% profit,ema1,ema2,threshold,diff,thresh / diff,ID
3959.665065,59,79,0.58,20,0.029,45
3945.301278,58,80,0.64,22,0.029090909,45
3939.31311,61,77,0.46,16,0.02875,45
3935.808656,60,78,0.52,18,0.028888889,45
3911.328245,57,81,0.7,24,0.029166667,45
3899.907676,62,75,0.38,13,0.029230769,45
3894.058922,62,76,0.4,14,0.028571429,45
3883.890893,61,76,0.44,15,0.029333333,45
3876.899868,59,77,0.53,18,0.029444444,45
3876.899868,58,78,0.59,20,0.0295,45
3876.766864,63,74,0.32,11,0.029090909,45
3857.629856,60,76,0.47,16,0.029375,45
3833.919715,60,77,0.5,17,0.029411765,45
3827.045877,59,78,0.56,19,0.029473684,45
3827.045877,58,79,0.62,21,0.02952381,45
3827.045877,57,80,0.68,23,0.029565217,45
3823.708051,62,74,0.35,12,0.029166667,45
3810.172115,56,81,0.74,25,0.0296,45
3798.036967,61,75,0.41,14,0.029285714,45
3774.229808,65,73,0.23,8,0.02875,45
3772.311717,64,73,0.26,9,0.028888889,45
3765.420821,62,76,0.41,14,0.029285714,45
3753.454444,66,67,0.03,1,0.03,45
3753.454444,65,68,0.09,3,0.03,45
3753.454444,64,69,0.15,5,0.03,45
3753.454444,63,70,0.21,7,0.03,45
3721.121365,61,77,0.47,16,0.029375,45
3710.058275,55,73,0.6,18,0.033333333,45
3708.051375,54,76,0.7,22,0.031818182,45
3691.284948,63,75,0.35,12,0.029166667,45
3691.278715,54,74,0.67,20,0.0335,45
3690.69732,40,49,0.33,9,0.036666667,45
3683.686387,53,76,0.76,23,0.033043478,45
3680.434709,58,70,0.4,12,0.033333333,45
3679.477822,51,78,0.9,27,0.033333333,45
3677.938668,50,79,0.97,29,0.033448276,45
3670.397843,61,67,0.2,6,0.033333333,45
3666.611817,61,78,0.49,17,0.028823529,45
3666.611817,60,79,0.55,19,0.028947368,45
3663.147414,59,71,0.38,12,0.031666667,45
3660.987676,52,77,0.83,25,0.0332,45
3657.716758,62,77,0.43,15,0.028666667,45
3655.634711,56,74,0.57,18,0.031666667,45
3651.002441,50,80,0.99,30,0.033,45
3645.669894,62,68,0.19,6,0.031666667,45
3636.171902,53,75,0.74,22,0.033636364,45
3634.477997,63,76,0.37,13,0.028461538,45
3634.217654,52,76,0.81,24,0.03375,45
3631.790498,50,79,0.96,29,0.033103448,45
3629.946386,61,76,0.45,15,0.03,45
3621.213635,64,74,0.29,10,0.029,45
3618.225956,54,75,0.69,21,0.032857143,45
3612.547525,62,69,0.22,7,0.031428571,45
3610.629198,62,75,0.39,13,0.03,45
3610.329498,51,78,0.89,27,0.032962963,45
3609.924368,64,75,0.31,11,0.028181818,45
3609.836572,66,73,0.2,7,0.028571429,45
3608.626792,50,80,0.98,30,0.032666667,45
3604.89318,51,77,0.88,26,0.033846154,45
3598.62175,60,77,0.51,17,0.03,45
3598.245569,52,77,0.82,25,0.0328,45
3596.548408,52,78,0.84,26,0.032307692,45
3596.548408,51,79,0.91,28,0.0325,45
3595.588518,53,77,0.77,24,0.032083333,45
3591.815087,36,54,0.65,18,0.036111111,45
3589.596876,57,72,0.49,15,0.032666667,45
3589.596876,55,74,0.62,19,0.032631579,45
3589.277938,64,71,0.22,7,0.031428571,45
3583.472003,50,75,0.85,25,0.034,45
3583.115135,59,77,0.56,18,0.031111111,45
3582.005678,55,76,0.66,21,0.031428571,45
3579.713946,56,75,0.6,19,0.031578947,45
3579.594898,57,74,0.53,17,0.031176471,45
3576.71518,51,79,0.92,28,0.032857143,45
3573.268379,55,75,0.64,20,0.032,45
3571.869602,58,71,0.43,13,0.033076923,45
3570.294672,57,71,0.47,14,0.033571429,45
3570.054237,54,77,0.73,23,0.03173913,45
3566.339546,62,74,0.37,12,0.030833333,45
3566.339546,61,75,0.43,14,0.030714286,45
3561.291843,50,78,0.95,28,0.033928571,45
3560.215062,58,78,0.62,20,0.031,45
3560.215062,58,79,0.64,21,0.03047619,45
3560.215062,57,80,0.7,23,0.030434783,45
3559.091159,61,69,0.26,8,0.0325,45
3559.048124,60,72,0.37,12,0.030833333,45
3557.53853,56,74,0.59,18,0.032777778,45
3557.462957,59,72,0.41,13,0.031538462,45
3557.01634,59,71,0.39,12,0.0325,45
3555.974852,61,68,0.23,7,0.032857143,45
3553.905901,56,73,0.56,17,0.032941176,45
3552.595045,59,64,0.17,5,0.034,45
3549.841691,55,74,0.63,19,0.033157895,45
3546.916805,60,75,0.47,15,0.031333333,45
3544.204963,54,76,0.72,22,0.032727273,45
3541.575617,58,72,0.46,14,0.032857143,45
3538.48164,55,72,0.58,17,0.034117647,45
3538.48164,54,73,0.65,19,0.034210526,45
3537.91044,56,76,0.62,20,0.031,45
3536.33453,61,66,0.17,5,0.034,45
3535.985356,57,73,0.52,16,0.0325,45
3535.514437,58,73,0.47,15,0.031333333,45
3535.182835,65,72,0.21,7,0.03,45
3535.182835,64,73,0.27,9,0.03,45
3534.370517,64,69,0.16,5,0.032,45
3533.1856,56,72,0.54,16,0.03375,45
3532.892805,52,78,0.85,26,0.032692308,45
3532.722358,56,80,0.75,24,0.03125,45
3530.014064,50,79,0.98,29,0.033793103,45
3529.076887,42,46,0.15,4,0.0375,45
3526.441738,57,75,0.56,18,0.031111111,45
3526.441738,55,78,0.71,23,0.030869565,45
3525.079249,55,80,0.79,25,0.0316,45
3524.144842,68,69,0.03,1,0.03,45
3524.144842,67,70,0.09,3,0.03,45
3524.144842,66,71,0.15,5,0.03,45
3523.678676,38,51,0.48,13,0.036923077,45
3522.801136,58,79,0.63,21,0.03,45
3521.523253,57,73,0.51,16,0.031875,45
3521.061074,59,70,0.36,11,0.032727273,45
3521.061074,55,75,0.65,20,0.0325,45
3517.649545,57,79,0.68,22,0.030909091,45
3517.649271,63,72,0.28,9,0.031111111,45
3517.649271,59,76,0.53,17,0.031176471,45
3517.594032,60,70,0.32,10,0.032,45
3517.594032,58,72,0.45,14,0.032142857,45
3517.594032,55,76,0.67,21,0.031904762,45
3516.211504,59,78,0.57,19,0.03,45
3513.476769,52,78,0.86,26,0.033076923,45
3512.99197,53,78,0.81,25,0.0324,45
3512.438242,60,76,0.49,16,0.030625,45
3512.08989,52,79,0.88,27,0.032592593,45
3511.061198,53,77,0.79,24,0.032916667,45
3509.32385,61,70,0.28,9,0.031111111,45
3509.32385,59,73,0.43,14,0.030714286,45
3508.271256,64,70,0.19,6,0.031666667,45
3508.271256,61,73,0.38,12,0.031666667,45
3507.716843,61,71,0.31,10,0.031,45
3505.03386,52,79,0.86,27,0.031851852,45
3503.14738,57,78,0.66,21,0.031428571,45
3502.702533,63,67,0.13,4,0.0325,45
3501.851288,33,59,0.88,26,0.033846154,45
3501.429044,54,83,0.88,29,0.030344828,45
3501.225052,54,77,0.74,23,0.032173913,45
3499.568665,60,67,0.24,7,0.034285714,45
3499.22053,53,78,0.79,25,0.0316,45
3498.489461,55,75,0.66,20,0.033,45
3497.916788,55,73,0.61,18,0.033888889,45
3497.916788,54,74,0.68,20,0.034,45
3496.790687,54,75,0.7,21,0.033333333,45
3495.977317,61,74,0.41,13,0.031538462,45
3495.977317,58,77,0.6,19,0.031578947,45
3493.966117,62,78,0.45,16,0.028125,45
3493.18013,56,74,0.58,18,0.032222222,45
3493.18013,54,76,0.71,22,0.032272727,45
3493.18013,53,77,0.78,24,0.0325,45
3492.571286,63,74,0.33,11,0.03,45
3490.632517,58,80,0.65,22,0.029545455,45
3490.632517,57,81,0.71,24,0.029583333,45
3490.407151,55,77,0.69,22,0.031363636,45
3490.191157,52,73,0.71,21,0.033809524,45
3490.186064,60,75,0.45,15,0.03,45
3490.087267,62,72,0.32,10,0.032,45
3490.00828,53,72,0.64,19,0.033684211,45
3488.478043,55,81,0.81,26,0.031153846,45
3487.892858,59,77,0.55,18,0.030555556,45
3487.506609,62,73,0.33,11,0.03,45
3487.506609,61,74,0.39,13,0.03,45
3486.97543,58,76,0.57,18,0.031666667,45
3486.355903,64,71,0.21,7,0.03,45
3486.355903,63,72,0.27,9,0.03,45
3486.083031,63,66,0.1,3,0.033333333,45
3485.573677,57,74,0.57,17,0.033529412,45
3485.316312,58,74,0.5,16,0.03125,45
3485.316312,53,80,0.84,27,0.031111111,45
3484.900213,58,76,0.55,18,0.030555556,45
3484.586261,67,69,0.06,2,0.03,45
3484.586261,66,70,0.12,4,0.03,45
3484.586261,65,71,0.18,6,0.03,45
3484.586261,64,72,0.24,8,0.03,45
3484.586261,63,73,0.3,10,0.03,45
3484.565263,65,69,0.13,4,0.0325,45
3484.565263,63,71,0.26,8,0.0325,45
3483.840266,54,80,0.84,26,0.032307692,45
3483.106616,62,71,0.29,9,0.032222222,45
3481.680679,52,81,0.92,29,0.031724138,45
3481.680679,51,82,0.99,31,0.031935484,45
3480.981883,53,79,0.82,26,0.031538462,45
3480.786418,52,81,0.93,29,0.032068966,45
3479.919623,57,74,0.55,17,0.032352941,45
3479.919623,55,76,0.68,21,0.032380952,45
3479.781701,53,71,0.61,18,0.033888889,45
3479.182985,56,81,0.76,25,0.0304,45
3478.951354,51,81,0.95,30,0.031666667,45
3478.348403,59,75,0.52,16,0.0325,45
3478.001799,65,68,0.1,3,0.033333333,45
3477.200635,61,73,0.39,12,0.0325,45
3476.819788,53,78,0.8,25,0.032,45
3474.689337,57,80,0.69,23,0.03,45
3474.689337,56,81,0.75,25,0.03,45
3473.77106,54,81,0.86,27,0.031851852,45
3473.676404,52,80,0.91,28,0.0325,45
3473.488012,57,76,0.63,19,0.033157895,45
3472.926702,53,76,0.77,23,0.033478261,45
3472.634833,51,74,0.78,23,0.033913043,45
3472.269596,51,80,0.94,29,0.032413793,45
3471.736914,54,77,0.75,23,0.032608696,45
3471.474554,54,79,0.78,25,0.0312,45
3471.474554,52,81,0.91,29,0.03137931,45
3470.500075,56,77,0.65,21,0.030952381,45
3469.453226,53,80,0.89,27,0.032962963,45
3469.260917,50,74,0.83,24,0.034583333,45
3468.469226,51,82,0.98,31,0.031612903,45
3467.935923,58,75,0.56,17,0.032941176,45
3467.674212,58,74,0.49,16,0.030625,45
3467.570873,53,84,0.94,31,0.030322581,45
3467.429104,56,78,0.68,22,0.030909091,45
3467.429104,53,81,0.87,28,0.031071429,45
3465.65123,60,71,0.34,11,0.030909091,45
3464.750366,53,71,0.62,18,0.034444444,45
3463.865724,57,74,0.54,17,0.031764706,45
3463.334517,58,73,0.5,15,0.033333333,45
3463.186905,54,79,0.79,25,0.0316,45
3463.186905,53,80,0.86,27,0.031851852,45
3462.641352,52,82,0.93,30,0.031,45
3462.625316,51,80,0.93,29,0.032068966,45
3462.177381,60,73,0.4,13,0.030769231,45
3462.177381,59,74,0.46,15,0.030666667,45
3462.177381,56,78,0.67,22,0.030454545,45
3462.177381,55,79,0.73,24,0.030416667,45
3461.511816,54,78,0.75,24,0.03125,45
3461.434942,59,72,0.42,13,0.032307692,45
3461.020574,61,72,0.34,11,0.030909091,45
3460.954335,51,79,0.93,28,0.033214286,45
3460.91663,55,69,0.48,14,0.034285714,45
3460.91663,54,70,0.55,16,0.034375,45
3460.864357,58,78,0.6,20,0.03,45
3460.553672,67,68,0.03,1,0.03,45
3460.553672,66,69,0.09,3,0.03,45
3460.553672,65,70,0.15,5,0.03,45
3460.477858,56,82,0.77,26,0.029615385,45
3460.477858,55,83,0.83,28,0.029642857,45
3460.091441,51,80,0.95,29,0.032758621,45
3459.924468,52,80,0.88,28,0.031428571,45
3459.845059,58,75,0.52,17,0.030588235,45
3459.634993,52,82,0.98,30,0.032666667,45
3459.332011,53,79,0.83,26,0.031923077,45
3459.332011,52,80,0.9,28,0.032142857,45
3459.332011,51,81,0.96,30,0.032,45
3459.051567,54,78,0.78,24,0.0325,45
3458.854764,57,76,0.58,19,0.030526316,45
3458.330252,59,74,0.49,15,0.032666667,45
3458.21102,64,68,0.13,4,0.0325,45
3458.21102,62,70,0.26,8,0.0325,45
3457.784566,54,78,0.8,24,0.033333333,45
3457.697571,60,74,0.45,14,0.032142857,45
3457.448436,57,77,0.64,20,0.032,45
3457.448436,55,79,0.77,24,0.032083333,45
3457.325114,61,69,0.27,8,0.03375,45
3456.991272,56,80,0.73,24,0.030416667,45
3456.672378,55,77,0.71,22,0.032272727,45
3456.644273,56,79,0.73,23,0.03173913,45
3456.421786,56,79,0.69,23,0.03,45
3455.556036,53,83,0.92,30,0.030666667,45
3455.04058,60,72,0.4,12,0.033333333,45
3454.747779,57,79,0.67,22,0.030454545,45
3453.430141,61,72,0.35,11,0.031818182,45
3452.719977,57,77,0.61,20,0.0305,45
3452.322069,63,69,0.2,6,0.033333333,45
3451.598268,59,75,0.49,16,0.030625,45
3451.032929,55,82,0.81,27,0.03,45
3450.582353,63,73,0.31,10,0.031,45
3449.835937,61,70,0.29,9,0.032222222,45
3449.529344,54,78,0.77,24,0.032083333,45
3449.384516,65,74,0.26,9,0.028888889,45
3449.303556,57,78,0.63,21,0.03,45
3449.021809,59,76,0.52,17,0.030588235,45
3448.64311,53,79,0.84,26,0.032307692,45
3448.64311,51,81,0.97,30,0.032333333,45
3448.633922,64,67,0.1,3,0.033333333,45
3447.739855,60,71,0.35,11,0.031818182,45
3447.739855,58,73,0.48,15,0.032,45
3447.739855,56,75,0.61,19,0.032105263,45
3447.739855,55,77,0.7,22,0.031818182,45
3447.739855,53,80,0.85,27,0.031481481,45
3447.525919,56,78,0.71,22,0.032272727,45
3447.481996,57,77,0.65,20,0.0325,45
3446.854276,56,75,0.62,19,0.032631579,45
3445.663951,60,69,0.3,9,0.033333333,45
3445.663951,57,72,0.5,15,0.033333333,45
3445.409856,53,78,0.82,25,0.0328,45
3444.573569,54,83,0.87,29,0.03,45
3444.321,60,73,0.42,13,0.032307692,45
3444.321,58,75,0.55,17,0.032352941,45
3444.245886,55,79,0.74,24,0.030833333,45
3444.006119,56,80,0.74,24,0.030833333,45
3443.935559,58,74,0.53,16,0.033125,45
3443.668473,62,73,0.35,11,0.031818182,45
3443.319634,59,76,0.51,17,0.03,45
3443.319634,58,77,0.57,19,0.03,45
3443.047903,60,73,0.43,13,0.033076923,45
3443.019983,63,71,0.25,8,0.03125,45
3442.625112,52,79,0.87,27,0.032222222,45
3441.883547,62,73,0.34,11,0.030909091,45
3441.676487,54,80,0.83,26,0.031923077,45
3440.100856,61,71,0.33,10,0.033,45
3439.629878,53,81,0.86,28,0.030714286,45
3437.545574,61,72,0.36,11,0.032727273,45
3436.784867,56,79,0.72,23,0.031304348,45
3436.777402,51,78,0.91,27,0.033703704,45
3436.345713,59,76,0.54,17,0.031764706,45
3435.626376,60,71,0.37,11,0.033636364,45
3435.421497,51,81,0.98,30,0.032666667,45
3435.331858,60,74,0.43,14,0.030714286,45
3435.245525,62,74,0.36,12,0.03,45
3435.245525,61,75,0.42,14,0.03,45
3435.245525,60,76,0.48,16,0.03,45
3435.245525,59,77,0.54,18,0.03,45
3435.21335,63,70,0.23,7,0.032857143,45
3435.167855,53,81,0.91,28,0.0325,45
3433.617676,60,74,0.44,14,0.031428571,45
3433.446907,57,79,0.66,22,0.03,45
3432.971889,59,73,0.45,14,0.032142857,45
3431.854181,59,75,0.51,16,0.031875,45
3431.835489,57,78,0.67,21,0.031904762,45
3431.201581,56,76,0.64,20,0.032,45
3429.795903,57,76,0.61,19,0.032105263,45
3429.616504,61,71,0.32,10,0.032,45
3429.421332,63,68,0.16,5,0.032,45
3429.421332,57,75,0.57,18,0.031666667,45
3428.540326,58,73,0.49,15,0.032666667,45
3427.96888,57,76,0.62,19,0.032631579,45
3427.96888,55,78,0.75,23,0.032608696,45
3424.681429,58,77,0.58,19,0.030526316,45
3422.8219,59,73,0.46,14,0.032857143,45
3422.8219,56,76,0.66,20,0.033,45
3422.003052,58,76,0.58,18,0.032222222,45
3421.403814,55,78,0.76,23,0.033043478,45
3420.430791,54,82,0.87,28,0.031071429,45
3420.42346,56,76,0.63,20,0.0315,45
3420.42346,54,78,0.76,24,0.031666667,45
3420.42346,52,80,0.89,28,0.031785714,45
3419.873057,51,73,0.76,22,0.034545455,45
3419.07221,54,84,0.89,30,0.029666667,45
3418.91198,53,81,0.9,28,0.032142857,45
3418.809703,55,77,0.73,22,0.033181818,45
3418.684889,56,78,0.69,22,0.031363636,45
3418.554831,55,81,0.79,26,0.030384615,45
3418.522075,55,82,0.82,27,0.03037037,45
3418.355283,61,70,0.3,9,0.033333333,45
3418.209535,55,78,0.73,23,0.03173913,45
3418.209535,53,81,0.88,28,0.031428571,45
3418.209535,52,82,0.94,30,0.031333333,45
3417.417936,57,76,0.59,19,0.031052632,45
3417.176637,55,75,0.67,20,0.0335,45
3417.166579,56,76,0.65,20,0.0325,45
3416.806923,54,79,0.83,25,0.0332,45
3416.725444,59,74,0.48,15,0.032,45
3416.715339,53,83,0.94,30,0.031333333,45
3416.694019,37,52,0.56,15,0.037333333,45
3416.435836,59,74,0.47,15,0.031333333,45
3416.435836,56,77,0.66,21,0.031428571,45
3415.996128,62,71,0.3,9,0.033333333,45
3415.935106,57,78,0.64,21,0.03047619,45
3415.935106,54,82,0.85,28,0.030357143,45
3415.498854,54,81,0.85,27,0.031481481,45
3413.735375,55,81,0.8,26,0.030769231,45
3413.551454,54,80,0.82,26,0.031538462,45
3413.551454,52,82,0.95,30,0.031666667,45
3412.930785,58,78,0.61,20,0.0305,45
3412.509879,52,81,0.94,29,0.032413793,45
3412.461647,56,77,0.69,21,0.032857143,45
3412.317346,58,66,0.27,8,0.03375,45
3411.874809,63,70,0.22,7,0.031428571,45
3411.874809,57,77,0.62,20,0.031,45
3411.77724,57,75,0.58,18,0.032222222,45
3411.684554,55,80,0.77,25,0.0308,45
3411.684554,54,81,0.83,27,0.030740741,45
3411.684554,52,84,0.98,32,0.030625,45
3411.426404,60,68,0.27,8,0.03375,45
3411.426404,52,77,0.84,25,0.0336,45
3411.245077,54,76,0.74,22,0.033636364,45
3411.119239,52,84,0.99,32,0.0309375,45
3410.805682,53,82,0.89,29,0.030689655,45
3410.602287,56,78,0.7,22,0.031818182,45
3410.347104,53,80,0.87,27,0.032222222,45
3410.128728,56,77,0.67,21,0.031904762,45
3409.473721,55,78,0.74,23,0.032173913,45
3408.962865,52,82,0.97,30,0.032333333,45
3408.409412,52,72,0.69,20,0.0345,45
3408.184273,62,70,0.25,8,0.03125,45
3407.34386,54,82,0.86,28,0.030714286,45
3407.336424,61,73,0.37,12,0.030833333,45
3407.327716,52,83,0.99,31,0.031935484,45
3406.851212,55,76,0.7,21,0.033333333,45
3406.800554,52,79,0.89,27,0.032962963,45
3406.751308,60,73,0.41,13,0.031538462,45
3406.751308,57,76,0.6,19,0.031578947,45
3406.751308,55,79,0.75,24,0.03125,45
3406.751308,54,80,0.81,26,0.031153846,45
3405.699433,52,82,0.96,30,0.032,45
3405.504542,59,69,0.34,10,0.034,45
3405.383818,51,72,0.73,21,0.034761905,45
3403.602059,61,73,0.36,12,0.03,45
3403.602059,60,74,0.42,14,0.03,45
3403.602059,59,75,0.48,16,0.03,45
3402.956224,54,79,0.82,25,0.0328,45
3402.786436,51,80,0.97,29,0.033448276,45
3402.711602,55,80,0.76,25,0.0304,45
3402.509574,56,73,0.57,17,0.033529412,45
3402.435445,41,48,0.25,7,0.035714286,45
3402.301326,60,72,0.39,12,0.0325,45
3402.245983,59,73,0.44,14,0.031428571,45
3402.208169,53,79,0.86,26,0.033076923,45
3402.062879,34,57,0.83,23,0.036086957,45
3402.032443,53,84,0.93,31,0.03,45
3401.613928,50,73,0.8,23,0.034782609,45
3401.189506,53,82,0.92,29,0.031724138,45
3397.946,54,78,0.79,24,0.032916667,45
3397.60147,54,81,0.82,27,0.03037037,45
3396.3824,60,70,0.33,10,0.033,45
3395.460423,54,80,0.8,26,0.030769231,45
3395.460423,52,83,0.95,31,0.030645161,45
3392.159444,55,81,0.78,26,0.03,45
3391.03932,56,80,0.72,24,0.03,45
3389.942474,58,75,0.54,17,0.031764706,45
3389.542534,55,79,0.76,24,0.031666667,45
3389.071117,54,79,0.8,25,0.032,45
3388.680587,56,70,0.46,14,0.032857143,45
3386.842728,54,68,0.49,14,0.035,45
3386.842728,53,69,0.56,16,0.035,45
3384.952847,57,73,0.53,16,0.033125,45
3384.952847,56,74,0.6,18,0.033333333,45
3384.870178,63,69,0.19,6,0.031666667,45
3384.870178,62,71,0.28,9,0.031111111,45
3384.870178,60,72,0.38,12,0.031666667,45
3384.870178,58,74,0.51,16,0.031875,45
3384.870178,58,75,0.53,17,0.031176471,45
3384.870178,55,78,0.72,23,0.031304348,45
3384.785275,55,70,0.5,15,0.033333333,45
3384.507816,55,79,0.78,24,0.0325,45
3383.495201,58,67,0.3,9,0.033333333,45
3383.433285,57,75,0.6,18,0.033333333,45
3383.273053,59,70,0.37,11,0.033636364,45
3383.032607,53,81,0.89,28,0.031785714,45
3380.922038,61,74,0.4,13,0.030769231,45
3380.922038,60,75,0.46,15,0.030666667,45
3380.705431,54,77,0.77,23,0.033478261,45
3380.120486,33,59,0.89,26,0.034230769,45
3379.300239,52,79,0.9,27,0.033333333,45
3379.164363,53,83,0.93,30,0.031,45
3376.634011,52,83,0.96,31,0.030967742,45
3376.50112,57,78,0.65,21,0.030952381,45
3376.19733,56,68,0.41,12,0.034166667,45
3375.356087,55,80,0.8,25,0.032,45
3374.290238,52,83,0.98,31,0.031612903,45
3373.793352,52,71,0.66,19,0.034736842,45
3372.798436,54,81,0.84,27,0.031111111,45
3372.798436,53,82,0.9,29,0.031034483,45
3372.798436,52,83,0.97,31,0.031290323,45
3372.72993,56,77,0.68,21,0.032380952,45
3371.982394,61,64,0.1,3,0.033333333,45
3371.74643,57,67,0.34,10,0.034,45
3371.513711,52,80,0.93,28,0.033214286,45
3370.567008,54,75,0.71,21,0.033809524,45
3370.567008,51,79,0.94,28,0.033571429,45
3370.464989,52,80,0.92,28,0.032857143,45
3370.464989,51,81,0.99,30,0.033,45
3368.278616,55,74,0.64,19,0.033684211,45
3368.278616,52,78,0.87,26,0.033461538,45
3367.714687,58,71,0.44,13,0.033846154,45
3367.663538,54,79,0.81,25,0.0324,45
3367.581468,35,56,0.72,21,0.034285714,45
3367.539333,53,83,0.91,30,0.030333333,45
3366.077164,62,72,0.31,10,0.031,45
3366.077164,58,76,0.56,18,0.031111111,45
3366.054738,58,74,0.52,16,0.0325,45
3364.23701,58,77,0.59,19,0.031052632,45
3362.964442,66,68,0.06,2,0.03,45
3362.964442,65,69,0.12,4,0.03,45
3362.964442,64,70,0.18,6,0.03,45
3362.327741,53,79,0.85,26,0.032692308,45
3361.488105,59,75,0.5,16,0.03125,45
3361.488105,56,79,0.71,23,0.030869565,45
3360.865691,54,80,0.85,26,0.032692308,45
3359.93892,51,74,0.79,23,0.034347826,45
3359.93892,50,75,0.86,25,0.0344,45
3359.471354,54,76,0.73,22,0.033181818,45
3359.471354,53,77,0.8,24,0.033333333,45
3357.912297,63,71,0.24,8,0.03,45
3357.912297,62,72,0.3,10,0.03,45
3354.91724,56,79,0.7,23,0.030434783,45
3354.630091,32,60,0.96,28,0.034285714,45
3353.679684,60,71,0.36,11,0.032727273,45
3353.397325,59,79,0.59,20,0.0295,45
3352.975744,60,78,0.53,18,0.029444444,45
3351.736162,57,73,0.54,16,0.03375,45
3349.872502,49,77,0.95,28,0.033928571,45
3349.219359,53,80,0.88,27,0.032592593,45
3348.837595,59,72,0.43,13,0.033076923,45
3348.837595,56,75,0.63,19,0.033157895,45
3348.837595,55,77,0.72,22,0.032727273,45
3348.067933,53,78,0.83,25,0.0332,45
3345.693997,57,75,0.59,18,0.032777778,45
3345.673615,51,80,0.96,29,0.033103448,45
3344.89623,57,77,0.63,20,0.0315,45
3344.89623,55,80,0.78,25,0.0312,45
3344.89623,53,82,0.91,29,0.03137931,45
3343.285668,52,81,0.96,29,0.033103448,45
3340.370802,62,69,0.23,7,0.032857143,45
3339.3949,33,58,0.9,25,0.036,45
3334.940821,32,57,0.93,25,0.0372,45
3332.188446,33,56,0.85,23,0.036956522,45
3331.555348,36,54,0.62,18,0.034444444,45
3331.24779,55,76,0.69,21,0.032857143,45
3331.24779,54,77,0.76,23,0.033043478,45
3328.288512,59,71,0.4,12,0.033333333,45
3328.288512,57,74,0.56,17,0.032941176,45
3327.024382,52,81,0.95,29,0.032758621,45
3324.177039,35,56,0.73,21,0.034761905,45
3321.579178,52,70,0.63,18,0.035,45
3321.474541,52,73,0.72,21,0.034285714,45
3321.212593,36,55,0.65,19,0.034210526,45
3320.460258,37,53,0.57,16,0.035625,45
3317.899417,51,71,0.7,20,0.035,45
3317.87874,62,68,0.2,6,0.033333333,45
3317.18856,58,65,0.24,7,0.034285714,45
3313.316904,55,71,0.53,16,0.033125,45
3312.58461,36,54,0.66,18,0.036666667,45
3312.583468,58,68,0.33,10,0.033,45
3311.937675,33,58,0.91,25,0.0364,45
3311.274972,58,72,0.47,14,0.033571429,45
3310.627309,44,59,0.5,15,0.033333333,45
3305.668091,57,66,0.31,9,0.034444444,45
3305.668091,56,67,0.38,11,0.034545455,45
3305.668091,55,68,0.45,13,0.034615385,45
3304.46337,49,75,0.9,26,0.034615385,45
3304.46337,48,76,0.97,28,0.034642857,45
3301.597223,65,75,0.28,10,0.028,45
3299.306943,39,48,0.34,9,0.037777778,45
3298.993277,73,74,0.02,1,0.02,45
3290.983084,37,50,0.49,13,0.037692308,45
3288.775161,49,76,0.93,27,0.034444444,45
3287.888269,54,71,0.57,17,0.033529412,45
3286.274574,42,47,0.18,5,0.036,45
3285.689065,65,81,0.32,16,0.02,45
3285.689065,64,82,0.36,18,0.02,45
3285.689065,63,83,0.4,20,0.02,45
3284.222602,35,53,0.67,18,0.037222222,45
3280.258919,35,55,0.73,20,0.0365,45
3274.335901,43,60,0.57,17,0.033529412,45
3268.648964,34,57,0.81,23,0.035217391,45
3267.451879,40,49,0.32,9,0.035555556,45
3267.124319,53,68,0.53,15,0.035333333,45
3265.25056,57,68,0.37,11,0.033636364,45
3264.289183,36,51,0.57,15,0.038,45
3259.83772,36,54,0.64,18,0.035555556,45
3259.585671,39,50,0.41,11,0.037272727,45
3259.208724,39,50,0.4,11,0.036363636,45
3257.449904,48,54,0.2,6,0.033333333,45
3256.835517,45,58,0.43,13,0.033076923,45
3255.724729,53,86,0.97,33,0.029393939,45
3241.840422,47,56,0.3,9,0.033333333,45
3241.079248,55,67,0.42,12,0.035,45
3237.644833,47,55,0.27,8,0.03375,45
3231.01457,50,53,0.1,3,0.033333333,45
3230.735625,66,80,0.28,14,0.02,45
3230.483046,33,55,0.83,22,0.037727273,45
3228.800261,54,72,0.6,18,0.033333333,45
3228.609522,34,57,0.8,23,0.034782609,45
3225.505074,41,63,0.73,22,0.033181818,45
3224.425798,52,69,0.6,17,0.035294118,45
3222.128418,32,58,0.96,26,0.036923077,45
3220.538367,68,79,0.23,11,0.020909091,45
3220.512373,32,57,0.94,25,0.0376,45
3211.581821,52,68,0.57,16,0.035625,45
3208.612093,53,73,0.67,20,0.0335,45
3207.655972,41,46,0.19,5,0.038,45
3207.261637,55,70,0.54,15,0.036,45
3206.772467,68,78,0.2,10,0.02,45
3206.772467,67,79,0.24,12,0.02,45
3206.148388,40,48,0.3,8,0.0375,45
3203.382241,54,87,0.92,33,0.027878788,45
3203.382241,53,88,0.98,35,0.028,45
3202.418614,34,57,0.79,23,0.034347826,45
3201.834491,34,54,0.75,20,0.0375,45
3197.753774,63,84,0.58,21,0.027619048,45
3196.248303,34,56,0.83,22,0.037727273,45
3194.403419,41,47,0.23,6,0.038333333,45
3192.467349,57,71,0.45,14,0.032142857,45
3192.467349,55,73,0.58,18,0.032222222,45
3190.459794,69,77,0.16,8,0.02,45
3188.664056,37,53,0.56,16,0.035,45
3186.873564,38,49,0.42,11,0.038181818,45
3185.440415,52,73,0.76,21,0.036190476,45
3184.960042,37,51,0.51,14,0.036428571,45
3184.824297,35,53,0.68,18,0.037777778,45
3184.401341,32,61,0.97,29,0.033448276,45
3184.036872,35,55,0.74,20,0.037,45
3183.40092,64,81,0.48,17,0.028235294,45
3183.304591,63,83,0.56,20,0.028,45
3183.095364,68,78,0.28,10,0.028,45
3181.104385,39,51,0.42,12,0.035,45
3179.984934,70,75,0.14,5,0.028,45
3179.76229,32,58,0.93,26,0.035769231,45
3178.950169,56,71,0.49,15,0.032666667,45
3178.797632,56,69,0.47,13,0.036153846,45
3178.259119,62,84,0.62,22,0.028181818,45
3176.019631,67,78,0.31,11,0.028181818,45
3174.871145,51,74,0.83,23,0.036086957,45
3174.229722,42,62,0.66,20,0.033,45
3170.95335,60,85,0.68,25,0.0272,45
3170.897318,62,83,0.43,21,0.02047619,45
3170.780561,59,66,0.25,7,0.035714286,45
3169.368185,35,52,0.65,17,0.038235294,45
3169.32986,54,71,0.61,17,0.035882353,45
3166.889297,54,69,0.52,15,0.034666667,45
3166.652104,62,82,0.55,20,0.0275,45
3165.825961,39,49,0.36,10,0.036,45
3165.571802,58,69,0.36,11,0.032727273,45
3164.716965,36,53,0.65,17,0.038235294,45
3164.258127,54,86,0.92,32,0.02875,45
3164.258127,53,87,0.98,34,0.028823529,45
3163.429127,43,61,0.59,18,0.032777778,45
3162.819544,40,65,0.82,25,0.0328,45
3161.703751,72,74,0.04,2,0.02,45
3161.703751,71,75,0.08,4,0.02,45
3161.703751,70,76,0.12,6,0.02,45
3160.911527,69,74,0.11,5,0.022,45
3159.734256,45,58,0.42,13,0.032307692,45
3157.973007,66,79,0.35,13,0.026923077,45
3157.635369,61,69,0.25,8,0.03125,45
3156.467469,37,52,0.57,15,0.038,45
3155.983445,72,75,0.06,3,0.02,45
3155.983445,71,76,0.1,5,0.02,45
3155.983445,70,77,0.14,7,0.02,45
3155.983445,69,78,0.18,9,0.02,45
3154.802097,55,84,0.85,29,0.029310345,45
3154.802097,54,85,0.91,31,0.029354839,45
3154.647792,62,85,0.64,23,0.027826087,45
3153.727628,45,59,0.46,14,0.032857143,45
3153.009547,41,63,0.72,22,0.032727273,45
3152.918951,33,56,0.86,23,0.037391304,45
3152.809241,60,85,0.67,25,0.0268,45
3152.809241,59,86,0.73,27,0.027037037,45
3151.510161,4,16,0.58,12,0.048333333,45
3151.119383,42,50,0.29,8,0.03625,45
3150.38158,67,77,0.27,10,0.027,45
3149.638967,46,56,0.34,10,0.034,45
3147.350175,40,47,0.26,7,0.037142857,45
3147.260179,72,73,0.02,1,0.02,45
3147.260179,71,74,0.06,3,0.02,45
3145.259394,39,47,0.31,8,0.03875,45
3145.061166,49,77,0.99,28,0.035357143,45
3145.040981,37,51,0.52,14,0.037142857,45
3143.324382,53,72,0.65,19,0.034210526,45
3143.084803,41,64,0.75,23,0.032608696,45
3142.9323,65,79,0.38,14,0.027142857,45
3142.9323,63,81,0.49,18,0.027222222,45
3142.818594,46,57,0.37,11,0.033636364,45
3142.00906,52,81,0.87,29,0.03,45
3142.002725,57,90,0.93,33,0.028181818,45
3140.083546,59,84,0.69,25,0.0276,45
3139.102987,49,54,0.16,5,0.032,45
3138.203224,52,74,0.75,22,0.034090909,45
3137.980755,67,77,0.22,10,0.022,45
3135.608916,42,49,0.24,7,0.034285714,45
3135.002399,68,80,0.33,12,0.0275,45
3135.002399,66,82,0.44,16,0.0275,45
3135.002399,64,84,0.55,20,0.0275,45
3134.547846,64,80,0.44,16,0.0275,45
3134.538183,57,89,0.86,32,0.026875,45
3134.538183,55,91,0.97,36,0.026944444,45
3134.033855,63,82,0.54,19,0.028421053,45
3134.030572,66,79,0.37,13,0.028461538,45
3132.002083,41,49,0.29,8,0.03625,45
3131.700181,65,81,0.45,16,0.028125,45
3130.827484,64,81,0.46,17,0.027058824,45
3130.708075,43,46,0.11,3,0.036666667,45
3130.36715,38,51,0.49,13,0.037692308,45
3130.0168,65,79,0.31,14,0.022142857,45
3129.998493,39,48,0.35,9,0.038888889,45
3129.284715,55,70,0.51,15,0.034,45
3129.284715,54,71,0.58,17,0.034117647,45
3129.180177,67,76,0.2,9,0.022222222,45
3129.119124,58,90,0.89,32,0.0278125,45
3128.537691,66,78,0.26,12,0.021666667,45
3128.29685,40,47,0.27,7,0.038571429,45
3127.17204,64,84,0.4,20,0.02,45
3126.424949,40,52,0.43,12,0.035833333,45
3126.36928,61,86,0.7,25,0.028,45
3125.354743,64,80,0.43,16,0.026875,45
3124.423953,51,54,0.08,3,0.026666667,45
3123.355949,51,75,0.81,24,0.03375,45
3123.355949,50,76,0.88,26,0.033846154,45
3123.071188,69,78,0.19,9,0.021111111,45
3122.89929,65,83,0.36,18,0.02,45
3122.343488,62,83,0.45,21,0.021428571,45
3121.893653,64,78,0.39,14,0.027857143,45
3119.903118,37,50,0.5,13,0.038461538,45
3118.182701,59,85,0.74,26,0.028461538,45
3117.35911,56,89,0.94,33,0.028484848,45
3116.342156,52,75,0.79,23,0.034347826,45
3116.342156,51,76,0.86,25,0.0344,45
3115.75732,36,51,0.58,15,0.038666667,45
3115.034628,34,56,0.8,22,0.036363636,45
3114.633508,53,79,0.88,26,0.033846154,45
3114.322048,71,74,0.08,3,0.026666667,45
3114.058279,58,87,0.78,29,0.026896552,45
3112.92886,54,74,0.65,20,0.0325,45
3112.475094,72,76,0.11,4,0.0275,45
3112.475094,70,78,0.22,8,0.0275,45
3112.391142,61,84,0.49,23,0.021304348,45
3112.098991,71,78,0.19,7,0.027142857,45
3112.098991,67,83,0.43,16,0.026875,45
3110.713555,56,69,0.44,13,0.033846154,45
3110.682989,46,57,0.35,11,0.031818182,45
3110.668795,51,82,0.93,31,0.03,45
3110.056929,53,70,0.59,17,0.034705882,45
3109.871457,59,83,0.69,24,0.02875,45
3109.51102,55,74,0.61,19,0.032105263,45
3109.51102,53,76,0.74,23,0.032173913,45
3109.473012,47,56,0.29,9,0.032222222,45
3108.675699,64,79,0.43,15,0.028666667,45
3108.559865,69,74,0.14,5,0.028,45
3108.343483,58,74,0.54,16,0.03375,45
3107.202642,66,82,0.33,16,0.020625,45
3106.898576,65,83,0.37,18,0.020555556,45
3106.69288,52,83,0.88,31,0.028387097,45
3106.246736,61,87,0.55,26,0.021153846,45
3105.981581,63,82,0.51,19,0.026842105,45
3105.981581,61,84,0.62,23,0.026956522,45
3105.336541,67,80,0.36,13,0.027692308,45
3105.251611,60,85,0.71,25,0.0284,45
3105.068273,58,87,0.79,29,0.027241379,45
3104.818884,52,74,0.74,22,0.033636364,45
3104.684359,52,75,0.76,23,0.033043478,45
3103.721683,63,85,0.46,22,0.020909091,45
3103.226575,34,55,0.77,21,0.036666667,45
3103.057601,66,89,0.42,23,0.01826087,45
3102.68779,53,73,0.7,20,0.035,45
3102.589043,65,78,0.37,13,0.028461538,45
3102.589043,60,84,0.68,24,0.028333333,45
3101.938416,52,76,0.82,24,0.034166667,45
3101.882295,53,74,0.72,21,0.034285714,45
3101.715575,55,74,0.67,19,0.035263158,45
3101.458263,61,84,0.48,23,0.020869565,45
3101.313481,34,57,0.82,23,0.035652174,45
3100.952898,61,68,0.22,7,0.031428571,45
3099.816791,65,84,0.39,19,0.020526316,45
3099.760137,37,52,0.55,15,0.036666667,45
3099.650993,61,83,0.63,22,0.028636364,45
3098.890253,55,86,0.87,31,0.028064516,45
3098.669936,65,82,0.36,17,0.021176471,45
3098.597102,54,87,0.93,33,0.028181818,45
3098.597102,53,88,0.99,35,0.028285714,45
3098.13085,56,73,0.59,17,0.034705882,45
3097.430177,59,86,0.74,27,0.027407407,45
3097.430177,56,90,0.93,34,0.027352941,45
3097.336608,61,85,0.68,24,0.028333333,45
3097.116433,67,88,0.38,21,0.018095238,45
3096.922131,69,78,0.25,9,0.027777778,45
3096.82533,59,69,0.32,10,0.032,45
3096.47863,51,76,0.83,25,0.0332,45
3096.453891,57,83,0.74,26,0.028461538,45
3096.255563,65,82,0.47,17,0.027647059,45
3095.14103,63,81,0.39,18,0.021666667,45
3094.53768,40,48,0.29,8,0.03625,45
3094.430785,53,75,0.75,22,0.034090909,45
3093.938631,46,59,0.35,13,0.026923077,45
3093.933525,57,88,0.88,31,0.028387097,45
3093.827013,66,75,0.26,9,0.028888889,45
3093.752508,62,84,0.59,22,0.026818182,45
3093.624035,33,55,0.84,22,0.038181818,45
3093.541173,60,65,0.17,5,0.034,45
3093.331753,53,73,0.68,20,0.034,45
3092.594996,35,55,0.76,20,0.038,45
3092.54357,65,79,0.3,14,0.021428571,45
3092.029033,63,82,0.4,19,0.021052632,45
3091.68835,61,84,0.5,23,0.02173913,45
3091.429833,63,87,0.65,24,0.027083333,45
3091.429445,44,63,0.5,19,0.026315789,45
3091.040023,69,75,0.13,6,0.021666667,45
3090.772093,56,90,0.91,34,0.026764706,45
3090.754617,60,88,0.59,28,0.021071429,45
3090.327284,41,51,0.36,10,0.036,45
3089.912733,60,85,0.55,25,0.022,45
3089.588508,59,94,0.89,35,0.025428571,45
3089.327937,60,62,0.07,2,0.035,45
3089.327937,59,63,0.14,4,0.035,45
3089.327937,58,64,0.21,6,0.035,45
3089.327937,57,65,0.28,8,0.035,45
3089.327937,56,66,0.35,10,0.035,45
3088.934995,64,82,0.48,18,0.026666667,45
3088.757036,58,88,0.8,30,0.026666667,45
3088.590793,62,89,0.7,27,0.025925926,45
3088.590793,62,90,0.72,28,0.025714286,45
3088.590793,61,91,0.77,30,0.025666667,45
3088.439488,34,55,0.78,21,0.037142857,45
3088.10624,64,84,0.42,20,0.021,45
3087.520719,70,78,0.16,8,0.02,45
3087.520719,69,79,0.2,10,0.02,45
3087.520719,68,80,0.24,12,0.02,45
3087.520719,67,81,0.28,14,0.02,45
3087.456246,44,60,0.51,16,0.031875,45
3087.155882,60,65,0.18,5,0.036,45
3086.846861,68,75,0.2,7,0.028571429,45
3086.754976,57,86,0.83,29,0.02862069,45
3086.65562,59,80,0.61,21,0.029047619,45
3086.65562,58,81,0.67,23,0.029130435,45
3086.65562,55,85,0.87,30,0.029,45
3086.26996,62,67,0.16,5,0.032,45
3085.78107,68,76,0.17,8,0.02125,45
3085.78107,64,80,0.34,16,0.02125,45
3085.45283,61,83,0.61,22,0.027727273,45
3085.45283,58,87,0.8,29,0.027586207,45
3085.260882,62,70,0.27,8,0.03375,45
3084.8287,67,77,0.21,10,0.021,45
3084.740306,60,70,0.34,10,0.034,45
3084.610546,73,76,0.08,3,0.026666667,45
3084.57487,57,89,0.85,32,0.0265625,45
3084.322683,56,70,0.49,14,0.035,45
3084.322683,55,71,0.56,16,0.035,45
3084.322683,54,72,0.63,18,0.035,45
3084.268221,60,72,0.36,12,0.03,45
3083.923776,59,73,0.42,14,0.03,45
3083.587991,56,91,0.98,35,0.028,45
3083.454601,69,80,0.3,11,0.027272727,45
3083.374442,60,88,0.77,28,0.0275,45
3082.752634,38,51,0.47,13,0.036153846,45
3082.489782,61,84,0.61,23,0.026521739,45
3082.489782,58,88,0.79,30,0.026333333,45
3082.347123,39,49,0.37,10,0.037,45
3082.347123,35,54,0.7,19,0.036842105,45
3082.160452,51,77,0.89,26,0.034230769,45
3082.160452,50,78,0.96,28,0.034285714,45
3082.086465,58,71,0.45,13,0.034615385,45
3082.086465,57,72,0.52,15,0.034666667,45
3081.986383,56,90,0.92,34,0.027058824,45
3081.276018,68,81,0.26,13,0.02,45
3081.186678,56,87,0.89,31,0.028709677,45
3081.131911,57,72,0.48,15,0.032,45
3081.087495,57,82,0.73,25,0.0292,45
3081.087495,56,83,0.79,27,0.029259259,45
3080.910577,69,73,0.11,4,0.0275,45
3080.760015,59,87,0.79,28,0.028214286,45
3080.455969,59,86,0.77,27,0.028518519,45
3079.851835,53,74,0.69,21,0.032857143,45
3079.629683,61,84,0.51,23,0.022173913,45
3079.605644,49,57,0.21,8,0.02625,45
3079.074113,36,52,0.59,16,0.036875,45
3078.644381,61,68,0.24,7,0.034285714,45
3078.20608,69,81,0.31,12,0.025833333,45
3078.20608,66,85,0.49,19,0.025789474,45
3078.20608,65,86,0.54,21,0.025714286,45
3078.20608,64,88,0.61,24,0.025416667,45
3077.743478,64,83,0.53,19,0.027894737,45
3077.54741,65,85,0.54,20,0.027,45
3077.54741,63,88,0.67,25,0.0268,45
3077.368594,54,73,0.66,19,0.034736842,45
3077.356882,62,82,0.56,20,0.028,45
3077.279307,62,86,0.49,24,0.020416667,45
3076.719689,64,80,0.36,16,0.0225,45
3076.719689,62,82,0.45,20,0.0225,45
3076.220805,42,66,0.63,24,0.02625,45
3075.669098,54,79,0.74,25,0.0296,45
3075.651252,62,91,0.73,29,0.025172414,45
3075.094108,48,57,0.24,9,0.026666667,45
3075.030091,61,71,0.3,10,0.03,45
3074.979978,33,58,0.89,25,0.0356,45
3074.899016,35,55,0.72,20,0.036,45
3074.703853,51,75,0.82,24,0.034166667,45
3074.703853,50,76,0.89,26,0.034230769,45
3074.655372,37,49,0.47,12,0.039166667,45
3074.563638,62,83,0.57,21,0.027142857,45
3074.303494,59,87,0.58,28,0.020714286,45
3074.159437,48,56,0.25,8,0.03125,45
3074.156507,62,86,0.66,24,0.0275,45
3074.153285,66,83,0.46,17,0.027058824,45
3074.153285,64,85,0.57,21,0.027142857,45
3074.153285,62,87,0.68,25,0.0272,45
3074.055855,54,78,0.81,24,0.03375,45
3073.726876,52,78,0.91,26,0.035,45
3073.327213,63,68,0.17,5,0.034,45
3073.316215,64,92,0.51,28,0.018214286,45
3073.108906,66,82,0.32,16,0.02,45
3072.899757,33,96,0.12,63,0.001904762,45
3072.74681,66,79,0.28,13,0.021538462,45
3071.94874,63,86,0.63,23,0.027391304,45
3071.94874,61,88,0.74,27,0.027407407,45
3071.813832,53,80,0.9,27,0.033333333,45
3071.255806,62,80,0.51,18,0.028333333,45
3070.962238,67,81,0.29,14,0.020714286,45
3070.696625,64,80,0.35,16,0.021875,45
3070.006773,58,68,0.35,10,0.035,45
3070.006773,57,69,0.42,12,0.035,45
3069.96707,69,73,0.09,4,0.0225,45
3069.59517,63,79,0.45,16,0.028125,45
3069.27252,54,72,0.61,18,0.033888889,45
3068.976587,59,86,0.72,27,0.026666667,45
3068.865072,68,82,0.37,14,0.026428571,45
3068.865072,65,85,0.53,20,0.0265,45
3068.645277,57,74,0.58,17,0.034117647,45
3068.645277,56,75,0.65,19,0.034210526,45
3068.609167,59,68,0.31,9,0.034444444,45
3068.496119,58,74,0.48,16,0.03,45
3067.920267,53,73,0.72,20,0.036,45
3067.333958,70,76,0.17,6,0.028333333,45
3067.333958,67,79,0.34,12,0.028333333,45
3066.671795,58,96,0.96,38,0.025263158,45
3066.463071,52,75,0.8,23,0.034782609,45
3066.332294,58,88,0.84,30,0.028,45
3066.332294,57,89,0.9,32,0.028125,45
3066.329025,38,50,0.46,12,0.038333333,45
3066.276125,68,89,0.37,21,0.017619048,45
3066.266429,34,57,0.84,23,0.036521739,45
3065.859265,63,84,0.42,21,0.02,45
3065.764287,56,90,0.96,34,0.028235294,45
3065.752621,49,77,0.96,28,0.034285714,45
3065.681249,60,93,0.84,33,0.025454545,45
3065.6055,61,87,0.72,26,0.027692308,45
3065.585938,35,56,0.74,21,0.035238095,45
3065.108166,61,92,0.78,31,0.02516129,45
3064.956596,65,67,0.06,2,0.03,45
3064.150771,64,84,0.41,20,0.0205,45
3064.150771,63,85,0.45,22,0.020454545,45
3064.118109,64,87,0.59,23,0.025652174,45
3063.666219,35,52,0.66,17,0.038823529,45
3063.6562,57,76,0.56,19,0.029473684,45
3063.598818,62,82,0.44,20,0.022,45
3062.57662,63,92,0.53,29,0.018275862,45
3062.542683,36,52,0.6,16,0.0375,45
3062.429273,50,76,0.93,26,0.035769231,45
3062.273747,48,57,0.28,9,0.031111111,45
3062.18741,58,73,0.51,15,0.034,45
3062.187007,60,87,0.72,27,0.026666667,45
3062.171067,61,86,0.66,25,0.0264,45
3062.084416,55,74,0.66,19,0.034736842,45
3062.030894,57,75,0.61,18,0.033888889,45
3062.030654,62,69,0.24,7,0.034285714,45
3061.843154,62,83,0.56,21,0.026666667,45
3061.746416,50,77,0.94,27,0.034814815,45
3061.68825,65,80,0.31,15,0.020666667,45
3061.574605,63,89,0.66,26,0.025384615,45
3061.529815,60,86,0.69,26,0.026538462,45
3061.529815,60,87,0.71,27,0.026296296,45
3061.074261,56,72,0.57,16,0.035625,45
3061.0396,39,49,0.38,10,0.038,45
3060.520292,58,87,0.81,29,0.027931034,45
3059.986994,59,89,0.83,30,0.027666667,45
3059.836692,63,93,0.55,30,0.018333333,45
3059.611088,60,86,0.73,26,0.028076923,45
3059.531094,61,90,0.78,29,0.026896552,45
3059.531094,59,92,0.89,33,0.026969697,45
3059.40023,34,56,0.84,22,0.038181818,45
3059.395687,60,69,0.31,9,0.034444444,45
3059.197055,58,92,0.93,34,0.027352941,45
3059.170278,65,80,0.4,15,0.026666667,45
3058.622341,38,48,0.39,10,0.039,45
3058.506382,61,83,0.62,22,0.028181818,45
3058.506382,57,88,0.87,31,0.028064516,45
3058.506382,56,89,0.93,33,0.028181818,45
3058.430612,67,80,0.27,13,0.020769231,45
3058.393712,63,81,0.4,18,0.022222222,45
3058.151059,65,84,0.52,19,0.027368421,45
3058.119463,56,80,0.76,24,0.031666667,45
3058.041986,42,48,0.22,6,0.036666667,45
3057.976507,69,77,0.21,8,0.02625,45
3057.976507,66,80,0.37,14,0.026428571,45
3057.964522,36,54,0.63,18,0.035,45
3057.742395,53,74,0.73,21,0.034761905,45
3057.520772,58,69,0.37,11,0.033636364,45
3057.437928,71,79,0.21,8,0.02625,45
3057.412484,70,80,0.26,10,0.026,45
3057.412484,66,84,0.47,18,0.026111111,45
3057.048084,70,76,0.16,6,0.026666667,45
3057.048084,67,79,0.32,12,0.026666667,45
3056.652973,58,72,0.44,14,0.031428571,45
3056.418643,67,75,0.22,8,0.0275,45
3056.28151,32,98,0.13,66,0.001969697,45
3055.774492,64,68,0.12,4,0.03,45
3055.774492,63,69,0.18,6,0.03,45
3055.774492,62,70,0.24,8,0.03,45
3055.560704,62,64,0.07,2,0.035,45
3055.560704,61,65,0.14,4,0.035,45
3055.560704,60,66,0.21,6,0.035,45
3055.554442,69,77,0.17,8,0.02125,45
3055.507261,45,59,0.44,14,0.031428571,45
3055.413559,59,88,0.6,29,0.020689655,45
3054.927737,59,66,0.24,7,0.034285714,45
3054.553585,57,89,0.91,32,0.0284375,45
3054.367248,56,84,0.8,28,0.028571429,45
3053.843103,51,83,0.94,32,0.029375,45
3053.842856,59,73,0.47,14,0.033571429,45
3052.980918,65,76,0.31,11,0.028181818,45
3052.980918,62,79,0.48,17,0.028235294,45
3052.362288,55,71,0.57,16,0.035625,45
3052.25382,56,89,0.92,33,0.027878788,45
3052.136624,57,91,0.95,34,0.027941176,45
3052.10267,39,50,0.39,11,0.035454545,45
3051.930038,63,83,0.53,20,0.0265,45
3051.930038,61,85,0.64,24,0.026666667,45
3051.701433,60,86,0.7,26,0.026923077,45
3051.701433,58,88,0.81,30,0.027,45
3051.701433,58,89,0.83,31,0.026774194,45
3051.701433,57,89,0.87,32,0.0271875,45
3051.701433,57,90,0.89,33,0.026969697,45
3051.701433,56,91,0.94,35,0.026857143,45
3051.701433,56,92,0.96,36,0.026666667,45
3051.453238,64,81,0.35,17,0.020588235,45
3051.351309,57,70,0.45,13,0.034615385,45
3051.351309,56,71,0.52,15,0.034666667,45
3051.201373,73,75,0.04,2,0.02,45
3051.201373,72,76,0.08,4,0.02,45
3051.201373,71,77,0.12,6,0.02,45
3051.112655,62,88,0.71,26,0.027307692,45
3050.95085,67,83,0.42,16,0.02625,45
3050.95085,61,90,0.76,29,0.026206897,45
3050.71421,55,91,0.98,36,0.027222222,45
3050.601845,53,79,0.87,26,0.033461538,45
3050.535192,62,82,0.57,20,0.0285,45
3050.341678,59,88,0.78,29,0.026896552,45
3050.341678,57,91,0.91,34,0.026764706,45
3050.335842,49,78,0.99,29,0.034137931,45
3050.165995,58,91,0.69,33,0.020909091,45
3050.029366,61,92,0.79,31,0.025483871,45
3049.577666,68,77,0.24,9,0.026666667,45
3049.273695,55,72,0.59,17,0.034705882,45
3049.144023,63,92,0.54,29,0.01862069,45
3049.134055,61,84,0.65,23,0.02826087,45
3048.597725,59,93,0.88,34,0.025882353,45
3048.289089,56,91,0.92,35,0.026285714,45
3048.267366,46,60,0.37,14,0.026428571,45
3048.219649,66,77,0.31,11,0.028181818,45
3048.203528,66,77,0.25,11,0.022727273,45
3048.19969,34,58,0.82,24,0.034166667,45
3048.078214,55,92,0.98,37,0.026486486,45
3047.752154,64,86,0.59,22,0.026818182,45
3047.743361,58,75,0.5,17,0.029411765,45
3047.524691,59,95,0.91,36,0.025277778,45
3047.448638,64,82,0.5,18,0.027777778,45
3047.30159,69,79,0.27,10,0.027,45
3047.30159,67,81,0.38,14,0.027142857,45
3047.30159,65,83,0.49,18,0.027222222,45
3047.30159,63,85,0.6,22,0.027272727,45
3047.252037,60,89,0.79,29,0.027241379,45
3047.252037,57,92,0.96,35,0.027428571,45
3046.797446,55,85,0.86,30,0.028666667,45
3046.522545,58,88,0.64,30,0.021333333,45
3046.227759,64,81,0.45,17,0.026470588,45
3046.227759,60,86,0.68,26,0.026153846,45
3046.227759,57,90,0.86,33,0.026060606,45
3046.209771,39,49,0.39,10,0.039,45
3046.097255,65,86,0.55,21,0.026190476,45
3046.094061,69,81,0.32,12,0.026666667,45
3046.094061,66,84,0.48,18,0.026666667,45
3046.094061,66,85,0.5,19,0.026315789,45
3046.08757,51,76,0.87,25,0.0348,45
3045.939434,59,87,0.74,28,0.026428571,45
3045.474897,38,52,0.49,14,0.035,45
3045.467495,47,57,0.31,10,0.031,45
3045.237785,51,83,0.95,32,0.0296875,45
3044.963179,61,85,0.51,24,0.02125,45
3044.916645,70,74,0.11,4,0.0275,45
3044.916645,68,76,0.22,8,0.0275,45
3044.916645,66,78,0.33,12,0.0275,45
3044.812846,64,87,0.61,23,0.026521739,45
3044.812846,63,88,0.66,25,0.0264,45
3044.812846,63,89,0.68,26,0.026153846,45
3044.675342,61,80,0.55,19,0.028947368,45
3044.617875,59,87,0.76,28,0.027142857,45
3044.409124,59,88,0.77,29,0.026551724,45
3044.362703,70,79,0.24,9,0.026666667,45
3044.022591,57,90,0.69,33,0.020909091,45
3043.521456,63,81,0.51,18,0.028333333,45
3043.280003,65,81,0.42,16,0.02625,45
3043.280003,62,84,0.58,22,0.026363636,45
3043.280003,62,85,0.6,23,0.026086957,45
3043.173829,54,86,0.93,32,0.0290625,45
3043.173829,53,87,0.99,34,0.029117647,45
3043.159304,60,87,0.76,27,0.028148148,45
3043.139936,44,61,0.53,17,0.031176471,45
3042.791274,51,75,0.86,24,0.035833333,45
3042.771453,55,77,0.74,22,0.033636364,45
3042.703541,58,86,0.72,28,0.025714286,45
3042.267611,55,74,0.44,19,0.023157895,45
3042.179023,59,87,0.75,28,0.026785714,45
3042.105849,56,77,0.7,21,0.033333333,45
3042.050778,69,75,0.16,6,0.026666667,45
3041.987451,63,81,0.5,18,0.027777778,45
3041.987451,60,84,0.67,24,0.027916667,45
3041.987451,57,88,0.86,31,0.027741935,45
3041.976969,59,67,0.28,8,0.035,45
3041.541933,45,60,0.47,15,0.031333333,45
3041.407267,51,84,0.95,33,0.028787879,45
3041.362736,55,78,0.69,23,0.03,45
3041.362736,54,79,0.75,25,0.03,45
3041.037378,42,65,0.61,23,0.026521739,45
3040.880449,50,77,0.96,27,0.035555556,45
3040.835338,61,87,0.71,26,0.027307692,45
3040.089091,61,81,0.57,20,0.0285,45
3040.089091,60,82,0.63,22,0.028636364,45
3039.669718,60,89,0.6,29,0.020689655,45
3039.581486,53,80,0.81,27,0.03,45
3039.297636,65,80,0.32,15,0.021333333,45
3039.100219,40,48,0.31,8,0.03875,45
3039.064257,64,80,0.45,16,0.028125,45
3039.064257,59,86,0.76,27,0.028148148,45
3039.005647,63,82,0.39,19,0.020526316,45
3038.884172,59,71,0.41,12,0.034166667,45
3038.68432,55,91,0.99,36,0.0275,45
3038.427953,59,91,0.87,32,0.0271875,45
3038.354892,62,90,0.73,28,0.026071429,45
3038.311195,57,84,0.77,27,0.028518519,45
3038.311195,55,87,0.91,32,0.0284375,45
3038.18074,55,76,0.72,21,0.034285714,45
3037.785905,58,87,0.82,29,0.028275862,45
3037.654958,62,79,0.49,17,0.028823529,45
3037.60669,54,76,0.75,22,0.034090909,45
3037.60669,53,77,0.82,24,0.034166667,45
3037.51601,48,55,0.22,7,0.031428571,45
3037.27392,33,57,0.88,24,0.036666667,45
3036.896125,59,93,0.91,34,0.026764706,45
3036.878824,64,82,0.51,18,0.028333333,45
3036.672163,57,91,0.96,34,0.028235294,45
3036.377149,59,70,0.38,11,0.034545455,45
3036.331006,58,90,0.84,32,0.02625,45
3035.85537,44,60,0.53,16,0.033125,45
3035.844674,58,88,0.85,30,0.028333333,45
3035.647568,57,91,0.9,34,0.026470588,45
3035.371798,64,87,0.6,23,0.026086957,45
3035.365135,63,65,0.07,2,0.035,45
3035.365135,62,66,0.14,4,0.035,45
3035.365135,61,67,0.21,6,0.035,45
3035.365135,60,68,0.28,8,0.035,45
3035.365135,59,69,0.35,10,0.035,45
3035.365135,58,70,0.42,12,0.035,45
3035.34877,58,67,0.31,9,0.034444444,45
3035.34877,57,68,0.38,11,0.034545455,45
3035.003115,59,70,0.35,11,0.031818182,45
3034.884978,63,78,0.42,15,0.028,45
3034.847374,58,94,0.96,36,0.026666667,45
3034.801475,32,56,0.91,24,0.037916667,45
3034.793006,57,76,0.57,19,0.03,45
3034.793006,56,77,0.63,21,0.03,45
3034.728315,55,76,0.71,21,0.033809524,45
3034.728315,54,77,0.78,23,0.033913043,45
3034.728315,53,78,0.85,25,0.034,45
3034.414404,59,87,0.78,28,0.027857143,45
3033.363852,59,89,0.78,30,0.026,45
3032.854788,55,92,0.99,37,0.026756757,45
3032.576597,43,62,0.62,19,0.032631579,45
3032.229536,58,84,0.75,26,0.028846154,45
3032.198749,65,78,0.29,13,0.022307692,45
3032.198749,63,80,0.38,17,0.022352941,45
3032.117688,37,51,0.54,14,0.038571429,45
3031.983111,57,93,0.98,36,0.027222222,45
3031.920116,60,92,0.85,32,0.0265625,45
3031.920116,59,94,0.92,35,0.026285714,45
3031.8299,60,85,0.66,25,0.0264,45
3031.737402,68,81,0.35,13,0.026923077,45
3031.733227,54,77,0.79,23,0.034347826,45
3031.637213,58,87,0.62,29,0.02137931,45
3031.629951,56,76,0.68,20,0.034,45
3031.271694,53,78,0.86,25,0.0344,45
3031.072415,59,90,0.85,31,0.027419355,45
3031.057433,59,88,0.82,29,0.028275862,45
3030.33594,62,86,0.5,24,0.020833333,45
3030.226353,58,91,0.91,33,0.027575758,45
3030.100481,57,88,0.85,31,0.027419355,45
3029.484441,65,80,0.42,15,0.028,45
3029.484441,61,85,0.67,24,0.027916667,45
3029.210418,67,76,0.25,9,0.027777778,45
3028.816224,65,84,0.51,19,0.026842105,45
3028.816224,63,87,0.64,24,0.026666667,45
3028.662079,52,74,0.79,22,0.035909091,45
3028.439836,59,88,0.75,29,0.025862069,45
3028.439836,58,90,0.82,32,0.025625,45
3028.345275,60,86,0.55,26,0.021153846,45
3028.319115,60,90,0.82,30,0.027333333,45
3028.297835,56,75,0.64,19,0.033684211,45
3028.20999,58,89,0.86,31,0.027741935,45
3028.20999,57,90,0.92,33,0.027878788,45
3028.209534,57,90,0.91,33,0.027575758,45
3028.10851,36,55,0.66,19,0.034736842,45
3028.086773,64,91,0.49,27,0.018148148,45
3027.897178,62,83,0.44,21,0.020952381,45
3027.740865,59,72,0.44,13,0.033846154,45
3027.497053,60,91,0.83,31,0.026774194,45
3027.006622,66,74,0.23,8,0.02875,45
3027.006622,64,77,0.37,13,0.028461538,45
3026.935603,56,91,0.97,35,0.027714286,45
3026.836812,46,58,0.38,12,0.031666667,45
3026.141308,52,82,0.89,30,0.029666667,45
3025.975525,58,95,0.95,37,0.025675676,45
3025.808012,55,83,0.84,28,0.03,45
3025.739208,62,87,0.52,25,0.0208,45
3025.466808,67,83,0.31,16,0.019375,45
3025.401991,64,86,0.6,22,0.027272727,45
3025.306299,63,86,0.62,23,0.026956522,45
3024.813713,64,81,0.37,17,0.021764706,45
3024.576659,62,89,0.72,27,0.026666667,45
3024.576659,62,90,0.74,28,0.026428571,45
3024.576659,61,90,0.77,29,0.026551724,45
3024.576659,61,91,0.79,30,0.026333333,45
3024.505713,67,84,0.44,17,0.025882353,45
3024.505713,63,88,0.65,25,0.026,45
3024.393228,53,82,0.82,29,0.028275862,45
3024.344131,61,85,0.5,24,0.020833333,45
3024.287221,49,78,0.98,29,0.033793103,45
3024.23688,60,91,0.84,31,0.027096774,45
3024.129254,65,85,0.52,20,0.026,45
3024.03355,61,88,0.73,27,0.027037037,45
3023.805257,62,81,0.42,19,0.022105263,45
3023.270943,32,59,0.98,27,0.036296296,45
3023.163468,39,54,0.52,15,0.034666667,45
3023.095297,58,96,0.99,38,0.026052632,45
3023.068008,58,95,0.98,37,0.026486486,45
3022.912482,62,80,0.5,18,0.027777778,45
3022.903817,65,86,0.56,21,0.026666667,45
3022.815324,59,86,0.58,27,0.021481481,45
3022.267948,63,82,0.52,19,0.027368421,45
3022.267948,61,84,0.63,23,0.027391304,45
3022.267948,58,88,0.82,30,0.027333333,45
3021.704038,37,54,0.61,17,0.035882353,45
3021.693479,58,89,0.81,31,0.026129032,45
3021.693479,57,91,0.88,34,0.025882353,45
3021.693479,56,92,0.93,36,0.025833333,45
3021.49461,39,51,0.44,12,0.036666667,45
3021.421472,38,50,0.45,12,0.0375,45
3021.407403,59,88,0.76,29,0.026206897,45
3021.407403,57,90,0.87,33,0.026363636,45
3021.407403,55,93,0.99,38,0.026052632,45
3021.258369,49,55,0.19,6,0.031666667,45
3021.11639,61,89,0.75,28,0.026785714,45
3021.112246,36,55,0.69,19,0.036315789,45
3021.060069,61,82,0.58,21,0.027619048,45
3020.975434,63,85,0.61,22,0.027727273,45
3020.879722,56,72,0.53,16,0.033125,45
3020.049019,69,75,0.17,6,0.028333333,45
3019.98135,62,85,0.61,23,0.026521739,45
3019.662436,33,56,0.87,23,0.037826087,45
3019.662436,32,57,0.95,25,0.038,45
3019.466768,56,72,0.52,16,0.0325,45
3019.448198,53,89,0.99,36,0.0275,45
3019.363674,64,82,0.47,18,0.026111111,45
3019.363674,61,85,0.63,24,0.02625,45
3019.363674,60,87,0.7,27,0.025925926,45
3019.363674,59,89,0.77,30,0.025666667,45
3019.352437,65,80,0.41,15,0.027333333,45
3019.352437,61,85,0.65,24,0.027083333,45
3019.352437,58,89,0.84,31,0.027096774,45
3019.107306,62,83,0.59,21,0.028095238,45
3019.077811,61,86,0.65,25,0.026,45
3019.055188,45,62,0.44,17,0.025882353,45
3018.325113,55,92,0.97,37,0.026216216,45
3018.160261,60,92,0.84,32,0.02625,45
3018.160261,59,94,0.91,35,0.026,45
3018.160261,58,94,0.95,36,0.026388889,45
3018.157095,60,93,0.86,33,0.026060606,45
3018.157095,59,93,0.9,34,0.026470588,45
3018.157095,58,95,0.97,37,0.026216216,45
3018.019724,45,60,0.46,15,0.030666667,45
3017.867796,37,56,0.67,19,0.035263158,45
3017.809606,50,76,0.92,26,0.035384615,45
3017.778856,65,79,0.4,14,0.028571429,45
3017.741713,62,93,0.57,31,0.018387097,45
3017.567876,36,54,0.67,18,0.037222222,45
3017.436119,32,57,0.92,25,0.0368,45
3017.36441,65,75,0.29,10,0.029,45
3017.362728,55,82,0.83,27,0.030740741,45
3017.075696,63,84,0.55,21,0.026190476,45
3016.432058,51,79,0.96,28,0.034285714,45
3016.073102,56,91,0.95,35,0.027142857,45
3015.995985,40,66,0.84,26,0.032307692,45
3015.923453,62,81,0.53,19,0.027894737,45
3015.435841,36,53,0.62,17,0.036470588,45
3015.423241,38,52,0.51,14,0.036428571,45
3015.423241,37,53,0.58,16,0.03625,45
3015.325712,59,87,0.59,28,0.021071429,45
3015.315198,54,83,0.9,29,0.031034483,45
3015.272005,54,87,0.96,33,0.029090909,45
3015.08325,53,77,0.84,24,0.035,45
3014.797167,67,82,0.41,15,0.027333333,45
3014.721739,34,54,0.78,20,0.039,45
3014.374813,68,73,0.14,5,0.028,45
3014.347647,33,56,0.84,23,0.036521739,45
3014.26471,67,74,0.2,7,0.028571429,45
3014.036231,68,79,0.3,11,0.027272727,45
3014.036231,66,81,0.41,15,0.027333333,45
3014.036231,64,83,0.52,19,0.027368421,45
3014.036231,64,84,0.54,20,0.027,45
3014.036231,62,86,0.65,24,0.027083333,45
3013.545803,59,83,0.68,24,0.028333333,45
3013.337194,58,92,0.91,34,0.026764706,45
3013.336902,58,89,0.87,31,0.028064516,45
3012.844624,62,89,0.71,27,0.026296296,45
3012.768071,59,90,0.84,31,0.027096774,45
3012.718762,67,78,0.23,11,0.020909091,45
3012.46779,60,67,0.25,7,0.035714286,45
3012.351151,64,83,0.49,19,0.025789474,45
3012.285641,61,89,0.76,28,0.027142857,45
3012.274996,50,78,0.97,28,0.034642857,45
3012.007215,32,57,0.96,25,0.0384,45
3012.00501,43,59,0.54,16,0.03375,45
3011.810546,53,77,0.83,24,0.034583333,45
3011.57695,60,91,0.82,31,0.026451613,45
3011.57695,58,94,0.94,36,0.026111111,45
3011.570484,35,54,0.71,19,0.037368421,45
3011.479544,44,62,0.48,18,0.026666667,45
3011.333211,33,55,0.86,22,0.039090909,45
3011.310813,60,98,0.71,38,0.018684211,45
3011.310813,59,99,0.75,40,0.01875,45
3011.301457,61,91,0.8,30,0.026666667,45
3011.283015,41,49,0.28,8,0.035,45
3011.283015,40,50,0.35,10,0.035,45
3011.249051,54,88,0.98,34,0.028823529,45
3011.128406,67,82,0.4,15,0.026666667,45
3011.128406,66,82,0.43,16,0.026875,45
3011.128406,64,85,0.56,21,0.026666667,45
3011.128406,64,86,0.58,22,0.026363636,45
3011.128406,63,87,0.63,24,0.02625,45
3011.128406,62,87,0.67,25,0.0268,45
3011.128406,62,88,0.69,26,0.026538462,45
3011.128406,61,89,0.74,28,0.026428571,45
3011.128406,60,89,0.78,29,0.026896552,45
3011.128406,60,90,0.8,30,0.026666667,45
3011.128406,60,91,0.81,31,0.026129032,45
3011.128406,59,92,0.87,33,0.026363636,45
3011.013827,59,86,0.6,27,0.022222222,45
3010.945376,34,54,0.77,20,0.0385,45
3010.831445,38,53,0.54,15,0.036,45
3010.738387,53,76,0.75,23,0.032608696,45
3010.505655,64,82,0.37,18,0.020555556,45
3010.163872,60,82,0.61,22,0.027727273,45
3009.743922,55,78,0.68,23,0.029565217,45
3009.331038,34,55,0.76,21,0.036190476,45
3009.325499,74,75,0.02,1,0.02,45
3009.325499,73,76,0.06,3,0.02,45
3009.325499,72,77,0.1,5,0.02,45
3009.325499,71,78,0.14,7,0.02,45
3009.325499,70,79,0.18,9,0.02,45
3009.325499,69,80,0.22,11,0.02,45
3009.267149,64,78,0.32,14,0.022857143,45
3009.265172,43,65,0.57,22,0.025909091,45
3009.222925,51,75,0.85,24,0.035416667,45
3008.912627,57,83,0.75,26,0.028846154,45
3008.912627,56,84,0.81,28,0.028928571,45
3008.406259,43,61,0.58,18,0.032222222,45
3008.257364,44,56,0.41,12,0.034166667,45
3008.045559,51,77,0.87,26,0.033461538,45
3008.017001,36,53,0.63,17,0.037058824,45
3007.842671,66,75,0.25,9,0.027777778,45
3007.824709,55,84,0.83,29,0.02862069,45
3007.588246,35,55,0.75,20,0.0375,45
3007.150491,57,90,0.88,33,0.026666667,45
3007.047339,63,89,0.67,26,0.025769231,45
3007.047339,59,94,0.9,35,0.025714286,45
3006.70524,59,67,0.27,8,0.03375,45
3006.348474,58,93,0.74,35,0.021142857,45
3006.262963,54,73,0.64,19,0.033684211,45
3006.033821,62,83,0.46,21,0.021904762,45
3006.028869,62,84,0.46,22,0.020909091,45
3005.971329,57,94,0.79,37,0.021351351,45
3005.894556,52,82,0.9,30,0.03,45
3005.894556,51,83,0.96,32,0.03,45
3005.812686,55,86,0.9,31,0.029032258,45
3005.70711,68,79,0.22,11,0.02,45
3005.70711,67,80,0.26,13,0.02,45
3005.70711,66,81,0.3,15,0.02,45
3005.70711,65,82,0.34,17,0.02,45
3005.70711,64,83,0.38,19,0.02,45
3005.522889,52,79,0.93,27,0.034444444,45
3005.348719,56,77,0.62,21,0.02952381,45
3005.127198,54,85,0.89,31,0.028709677,45
3005.084369,56,90,0.9,34,0.026470588,45
3005.001117,60,88,0.78,28,0.027857143,45
3004.956168,46,61,0.39,15,0.026,45
3004.949322,71,76,0.14,5,0.028,45
3004.949322,66,81,0.42,15,0.028,45
3004.855821,68,77,0.19,9,0.021111111,45
3004.799815,55,91,0.96,36,0.026666667,45
3004.744747,53,81,0.84,28,0.03,45
3004.615663,42,49,0.26,7,0.037142857,45
3004.084701,54,72,0.64,18,0.035555556,45
3004.076137,35,53,0.69,18,0.038333333,45
3003.931073,59,91,0.86,32,0.026875,45
3003.931073,58,91,0.9,33,0.027272727,45
3003.89433,70,77,0.19,7,0.027142857,45
3003.823125,62,80,0.41,18,0.022777778,45
3002.83284,55,77,0.75,22,0.034090909,45
3002.83284,54,78,0.82,24,0.034166667,45
3002.789861,58,89,0.82,31,0.026451613,45
3002.789861,56,91,0.93,35,0.026571429,45
3002.719323,61,83,0.6,22,0.027272727,45
3002.719323,59,85,0.71,26,0.027307692,45
3002.719323,57,87,0.82,30,0.027333333,45
3002.711923,53,73,0.71,20,0.0355,45
3002.70427,46,58,0.37,12,0.030833333,45
3002.549713,57,73,0.55,16,0.034375,45
3002.549713,56,74,0.62,18,0.034444444,45
3002.549713,55,75,0.69,20,0.0345,45
3002.242429,52,78,0.89,26,0.034230769,45
3002.092481,54,76,0.76,22,0.034545455,45
3002.091376,61,86,0.67,25,0.0268,45
3001.804587,61,81,0.56,20,0.028,45
3001.708886,36,58,0.76,22,0.034545455,45
3001.671521,43,64,0.55,21,0.026190476,45
3000.995975,71,77,0.16,6,0.026666667,45
3000.995975,69,80,0.29,11,0.026363636,45
3000.995975,66,83,0.45,17,0.026470588,45
3000.732954,35,53,0.7,18,0.038888889,45
3000.657196,65,79,0.37,14,0.026428571,45
3000.470813,65,90,0.46,25,0.0184,45
3000.42168,34,53,0.73,19,0.038421053,45
3000.403678,66,77,0.3,11,0.027272727,45
3000.403678,64,79,0.41,15,0.027333333,45
3000.403678,62,81,0.52,19,0.027368421,45
3000.403678,62,82,0.54,20,0.027,45
3000.259261,65,89,0.45,24,0.01875,45
3000.054313,69,82,0.32,13,0.024615385,45
3000.006845,58,89,0.85,31,0.027419355,45
3000.006845,56,92,0.98,36,0.027222222,45
2999.894848,60,68,0.26,8,0.0325,45
2999.894848,58,70,0.39,12,0.0325,45
2999.648079,37,55,0.67,18,0.037222222,45
2999.298442,57,71,0.48,14,0.034285714,45
2999.212028,56,93,0.95,37,0.025675676,45
2999.078144,62,91,0.72,29,0.024827586,45
2999.078144,60,94,0.84,34,0.024705882,45
2998.928012,58,90,0.83,32,0.0259375,45
2998.928012,56,92,0.94,36,0.026111111,45
2998.745502,62,89,0.73,27,0.027037037,45
2998.745502,60,92,0.86,32,0.026875,45
2998.687564,57,79,0.69,22,0.031363636,45
2998.590368,62,83,0.55,21,0.026190476,45
2998.562104,61,82,0.46,21,0.021904762,45
2998.170983,51,85,0.95,34,0.027941176,45
2997.935562,58,94,0.97,36,0.026944444,45
2997.648192,61,88,0.56,27,0.020740741,45
2997.553821,64,91,0.5,27,0.018518519,45
2997.446697,33,96,0.13,63,0.002063492,45
2997.39946,56,81,0.77,25,0.0308,45
2997.39946,53,85,0.98,32,0.030625,45
2997.354524,67,75,0.18,8,0.0225,45
2997.354524,65,77,0.27,12,0.0225,45
2997.11212,56,92,0.97,36,0.026944444,45
2996.933118,60,94,0.85,34,0.025,45
2996.786868,56,93,0.94,37,0.025405405,45
2996.786868,55,94,0.99,39,0.025384615,45
2996.307545,61,83,0.48,22,0.021818182,45
2996.276507,51,84,0.97,33,0.029393939,45
2996.255153,54,80,0.77,26,0.029615385,45
2996.255153,53,81,0.83,28,0.029642857,45
2996.255153,51,84,0.98,33,0.02969697,45
2996.203117,50,77,0.9,27,0.033333333,45
2996.203117,49,78,0.97,29,0.033448276,45
2996.131192,50,77,0.91,27,0.033703704,45
2995.855996,60,85,0.7,25,0.028,45
2995.855996,56,90,0.95,34,0.027941176,45
2995.697568,58,82,0.7,24,0.029166667,45
2995.697568,56,85,0.84,29,0.028965517,45
2995.660847,47,57,0.33,10,0.033,45
2995.585012,46,59,0.4,13,0.030769231,45
2995.548133,56,82,0.78,26,0.03,45
2995.384206,58,83,0.71,25,0.0284,45
2995.375612,66,78,0.34,12,0.028333333,45
2995.343933,56,93,0.79,37,0.021351351,45
2995.224507,49,75,0.96,26,0.036923077,45
2995.223164,58,75,0.51,17,0.03,45
2995.117682,65,81,0.43,16,0.026875,45
2994.905056,32,58,0.95,26,0.036538462,45
2994.859395,59,68,0.32,9,0.035555556,45
2994.765814,45,59,0.45,14,0.032142857,45
2994.699588,61,90,0.79,29,0.027241379,45
2994.699588,59,92,0.9,33,0.027272727,45
2994.699588,58,93,0.96,35,0.027428571,45
2994.699588,58,94,0.98,36,0.027222222,45
2994.575013,59,87,0.61,28,0.021785714,45
2994.557172,56,71,0.51,15,0.034,45
2994.479327,58,69,0.38,11,0.034545455,45
2994.384937,64,81,0.36,17,0.021176471,45
2994.357234,65,91,0.47,26,0.018076923,45
2993.399098,44,46,0.07,2,0.035,45
2993.399098,43,47,0.14,4,0.035,45
2993.399098,42,48,0.21,6,0.035,45
2993.369168,65,87,0.54,22,0.024545455,45
2993.369168,64,88,0.59,24,0.024583333,45
2993.369168,63,89,0.64,26,0.024615385,45
2993.369168,63,90,0.66,27,0.024444444,45
2993.369168,62,90,0.69,28,0.024642857,45
2993.369168,62,91,0.71,29,0.024482759,45
2993.369168,61,91,0.74,30,0.024666667,45
2993.369168,61,92,0.76,31,0.024516129,45
2992.908191,54,75,0.74,21,0.035238095,45
2992.908191,53,76,0.81,23,0.035217391,45
2992.726179,50,78,0.94,28,0.033571429,45
2992.311754,58,95,0.99,37,0.026756757,45
2992.273114,36,58,0.78,22,0.035454545,45
2992.049202,38,55,0.6,17,0.035294118,45
2992.017345,58,96,0.98,38,0.025789474,45
2991.712395,59,83,0.67,24,0.027916667,45
2991.554629,59,93,0.89,34,0.026176471,45
2991.494652,62,87,0.69,25,0.0276,45
2991.494652,60,89,0.8,29,0.027586207,45
2991.494652,59,90,0.86,31,0.027741935,45
2991.342525,57,69,0.43,12,0.035833333,45
2991.074621,38,52,0.48,14,0.034285714,45
2991.060502,74,76,0.05,2,0.025,45
2991.060502,73,77,0.1,4,0.025,45
2991.060502,72,78,0.15,6,0.025,45
2991.060502,68,83,0.37,15,0.024666667,45
2991.060502,67,84,0.42,17,0.024705882,45
2991.060502,66,85,0.47,19,0.024736842,45
2991.060502,66,86,0.49,20,0.0245,45
2991.060502,65,86,0.52,21,0.024761905,45
2990.77356,33,55,0.85,22,0.038636364,45
2990.455119,62,82,0.43,20,0.0215,45
2990.19106,65,81,0.33,16,0.020625,45
2989.750468,53,81,0.82,28,0.029285714,45
2989.750468,52,82,0.88,30,0.029333333,45
2989.729159,54,80,0.76,26,0.029230769,45
2989.727456,61,84,0.64,23,0.027826087,45
2989.727456,59,86,0.75,27,0.027777778,45
2989.727456,59,87,0.77,28,0.0275,45
2989.727456,58,88,0.83,30,0.027666667,45
2989.727456,57,89,0.88,32,0.0275,45
2989.727456,57,89,0.89,32,0.0278125,45
2989.727456,57,90,0.9,33,0.027272727,45
2989.727456,56,90,0.94,34,0.027647059,45
2989.727456,56,91,0.96,35,0.027428571,45
2989.625402,65,85,0.39,20,0.0195,45
2989.600804,66,78,0.32,12,0.026666667,45
2989.585606,48,58,0.26,10,0.026,45
2989.455569,34,54,0.76,20,0.038,45
2989.355686,52,74,0.78,22,0.035454545,45
2988.976902,41,67,0.68,26,0.026153846,45
2988.716155,50,77,0.92,27,0.034074074,45
2988.601203,54,75,0.68,21,0.032380952,45
2988.601203,52,77,0.81,25,0.0324,45
2988.601203,51,78,0.88,27,0.032592593,45
2988.573337,59,93,0.92,34,0.027058824,45
2988.557313,66,76,0.28,10,0.028,45
2988.557313,65,78,0.36,13,0.027692308,45
2988.432244,55,92,0.96,37,0.025945946,45
2988.419518,67,82,0.3,15,0.02,45
2988.408905,57,86,0.82,29,0.028275862,45
2987.972338,51,76,0.84,25,0.0336,45
2987.971024,62,88,0.7,26,0.026923077,45
2987.971024,60,90,0.81,30,0.027,45
2987.862763,45,58,0.44,13,0.033846154,45
2987.862763,44,59,0.51,15,0.034,45
2987.628183,53,74,0.71,21,0.033809524,45
2987.34545,52,75,0.81,23,0.035217391,45
2987.250252,68,80,0.32,12,0.026666667,45
2987.183173,57,91,0.89,34,0.026176471,45
2987.148801,46,59,0.34,13,0.026153846,45
2986.855405,54,89,0.98,35,0.028,45
2986.76987,44,58,0.47,14,0.033571429,45
2986.719304,61,91,0.78,30,0.026,45
2986.719304,60,92,0.83,32,0.0259375,45
2986.429745,53,77,0.55,24,0.022916667,45
2986.125518,65,81,0.34,16,0.02125,45
2985.999217,42,63,0.69,21,0.032857143,45
2985.983563,44,47,0.11,3,0.036666667,45
2985.959917,58,77,0.61,19,0.032105263,45
2985.924264,55,91,0.8,36,0.022222222,45
2985.796993,58,96,0.97,38,0.025526316,45
2985.73755,59,95,0.89,36,0.024722222,45
2985.73755,58,96,0.94,38,0.024736842,45
2985.561907,70,84,0.26,14,0.018571429,45
2985.489229,61,92,0.8,31,0.025806452,45
2985.462269,60,93,0.85,33,0.025757576,45
2985.267499,57,92,0.97,35,0.027714286,45
2985.157612,59,74,0.5,15,0.033333333,45
2984.969648,63,84,0.59,21,0.028095238,45
2984.954659,54,81,0.76,27,0.028148148,45
2984.787215,54,84,0.9,30,0.03,45
2984.776122,52,80,0.94,28,0.033571429,45
2984.059547,66,84,0.35,18,0.019444444,45
2984.025132,35,59,0.85,24,0.035416667,45
2983.919072,56,82,0.76,26,0.029230769,45
2983.908864,60,85,0.53,25,0.0212,45
2983.683391,56,72,0.55,16,0.034375,45
2983.615605,53,78,0.84,25,0.0336,45
2983.232645,60,69,0.29,9,0.032222222,45
2983.232645,58,71,0.42,13,0.032307692,45
2983.232645,56,73,0.55,17,0.032352941,45
2983.075465,38,49,0.43,11,0.039090909,45
2982.780325,61,82,0.6,21,0.028571429,45
2982.759213,39,70,0.81,31,0.026129032,45
2982.756802,59,91,0.88,32,0.0275,45
2982.679583,62,87,0.51,25,0.0204,45
2982.660209,45,57,0.4,12,0.033333333,45
2982.421685,36,53,0.61,17,0.035882353,45
2982.313829,56,85,0.81,29,0.027931034,45
2982.247498,58,86,0.61,28,0.021785714,45
2981.878837,55,73,0.64,18,0.035555556,45
2981.878837,54,74,0.71,20,0.0355,45
2981.864424,60,87,0.56,27,0.020740741,45
2981.795765,60,87,0.73,27,0.027037037,45
2981.763337,67,75,0.23,8,0.02875,45
2981.763337,60,83,0.66,23,0.028695652,45
2981.763337,58,86,0.8,28,0.028571429,45
2981.702815,62,75,0.4,13,0.030769231,45
2981.650389,55,73,0.62,18,0.034444444,45
2981.650389,54,74,0.69,20,0.0345,45
2981.629797,58,92,0.92,34,0.027058824,45
2981.629797,58,93,0.94,35,0.026857143,45
2981.355888,58,97,0.97,39,0.024871795,45
2981.280911,66,80,0.39,14,0.027857143,45
2981.168494,56,74,0.61,18,0.033888889,45
2981.07296,56,92,0.95,36,0.026388889,45
2981.061701,58,70,0.41,12,0.034166667,45
2981.050352,56,86,0.84,30,0.028,45
2981.040634,45,55,0.34,10,0.034,45
2980.999724,62,67,0.17,5,0.034,45
2980.915647,44,63,0.49,19,0.025789474,45
2980.896873,66,82,0.31,16,0.019375,45
2980.886386,57,93,0.97,36,0.026944444,45
2980.6572,60,94,0.86,34,0.025294118,45
2980.493423,55,93,0.98,38,0.025789474,45
2980.298206,62,84,0.61,22,0.027727273,45
2980.298206,59,88,0.8,29,0.027586207,45
2980.283966,54,75,0.49,21,0.023333333,45
2980.169773,52,80,0.95,28,0.033928571,45
2980.079195,55,88,0.95,33,0.028787879,45
2979.93208,57,93,0.99,36,0.0275,45
2979.776006,57,92,0.74,35,0.021142857,45
2979.664724,65,79,0.39,14,0.027857143,45
2979.664724,62,83,0.58,21,0.027619048,45
2979.664724,60,85,0.69,25,0.0276,45
2979.664724,60,86,0.71,26,0.027307692,45
2979.346644,60,85,0.56,25,0.0224,45
2979.270224,53,75,0.73,22,0.033181818,45
2978.918188,58,68,0.34,10,0.034,45
2978.868052,54,87,0.94,33,0.028484848,45
2978.829435,60,84,0.65,24,0.027083333,45
2978.829435,58,86,0.76,28,0.027142857,45
2978.816079,52,81,0.97,29,0.033448276,45
2978.809171,34,56,0.81,22,0.036818182,45
2978.809171,32,59,0.99,27,0.036666667,45
2978.752232,59,92,0.88,33,0.026666667,45
2978.752232,57,94,0.99,37,0.026756757,45
2978.449258,60,85,0.54,25,0.0216,45
2978.405222,51,80,0.98,29,0.033793103,45
2978.398805,66,79,0.34,13,0.026153846,45
2977.681237,42,64,0.71,22,0.032272727,45
2977.506551,47,58,0.29,11,0.026363636,45
2977.023342,41,48,0.26,7,0.037142857,45
2976.98788,57,70,0.43,13,0.033076923,45
2976.53162,68,75,0.19,7,0.027142857,45
2976.40941,66,78,0.27,12,0.0225,45
2976.255474,60,87,0.75,27,0.027777778,45
2976.172978,47,57,0.32,10,0.032,45
2976.032621,55,72,0.56,17,0.032941176,45
2976.032621,54,73,0.63,19,0.033157895,45
2975.495267,59,69,0.33,10,0.033,45
2975.490293,50,78,0.93,28,0.033214286,45
2975.44508,53,84,0.97,31,0.031290323,45
2975.416822,52,75,0.78,23,0.033913043,45
2975.318428,56,90,0.89,34,0.026176471,45
2975.262007,63,80,0.47,17,0.027647059,45
2975.069448,55,98,0.87,43,0.020232558,45
2975.065572,53,76,0.54,23,0.023478261,45
2974.948515,64,76,0.35,12,0.029166667,45
2974.867697,66,80,0.38,14,0.027142857,45
2974.749329,51,79,0.98,28,0.035,45
2974.733712,67,88,0.39,21,0.018571429,45
2974.685853,59,94,0.93,35,0.026571429,45
2974.055361,51,76,0.88,25,0.0352,45
2974.055361,50,77,0.95,27,0.035185185,45
2974.041826,41,50,0.31,9,0.034444444,45
2973.834128,59,74,0.45,15,0.03,45
2973.689343,57,70,0.44,13,0.033846154,45
2973.673323,59,84,0.72,25,0.0288,45
2973.562362,64,79,0.42,15,0.028,45
2973.430132,39,53,0.51,14,0.036428571,45
2973.151874,63,83,0.52,20,0.026,45
2973.151874,63,84,0.54,21,0.025714286,45
2973.151874,62,85,0.59,23,0.025652174,45
2972.758876,63,84,0.43,21,0.02047619,45
2972.742261,56,85,0.83,29,0.02862069,45
2972.742261,55,86,0.89,31,0.028709677,45
2972.707596,54,72,0.56,18,0.031111111,45
2972.484987,62,66,0.13,4,0.0325,45
2972.4216,57,87,0.86,30,0.028666667,45
2972.353133,38,71,0.86,33,0.026060606,45
2972.256097,56,78,0.65,22,0.029545455,45
2972.228902,47,58,0.33,11,0.03,45
2972.071623,56,81,0.71,25,0.0284,45
2972.071623,56,82,0.73,26,0.028076923,45
2971.970095,58,72,0.48,14,0.034285714,45
2971.929317,59,81,0.63,22,0.028636364,45
2971.599446,54,75,0.73,21,0.034761905,45
2971.576763,69,76,0.19,7,0.027142857,45
2971.576763,67,78,0.3,11,0.027272727,45
2971.576763,63,83,0.54,20,0.027,45
2971.445177,57,69,0.41,12,0.034166667,45
2971.219996,59,86,0.59,27,0.021851852,45
2971.197275,57,77,0.59,20,0.0295,45
2971.138092,64,88,0.6,24,0.025,45
2971.138092,63,89,0.65,26,0.025,45
2971.138092,61,92,0.77,31,0.02483871,45
2970.626107,52,76,0.79,24,0.032916667,45
2970.249261,52,76,0.8,24,0.033333333,45
2970.23027,51,76,0.85,25,0.034,45
2970.189913,58,95,0.93,37,0.025135135,45
2970.002885,62,86,0.67,24,0.027916667,45
2970.002885,59,89,0.84,30,0.028,45
2969.857753,58,69,0.39,11,0.035454545,45
2969.857753,57,70,0.46,13,0.035384615,45
2969.857753,57,71,0.49,14,0.035,45
2969.857753,56,71,0.53,15,0.035333333,45
2969.857753,56,72,0.56,16,0.035,45
2969.857753,55,73,0.63,18,0.035,45
2969.857753,54,74,0.7,20,0.035,45
2969.857753,53,76,0.8,23,0.034782609,45
2969.690508,63,79,0.46,16,0.02875,45
2969.690508,55,89,0.97,34,0.028529412,45
2969.59826,56,71,0.54,15,0.036,45
2969.476672,58,93,0.95,35,0.027142857,45
2969.234238,52,79,0.92,27,0.034074074,45
2969.20827,56,71,0.5,15,0.033333333,45
2968.968999,61,93,0.77,32,0.0240625,45
2968.968999,60,94,0.82,34,0.024117647,45
2968.777508,41,61,0.68,20,0.034,45
2968.312162,60,67,0.23,7,0.032857143,45
2968.312162,53,74,0.7,21,0.033333333,45
2968.312162,53,75,0.72,22,0.032727273,45
2968.273273,62,89,0.69,27,0.025555556,45
2968.09235,53,86,0.98,33,0.02969697,45
2967.990818,52,77,0.58,25,0.0232,45
2967.978902,58,91,0.92,33,0.027878788,45
2967.96406,66,77,0.24,11,0.021818182,45
2967.959412,43,60,0.58,17,0.034117647,45
2967.870446,58,94,0.93,36,0.025833333,45
2967.842757,62,81,0.54,19,0.028421053,45
2967.313506,68,82,0.36,14,0.025714286,45
2967.160768,57,88,0.84,31,0.027096774,45
2967.050913,42,64,0.59,22,0.026818182,45
2966.954573,64,78,0.4,14,0.028571429,45
2966.901496,51,76,0.89,25,0.0356,45
