% profit,ema1,ema2,threshold,diff,thresh / diff,ID
3358.428401,41,51,0.37,10,0.037,14
3334.710864,40,52,0.45,12,0.0375,14
3320.144326,40,47,0.27,7,0.038571429,14
3317.596951,36,58,0.79,22,0.035909091,14
3299.811404,34,54,0.77,20,0.0385,14
3289.451107,37,56,0.7,19,0.036842105,14
3274.960965,38,55,0.62,17,0.036470588,14
3249.085523,63,67,0.13,4,0.0325,14
3249.085523,61,69,0.26,8,0.0325,14
3249.042401,39,48,0.35,9,0.038888889,14
3249.027639,35,53,0.69,18,0.038333333,14
3244.010258,36,56,0.69,20,0.0345,14
3239.669562,61,68,0.23,7,0.032857143,14
3233.362214,34,54,0.78,20,0.039,14
3222.217049,34,60,0.88,26,0.033846154,14
3220.916893,33,55,0.86,22,0.039090909,14
3213.861664,40,50,0.37,10,0.037,14
3207.955448,35,53,0.7,18,0.038888889,14
3199.981896,36,52,0.62,16,0.03875,14
3184.377186,40,53,0.43,13,0.033076923,14
3180.157932,38,54,0.55,16,0.034375,14
3165.394991,34,58,0.88,24,0.036666667,14
3163.48649,40,52,0.44,12,0.036666667,14
3162.840787,42,50,0.29,8,0.03625,14
3159.099914,33,59,0.98,26,0.037692308,14
3156.91855,37,55,0.62,18,0.034444444,14
3156.808664,37,56,0.71,19,0.037368421,14
3151.021462,34,59,0.86,25,0.0344,14
3139.528171,41,47,0.23,6,0.038333333,14
3139.459097,36,54,0.68,18,0.037777778,14
3138.465674,41,48,0.25,7,0.035714286,14
3136.931173,40,53,0.44,13,0.033846154,14
3136.931173,39,54,0.51,15,0.034,14
3136.195176,58,71,0.43,13,0.033076923,14
3133.004768,36,57,0.71,21,0.033809524,14
3128.918015,43,50,0.25,7,0.035714286,14
3123.684877,33,59,0.96,26,0.036923077,14
3117.773309,38,54,0.59,16,0.036875,14
3114.502727,36,58,0.8,22,0.036363636,14
3112.66377,38,52,0.52,14,0.037142857,14
3111.495282,34,57,0.85,23,0.036956522,14
3105.135137,33,59,0.97,26,0.037307692,14
3101.461669,35,59,0.88,24,0.036666667,14
3097.666553,32,57,0.96,25,0.0384,14
3096.860404,37,53,0.6,16,0.0375,14
3091.959809,40,51,0.38,11,0.034545455,14
3091.375232,36,55,0.7,19,0.036842105,14
3091.349742,39,49,0.38,10,0.038,14
3089.249434,41,52,0.37,11,0.033636364,14
3084.115139,61,70,0.29,9,0.032222222,14
3081.871106,38,56,0.59,18,0.032777778,14
3081.680672,37,54,0.64,17,0.037647059,14
3081.328553,38,50,0.46,12,0.038333333,14
3081.328553,37,51,0.54,14,0.038571429,14
3079.595135,60,69,0.3,9,0.033333333,14
3079.595135,55,75,0.66,20,0.033,14
3077.085346,37,53,0.61,16,0.038125,14
3073.782133,57,72,0.5,15,0.033333333,14
3073.081395,41,51,0.36,10,0.036,14
3071.492876,39,57,0.58,18,0.032222222,14
3070.764601,36,54,0.67,18,0.037222222,14
3070.336749,39,53,0.51,14,0.036428571,14
3068.412925,38,53,0.52,15,0.034666667,14
3065.082048,39,52,0.45,13,0.034615385,14
3063.63393,35,56,0.79,21,0.037619048,14
3062.249278,38,55,0.58,17,0.034117647,14
3061.913415,60,68,0.27,8,0.03375,14
3061.406062,59,71,0.4,12,0.033333333,14
3059.969137,59,72,0.42,13,0.032307692,14
3059.382699,53,77,0.81,24,0.03375,14
3059.382699,52,78,0.88,26,0.033846154,14
3059.072168,39,51,0.45,12,0.0375,14
3059.012116,53,78,0.83,25,0.0332,14
3058.432294,56,73,0.57,17,0.033529412,14
3053.183311,51,80,0.97,29,0.033448276,14
3047.465137,35,57,0.82,22,0.037272727,14
3045.838401,63,66,0.1,3,0.033333333,14
3045.838401,60,70,0.33,10,0.033,14
3045.838401,58,72,0.46,14,0.032857143,14
3044.122245,53,77,0.8,24,0.033333333,14
3044.122245,52,78,0.87,26,0.033461538,14
3043.758176,56,74,0.6,18,0.033333333,14
3042.328838,34,58,0.9,24,0.0375,14
3040.054787,41,50,0.34,9,0.037777778,14
3039.833398,41,49,0.28,8,0.035,14
3039.466332,37,55,0.67,18,0.037222222,14
3038.901424,56,73,0.58,17,0.034117647,14
3037.356838,34,57,0.86,23,0.037391304,14
3037.198393,37,56,0.65,19,0.034210526,14
3035.638943,34,61,0.97,27,0.035925926,14
3033.235146,38,52,0.53,14,0.037857143,14
3031.347849,42,49,0.24,7,0.034285714,14
3031.048104,36,55,0.67,19,0.035263158,14
3030.679542,55,74,0.65,19,0.034210526,14
3030.679542,54,75,0.72,21,0.034285714,14
3030.43012,38,53,0.53,15,0.035333333,14
3030.055922,54,76,0.73,22,0.033181818,14
3028.480749,39,53,0.52,14,0.037142857,14
3028.368162,57,72,0.51,15,0.034,14
3028.150066,51,79,0.95,28,0.033928571,14
3028.004894,36,56,0.75,20,0.0375,14
3027.535331,44,71,0.83,27,0.030740741,14
3024.571935,56,75,0.62,19,0.032631579,14
3024.53594,38,53,0.56,15,0.037333333,14
3024.288059,39,53,0.48,14,0.034285714,14
3024.138249,35,56,0.78,21,0.037142857,14
3024.062248,41,50,0.31,9,0.034444444,14
3023.791671,63,70,0.22,7,0.031428571,14
3022.229631,58,71,0.44,13,0.033846154,14
3021.585359,42,49,0.26,7,0.037142857,14
3021.585359,40,51,0.41,11,0.037272727,14
3019.899397,43,72,0.89,29,0.030689655,14
3019.865351,52,79,0.9,27,0.033333333,14
3019.706982,55,75,0.67,20,0.0335,14
3019.706982,54,76,0.74,22,0.033636364,14
3018.867957,54,77,0.76,23,0.033043478,14
3018.734566,43,49,0.22,6,0.036666667,14
3018.632419,37,56,0.69,19,0.036315789,14
3017.116311,36,56,0.74,20,0.037,14
3016.578215,35,55,0.76,20,0.038,14
3015.65321,39,54,0.54,15,0.036,14
3015.31153,38,56,0.6,18,0.033333333,14
3014.965283,40,49,0.34,9,0.037777778,14
3013.167126,22,34,0.06,12,0.005,14
3011.1492,42,47,0.19,5,0.038,14
3007.431915,39,50,0.4,11,0.036363636,14
3006.351149,38,54,0.58,16,0.03625,14
3006.065901,38,50,0.42,12,0.035,14
3006.063442,42,51,0.32,9,0.035555556,14
3006.000469,40,55,0.49,15,0.032666667,14
3004.914618,55,76,0.69,21,0.032857143,14
3004.106698,35,57,0.8,22,0.036363636,14
3004.084998,53,90,0.96,37,0.025945946,14
3003.822624,32,56,0.95,24,0.039583333,14
3001.441093,55,88,0.85,33,0.025757576,14
3001.110034,38,51,0.49,13,0.037692308,14
2998.869341,37,51,0.49,14,0.035,14
2998.23574,33,60,0.98,27,0.036296296,14
2997.472943,23,32,0.05,9,0.005555556,14
2996.825129,57,73,0.53,16,0.033125,14
2992.631675,42,47,0.18,5,0.036,14
2992.612554,34,58,0.91,24,0.037916667,14
2992.541919,57,71,0.48,14,0.034285714,14
2992.537272,51,79,0.94,28,0.033571429,14
2992.38029,55,74,0.64,19,0.033684211,14
2992.177829,56,72,0.55,16,0.034375,14
2992.177829,55,73,0.62,18,0.034444444,14
2992.034289,38,49,0.42,11,0.038181818,14
2991.760915,33,56,0.88,23,0.03826087,14
2991.641395,32,57,0.97,25,0.0388,14
2989.619034,59,70,0.37,11,0.033636364,14
2988.978075,40,50,0.38,10,0.038,14
2987.575194,39,54,0.5,15,0.033333333,14
2986.829523,63,69,0.19,6,0.031666667,14
2986.785893,44,46,0.07,2,0.035,14
2986.785893,43,47,0.14,4,0.035,14
2986.613699,40,52,0.4,12,0.033333333,14
2986.266756,34,57,0.87,23,0.037826087,14
2985.056168,35,59,0.89,24,0.037083333,14
2982.45504,37,54,0.6,17,0.035294118,14
2981.66862,46,68,0.68,22,0.030909091,14
2980.446525,39,52,0.49,13,0.037692308,14
2979.772974,34,55,0.8,21,0.038095238,14
2979.551507,59,69,0.34,10,0.034,14
2979.38577,44,72,0.85,28,0.030357143,14
2979.315121,53,76,0.79,23,0.034347826,14
2979.113946,41,47,0.22,6,0.036666667,14
2978.772085,42,48,0.21,6,0.035,14
2977.576677,58,70,0.41,12,0.034166667,14
2977.576677,52,77,0.85,25,0.034,14
2976.058805,34,62,0.91,28,0.0325,14
2972.359617,33,60,0.99,27,0.036666667,14
2971.604445,53,91,0.97,38,0.025526316,14
2971.537809,53,76,0.78,23,0.033913043,14
2971.389016,37,57,0.67,20,0.0335,14
2969.534248,34,59,0.9,25,0.036,14
2968.414797,55,89,0.86,34,0.025294118,14
2967.835222,22,33,0.06,11,0.005454545,14
2967.579738,37,55,0.66,18,0.036666667,14
2965.729572,39,48,0.34,9,0.037777778,14
2965.11313,33,58,0.95,25,0.038,14
2964.521659,36,55,0.72,19,0.037894737,14
2964.379196,38,54,0.6,16,0.0375,14
2963.549484,24,31,0.03,7,0.004285714,14
2963.153652,38,55,0.61,17,0.035882353,14
2962.657276,33,58,0.93,25,0.0372,14
2961.970052,54,74,0.69,20,0.0345,14
2961.970052,52,77,0.86,25,0.0344,14
2961.319185,35,56,0.8,21,0.038095238,14
2958.03776,32,58,0.99,26,0.038076923,14
2957.543521,39,49,0.37,10,0.037,14
2957.083188,35,57,0.83,22,0.037727273,14
2956.639927,42,49,0.27,7,0.038571429,14
2956.301995,36,53,0.64,17,0.037647059,14
2956.301995,35,54,0.72,19,0.037894737,14
2955.564419,39,51,0.43,12,0.035833333,14
2955.534549,36,51,0.59,15,0.039333333,14
2954.059233,54,75,0.71,21,0.033809524,14
2953.869155,41,51,0.34,10,0.034,14
2952.928803,42,50,0.27,8,0.03375,14
2952.565755,35,59,0.81,24,0.03375,14
2949.177596,37,50,0.51,13,0.039230769,14
2948.977933,38,48,0.39,10,0.039,14
2948.664457,53,92,0.99,39,0.025384615,14
2947.962042,34,56,0.84,22,0.038181818,14
2947.399986,39,47,0.31,8,0.03875,14
2947.262947,34,59,0.92,25,0.0368,14
2947.24585,43,50,0.26,7,0.037142857,14
2946.91252,43,51,0.29,8,0.03625,14
2944.031696,43,73,0.91,30,0.030333333,14
2943.39039,40,53,0.47,13,0.036153846,14
2943.184914,39,52,0.48,13,0.036923077,14
2942.450738,34,60,0.97,26,0.037307692,14
2940.640336,51,78,0.92,27,0.034074074,14
2939.676093,40,52,0.41,12,0.034166667,14
2939.378136,35,58,0.79,23,0.034347826,14
2938.359864,35,53,0.71,18,0.039444444,14
2938.066384,22,32,0.06,10,0.006,14
2937.001466,39,53,0.53,14,0.037857143,14
2936.229546,34,61,0.96,27,0.035555556,14
2935.102576,43,47,0.15,4,0.0375,14
2934.408857,51,88,0.97,37,0.026216216,14
2930.837906,55,83,0.74,28,0.026428571,14
2930.080031,50,79,0.99,29,0.034137931,14
2928.655297,37,50,0.5,13,0.038461538,14
2928.118203,33,57,0.92,24,0.038333333,14
2927.519792,56,87,0.8,31,0.025806452,14
2926.9763,38,55,0.57,17,0.033529412,14
2925.198022,34,54,0.79,20,0.0395,14
2924.930723,33,59,0.99,26,0.038076923,14
2924.217219,44,70,0.82,26,0.031538462,14
2923.304271,36,57,0.76,21,0.036190476,14
2921.724308,35,59,0.87,24,0.03625,14
2920.825472,36,58,0.74,22,0.033636364,14
2920.820498,36,53,0.65,17,0.038235294,14
2920.820498,35,54,0.73,19,0.038421053,14
2920.657107,53,92,0.98,39,0.025128205,14
2918.884412,54,89,0.91,35,0.026,14
2917.915071,45,71,0.79,26,0.030384615,14
2917.652358,37,56,0.68,19,0.035789474,14
2916.506158,35,55,0.75,20,0.0375,14
2914.976918,37,52,0.57,15,0.038,14
2914.858973,42,50,0.3,8,0.0375,14
2914.388813,33,58,0.94,25,0.0376,14
2913.710867,38,51,0.5,13,0.038461538,14
2913.296779,32,56,0.94,24,0.039166667,14
2911.828637,34,55,0.81,21,0.038571429,14
2910.631992,39,56,0.56,17,0.032941176,14
2909.183812,37,54,0.63,17,0.037058824,14
2909.183812,36,55,0.71,19,0.037368421,14
2909.098147,51,89,0.99,38,0.026052632,14
2909.086977,54,90,0.92,36,0.025555556,14
2908.611939,59,78,0.51,19,0.026842105,14
2908.611939,56,82,0.69,26,0.026538462,14
2908.487364,57,80,0.62,23,0.026956522,14
2907.920145,41,50,0.33,9,0.036666667,14
2907.463654,37,57,0.66,20,0.033,14
2907.263047,37,53,0.57,16,0.035625,14
2907.232621,34,60,0.95,26,0.036538462,14
2906.836485,44,47,0.11,3,0.036666667,14
2906.56291,35,54,0.66,19,0.034736842,14
2906.339766,38,49,0.43,11,0.039090909,14
2904.127798,38,56,0.64,18,0.035555556,14
2903.597544,57,84,0.73,27,0.027037037,14
2903.597544,55,86,0.84,31,0.027096774,14
2903.295463,33,56,0.89,23,0.038695652,14
2903.104993,53,91,0.98,38,0.025789474,14
2902.73189,36,61,0.8,25,0.032,14
2902.728444,36,56,0.7,20,0.035,14
2901.974968,44,50,0.2,6,0.033333333,14
2901.238131,44,49,0.18,5,0.036,14
2899.21969,38,54,0.61,16,0.038125,14
2898.890861,45,69,0.75,24,0.03125,14
2898.418634,39,50,0.42,11,0.038181818,14
2897.800167,34,58,0.89,24,0.037083333,14
2896.371743,53,85,0.85,32,0.0265625,14
2896.266475,21,34,0.07,13,0.005384615,14
2896.037658,57,81,0.64,24,0.026666667,14
2896.037658,55,83,0.75,28,0.026785714,14
2895.087953,44,48,0.15,4,0.0375,14
2894.421873,41,49,0.3,8,0.0375,14
2894.30238,33,55,0.87,22,0.039545455,14
2893.487293,35,58,0.84,23,0.036521739,14
2892.675369,42,73,0.96,31,0.030967742,14
2892.562491,39,52,0.46,13,0.035384615,14
2890.231278,57,85,0.75,28,0.026785714,14
2890.159676,42,75,0.99,33,0.03,14
2890.009274,34,61,0.98,27,0.036296296,14
2888.717509,41,46,0.19,5,0.038,14
2887.981973,36,51,0.6,15,0.04,14
2887.366907,23,32,0.04,9,0.004444444,14
2886.667366,42,53,0.36,11,0.032727273,14
2886.461457,33,57,0.91,24,0.037916667,14
2886.244036,51,87,0.97,36,0.026944444,14
2885.588642,41,54,0.43,13,0.033076923,14
2885.359919,55,88,0.88,33,0.026666667,14
2885.13529,53,77,0.82,24,0.034166667,14
2885.13529,52,78,0.89,26,0.034230769,14
2883.093475,36,56,0.73,20,0.0365,14
2882.729767,54,84,0.8,30,0.026666667,14
2882.729767,53,86,0.87,33,0.026363636,14
2880.78381,43,52,0.32,9,0.035555556,14
2878.688245,35,58,0.85,23,0.036956522,14
2877.845247,42,74,0.99,32,0.0309375,14
2877.128083,35,60,0.82,25,0.0328,14
2876.588882,36,58,0.73,22,0.033181818,14
2876.431212,57,85,0.74,28,0.026428571,14
2875.732184,55,87,0.85,32,0.0265625,14
2875.013866,35,59,0.8,24,0.033333333,14
2874.67126,40,51,0.43,11,0.039090909,14
2874.578046,38,58,0.65,20,0.0325,14
2874.575074,53,86,0.88,33,0.026666667,14
2874.254987,54,87,0.9,33,0.027272727,14
2874.254987,53,89,0.97,36,0.026944444,14
2873.940527,37,51,0.53,14,0.037857143,14
2872.872944,56,75,0.63,19,0.033157895,14
2872.549784,34,56,0.83,22,0.037727273,14
2871.721666,55,87,0.86,32,0.026875,14
2871.621593,52,87,0.92,35,0.026285714,14
2871.49855,51,88,0.98,37,0.026486486,14
2870.4683,53,88,0.96,35,0.027428571,14
2870.326944,52,87,0.93,35,0.026571429,14
2869.195964,37,56,0.64,19,0.033684211,14
2866.662917,35,60,0.83,25,0.0332,14
2866.555908,60,73,0.41,13,0.031538462,14
2865.888966,24,30,0.03,6,0.005,14
2865.711884,56,87,0.81,31,0.026129032,14
2865.711884,55,88,0.87,33,0.026363636,14
2864.942249,34,53,0.75,19,0.039473684,14
2864.681644,43,72,0.91,29,0.03137931,14
2864.515756,52,80,0.92,28,0.032857143,14
2864.515756,51,81,0.99,30,0.033,14
2864.41547,65,70,0.14,5,0.028,14
2864.002228,41,53,0.44,12,0.036666667,14
2863.875603,54,88,0.91,34,0.026764706,14
2863.82691,58,78,0.55,20,0.0275,14
2863.300043,57,77,0.63,20,0.0315,14
2862.456037,54,89,0.93,35,0.026571429,14
2862.290625,58,79,0.57,21,0.027142857,14
2862.19292,52,86,0.91,34,0.026764706,14
2861.351122,56,86,0.8,30,0.026666667,14
2859.684042,38,55,0.63,17,0.037058824,14
2859.413814,21,35,0.08,14,0.005714286,14
2859.383569,56,81,0.68,25,0.0272,14
2859.383569,54,84,0.81,30,0.027,14
2859.150416,60,71,0.36,11,0.032727273,14
2858.311987,61,71,0.32,10,0.032,14
2858.104384,35,52,0.66,17,0.038823529,14
2857.630047,48,56,0.24,8,0.03,14
2857.630047,47,57,0.3,10,0.03,14
2857.162212,41,50,0.35,9,0.038888889,14
2856.277505,57,74,0.56,17,0.032941176,14
2856.052947,55,82,0.73,27,0.027037037,14
2855.385371,35,58,0.83,23,0.036086957,14
2854.877393,43,73,0.93,30,0.031,14
2854.777392,57,80,0.63,23,0.027391304,14
2852.373256,35,57,0.81,22,0.036818182,14
2852.367765,41,55,0.49,14,0.035,14
2850.794333,43,64,0.61,21,0.029047619,14
2850.345997,60,77,0.46,17,0.027058824,14
2850.150499,35,52,0.68,17,0.04,14
2849.041749,55,73,0.61,18,0.033888889,14
2848.851946,36,58,0.78,22,0.035454545,14
2848.840549,45,70,0.77,25,0.0308,14
2848.401612,33,61,0.96,28,0.034285714,14
2847.906655,55,87,0.9,32,0.028125,14
2847.906655,54,88,0.96,34,0.028235294,14
2846.807065,36,50,0.56,14,0.04,14
2846.584805,49,55,0.18,6,0.03,14
2846.173281,58,75,0.54,17,0.031764706,14
2845.909633,41,64,0.68,23,0.029565217,14
2844.95193,41,49,0.29,8,0.03625,14
2844.85946,56,84,0.81,28,0.028928571,14
2844.85946,54,87,0.95,33,0.028787879,14
2844.830673,58,73,0.49,15,0.032666667,14
2844.752334,42,53,0.39,11,0.035454545,14
2844.573232,55,84,0.85,29,0.029310345,14
2844.573232,55,85,0.87,30,0.029,14
2844.573232,54,86,0.93,32,0.0290625,14
2844.214668,54,77,0.77,23,0.033478261,14
2844.118354,53,90,0.99,37,0.026756757,14
2843.986286,41,48,0.27,7,0.038571429,14
2843.616728,33,63,0.99,30,0.033,14
2843.060904,36,52,0.61,16,0.038125,14
2842.876631,54,88,0.92,34,0.027058824,14
2842.876631,53,89,0.98,36,0.027222222,14
2842.159798,37,54,0.62,17,0.036470588,14
2842.086175,54,86,0.92,32,0.02875,14
2842.086175,53,87,0.98,34,0.028823529,14
2842.051504,38,52,0.5,14,0.035714286,14
2841.762103,53,80,0.88,27,0.032592593,14
2841.251272,22,34,0.05,12,0.004166667,14
2840.429755,36,57,0.77,21,0.036666667,14
2840.200804,36,56,0.78,20,0.039,14
2839.609457,47,67,0.62,20,0.031,14
2839.507637,51,88,0.99,37,0.026756757,14
2839.11184,41,52,0.4,11,0.036363636,14
2837.137441,54,85,0.91,31,0.029354839,14
2837.137441,53,87,0.99,34,0.029117647,14
2837.021825,19,38,0.09,19,0.004736842,14
2836.928749,66,70,0.11,4,0.0275,14
2836.928749,64,72,0.22,8,0.0275,14
2836.928749,62,74,0.33,12,0.0275,14
2836.928749,60,76,0.44,16,0.0275,14
2836.032833,55,76,0.7,21,0.033333333,14
2835.724663,52,81,0.95,29,0.032758621,14
2834.797398,36,57,0.78,21,0.037142857,14
2834.458869,53,79,0.85,26,0.032692308,14
2833.475588,42,74,0.98,32,0.030625,14
2833.33731,54,85,0.82,31,0.026451613,14
2833.308921,40,50,0.36,10,0.036,14
2833.278349,52,88,0.94,36,0.026111111,14
2833.270471,60,75,0.42,15,0.028,14
2833.270471,57,79,0.61,22,0.027727273,14
2832.968773,44,51,0.25,7,0.035714286,14
2831.875315,34,61,0.95,27,0.035185185,14
2831.72629,51,53,0.06,2,0.03,14
2831.72629,50,54,0.12,4,0.03,14
2831.100058,58,83,0.7,25,0.028,14
2831.100058,57,84,0.76,27,0.028148148,14
2831.100058,54,88,0.95,34,0.027941176,14
2829.780578,54,89,0.94,35,0.026857143,14
2829.715037,42,73,0.97,31,0.031290323,14
2829.214048,44,60,0.48,16,0.03,14
2828.200498,57,82,0.73,25,0.0292,14
2828.200498,56,83,0.79,27,0.029259259,14
2826.979443,35,57,0.78,22,0.035454545,14
2826.545149,36,57,0.79,21,0.037619048,14
2826.323393,37,59,0.71,22,0.032272727,14
2826.208276,55,82,0.74,27,0.027407407,14
2826.208276,53,85,0.87,32,0.0271875,14
2825.283014,46,58,0.36,12,0.03,14
2824.980431,52,87,0.94,35,0.026857143,14
2824.34154,34,62,0.92,28,0.032857143,14
2823.831656,56,77,0.67,21,0.031904762,14
2823.721641,54,82,0.78,28,0.027857143,14
2823.679614,38,53,0.55,15,0.036666667,14
2823.577767,35,56,0.75,21,0.035714286,14
2823.281179,52,86,0.92,34,0.027058824,14
2823.007012,43,71,0.89,28,0.031785714,14
2822.96593,26,29,0.01,3,0.003333333,14
2822.43215,37,57,0.71,20,0.0355,14
2822.416427,45,59,0.42,14,0.03,14
2821.464689,38,58,0.72,20,0.036,14
2821.043201,39,53,0.47,14,0.033571429,14
2820.886602,39,56,0.62,17,0.036470588,14
2820.852434,52,85,0.91,33,0.027575758,14
2820.682712,40,49,0.33,9,0.036666667,14
2819.946731,54,83,0.79,29,0.027241379,14
2819.701159,35,52,0.69,17,0.040588235,14
2819.00695,53,78,0.84,25,0.0336,14
2818.82527,43,72,0.9,29,0.031034483,14
2818.786557,59,77,0.5,18,0.027777778,14
2818.236312,56,86,0.82,30,0.027333333,14
2818.194843,37,54,0.61,17,0.035882353,14
2818.117206,36,52,0.63,16,0.039375,14
2817.404256,24,31,0.04,7,0.005714286,14
2816.657163,56,86,0.83,30,0.027666667,14
2816.657163,54,89,0.96,35,0.027428571,14
2816.413288,42,44,0.08,2,0.04,14
2816.413288,41,45,0.16,4,0.04,14
2816.298888,62,67,0.17,5,0.034,14
2814.894384,55,87,0.89,32,0.0278125,14
2814.302556,38,98,0.1,60,0.001666667,14
2813.487787,52,79,0.91,27,0.033703704,14
2812.496956,54,74,0.68,20,0.034,14
2812.104978,54,79,0.81,25,0.0324,14
2811.926965,38,60,0.76,22,0.034545455,14
2811.730634,38,53,0.54,15,0.036,14
2811.572008,38,49,0.44,11,0.04,14
2811.538346,54,90,0.94,36,0.026111111,14
2811.114976,34,59,0.91,25,0.0364,14
2810.94887,21,34,0.08,13,0.006153846,14
2810.325692,34,61,0.99,27,0.036666667,14
2808.520177,54,85,0.9,31,0.029032258,14
2808.390568,24,32,0.03,8,0.00375,14
2808.210676,40,55,0.54,15,0.036,14
2807.99616,32,55,0.91,23,0.039565217,14
2807.311748,56,86,0.84,30,0.028,14
2806.931478,54,90,0.95,36,0.026388889,14
2806.845288,35,57,0.77,22,0.035,14
2806.180427,21,35,0.07,14,0.005,14
2806.128403,53,81,0.9,28,0.032142857,14
2805.951979,40,65,0.74,25,0.0296,14
2805.664203,56,81,0.69,25,0.0276,14
2805.308905,39,57,0.64,18,0.035555556,14
2804.593885,54,89,0.95,35,0.027142857,14
2804.520821,54,87,0.94,33,0.028484848,14
2804.146355,53,85,0.86,32,0.026875,14
2803.627902,53,86,0.97,33,0.029393939,14
2803.36909,51,80,0.98,29,0.033793103,14
2803.208719,53,84,0.85,31,0.027419355,14
2802.539468,62,78,0.44,16,0.0275,14
2802.228901,57,85,0.76,28,0.027142857,14
2801.930252,39,49,0.35,10,0.035,14
2801.700494,38,58,0.64,20,0.032,14
2801.571421,58,81,0.66,23,0.028695652,14
2801.571421,57,82,0.72,25,0.0288,14
2801.571421,56,83,0.78,27,0.028888889,14
2801.571421,56,84,0.8,28,0.028571429,14
2801.571421,55,84,0.84,29,0.028965517,14
2801.571421,55,85,0.86,30,0.028666667,14
2800.752237,45,47,0.07,2,0.035,14
2800.348088,38,54,0.54,16,0.03375,14
2799.900859,53,86,0.96,33,0.029090909,14
2798.526044,43,58,0.46,15,0.030666667,14
2797.594388,54,78,0.79,24,0.032916667,14
2797.492962,25,29,0.02,4,0.005,14
2797.347307,35,51,0.64,16,0.04,14
2796.976818,40,48,0.28,8,0.035,14
2796.767912,34,60,0.94,26,0.036153846,14
2796.475945,34,58,0.85,24,0.035416667,14
2795.85651,55,77,0.72,22,0.032727273,14
2795.829856,64,75,0.31,11,0.028181818,14
2795.442505,41,63,0.66,22,0.03,14
2795.290915,44,48,0.14,4,0.035,14
2795.290915,43,49,0.21,6,0.035,14
2794.259937,60,79,0.54,19,0.028421053,14
2794.257042,61,78,0.48,17,0.028235294,14
2794.100237,35,99,0.2,64,0.003125,14
2793.649022,52,86,0.93,34,0.027352941,14
2792.825667,39,49,0.39,10,0.039,14
2792.681433,54,83,0.8,29,0.027586207,14
2792.612318,54,88,0.9,34,0.026470588,14
2792.612318,53,90,0.97,37,0.026216216,14
2790.969998,59,68,0.31,9,0.034444444,14
2790.820227,37,51,0.5,14,0.035714286,14
2790.813638,37,49,0.47,12,0.039166667,14
2790.367322,39,54,0.52,15,0.034666667,14
2790.240461,47,62,0.5,15,0.033333333,14
2790.225172,59,81,0.61,22,0.027727273,14
2790.225172,58,82,0.67,24,0.027916667,14
2790.225172,56,85,0.8,29,0.027586207,14
2790.148536,56,86,0.79,30,0.026333333,14
2790.148536,54,89,0.92,35,0.026285714,14
2789.593907,43,44,0.04,1,0.04,14
2789.593907,42,45,0.12,3,0.04,14
2789.593907,41,46,0.2,5,0.04,14
2789.593907,40,47,0.28,7,0.04,14
2789.591088,54,80,0.83,26,0.031923077,14
2789.469771,53,89,0.96,36,0.026666667,14
2788.351525,18,40,0.11,22,0.005,14
2788.023455,53,75,0.76,22,0.034545455,14
2787.763422,61,79,0.5,18,0.027777778,14
2787.763422,59,82,0.63,23,0.027391304,14
2787.763422,58,83,0.69,25,0.0276,14
2787.574165,33,58,0.96,25,0.0384,14
2787.138875,35,59,0.86,24,0.035833333,14
2787.105308,38,47,0.37,9,0.041111111,14
2786.27346,59,82,0.62,23,0.026956522,14
2786.200762,60,80,0.56,20,0.028,14
2786.1376,50,72,0.56,22,0.025454545,14
2785.059516,40,46,0.24,6,0.04,14
2785.059516,39,47,0.32,8,0.04,14
2784.910676,51,64,0.38,13,0.029230769,14
2784.565378,23,31,0.04,8,0.005,14
2784.396408,59,81,0.62,22,0.028181818,14
2784.393523,57,82,0.71,25,0.0284,14
2784.393523,56,84,0.79,28,0.028214286,14
2784.374817,41,51,0.35,10,0.035,14
2784.323913,34,60,0.93,26,0.035769231,14
2784.289794,58,69,0.38,11,0.034545455,14
2784.289794,57,70,0.45,13,0.034615385,14
2784.282126,22,33,0.05,11,0.004545455,14
2782.959727,33,60,0.95,27,0.035185185,14
2782.795289,42,46,0.15,4,0.0375,14
2782.795289,40,48,0.3,8,0.0375,14
2782.700463,39,48,0.36,9,0.04,14
2782.615504,37,59,0.72,22,0.032727273,14
2782.170196,54,89,0.98,35,0.028,14
2781.985658,40,57,0.59,17,0.034705882,14
2781.037161,19,39,0.1,20,0.005,14
2780.774866,34,57,0.88,23,0.03826087,14
2780.375393,55,86,0.86,31,0.027741935,14
2780.197827,56,85,0.82,29,0.028275862,14
2779.926123,37,50,0.52,13,0.04,14
2779.739946,55,88,0.86,33,0.026060606,14
2779.235637,42,55,0.45,13,0.034615385,14
2778.886498,39,54,0.55,15,0.036666667,14
2778.813852,57,83,0.73,26,0.028076923,14
2778.813852,54,87,0.92,33,0.027878788,14
2778.813852,53,88,0.98,35,0.028,14
2778.798556,55,78,0.74,23,0.032173913,14
2778.513431,63,76,0.37,13,0.028461538,14
2778.35248,51,87,0.98,36,0.027222222,14
2777.922033,55,87,0.88,32,0.0275,14
2777.569116,50,65,0.44,15,0.029333333,14
2777.386925,42,50,0.28,8,0.035,14
2776.772264,25,30,0.03,5,0.006,14
2776.627341,59,73,0.45,14,0.032142857,14
2776.627341,57,75,0.58,18,0.032222222,14
2776.561002,36,57,0.72,21,0.034285714,14
2776.364699,56,85,0.81,29,0.027931034,14
2776.361822,57,84,0.75,27,0.027777778,14
2776.361822,54,88,0.94,34,0.027647059,14
2775.523464,38,50,0.47,12,0.039166667,14
2775.505597,53,90,0.98,37,0.026486486,14
2774.999682,40,49,0.35,9,0.038888889,14
2774.461133,45,48,0.1,3,0.033333333,14
2772.66039,23,33,0.04,10,0.004,14
2772.371544,36,56,0.71,20,0.0355,14
2771.769537,35,58,0.78,23,0.033913043,14
2771.5128,25,30,0.02,5,0.004,14
2771.466562,36,55,0.68,19,0.035789474,14
2770.985121,37,51,0.55,14,0.039285714,14
2770.718383,36,59,0.75,23,0.032608696,14
2769.708748,42,52,0.37,10,0.037,14
2769.626135,36,49,0.54,13,0.041538462,14
2769.592562,55,86,0.88,31,0.028387097,14
2769.396924,22,33,0.07,11,0.006363636,14
2769.263561,34,59,0.93,25,0.0372,14
2768.903086,41,54,0.47,13,0.036153846,14
2768.708813,41,49,0.33,8,0.04125,14
2768.70455,39,59,0.63,20,0.0315,14
2768.703565,59,80,0.6,21,0.028571429,14
2768.703565,58,82,0.68,24,0.028333333,14
2768.703565,57,83,0.74,26,0.028461538,14
2768.703565,55,86,0.87,31,0.028064516,14
2768.703565,54,87,0.93,33,0.028181818,14
2768.703565,53,88,0.99,35,0.028285714,14
2768.700696,55,85,0.85,30,0.028333333,14
2768.700696,54,86,0.91,32,0.0284375,14
2768.700696,53,87,0.97,34,0.028529412,14
2768.467651,59,79,0.58,20,0.029,14
2768.467651,58,80,0.64,22,0.029090909,14
2768.467651,57,81,0.7,24,0.029166667,14
2766.637912,35,62,0.87,27,0.032222222,14
2766.155032,42,53,0.4,11,0.036363636,14
2764.81632,43,51,0.27,8,0.03375,14
2764.738068,53,79,0.86,26,0.033076923,14
2764.085339,60,80,0.55,20,0.0275,14
2764.085339,57,83,0.72,26,0.027692308,14
2763.964532,38,59,0.74,21,0.035238095,14
2763.862724,43,61,0.54,18,0.03,14
2763.805471,44,57,0.4,13,0.030769231,14
2763.610231,39,55,0.57,16,0.035625,14
2762.568736,40,48,0.31,8,0.03875,14
2762.207689,33,54,0.85,21,0.04047619,14
2762.116852,20,36,0.09,16,0.005625,14
2761.927328,42,49,0.25,7,0.035714286,14
2761.744725,36,60,0.79,24,0.032916667,14
2761.682283,45,66,0.52,21,0.024761905,14
2761.541871,52,80,0.93,28,0.033214286,14
2760.513501,56,85,0.79,29,0.027241379,14
2760.227541,38,55,0.59,17,0.034705882,14
2760.125965,38,57,0.7,19,0.036842105,14
2759.79665,55,83,0.82,28,0.029285714,14
2759.79665,54,84,0.88,30,0.029333333,14
2759.79665,53,85,0.94,32,0.029375,14
2759.689051,56,82,0.76,26,0.029230769,14
2758.529894,56,76,0.65,20,0.0325,14
2758.361811,43,70,0.88,27,0.032592593,14
2758.302588,42,70,0.94,28,0.033571429,14
2758.134495,43,53,0.32,10,0.032,14
2757.400934,40,58,0.57,18,0.031666667,14
2757.386089,54,85,0.89,31,0.028709677,14
2756.848607,38,61,0.72,23,0.031304348,14
2756.488992,42,54,0.42,12,0.035,14
2755.933847,42,71,0.95,29,0.032758621,14
2755.4326,48,59,0.32,11,0.029090909,14
2755.136256,24,32,0.02,8,0.0025,14
2754.833282,38,52,0.51,14,0.036428571,14
2754.752263,42,48,0.22,6,0.036666667,14
2754.391024,37,55,0.7,18,0.038888889,14
2753.899478,33,59,0.93,26,0.035769231,14
2753.882037,41,66,0.73,25,0.0292,14
2751.485735,56,83,0.77,27,0.028518519,14
2750.84314,56,85,0.71,29,0.024482759,14
2750.693226,49,67,0.52,18,0.028888889,14
2750.358869,40,51,0.39,11,0.035454545,14
2750.253947,42,62,0.6,20,0.03,14
2749.950307,41,54,0.42,13,0.032307692,14
2749.731507,34,55,0.73,21,0.034761905,14
2749.673236,56,71,0.52,15,0.034666667,14
2749.673236,55,72,0.59,17,0.034705882,14
2749.571268,40,54,0.46,14,0.032857143,14
2749.512928,19,38,0.1,19,0.005263158,14
2749.375119,39,58,0.66,19,0.034736842,14
2748.496396,51,86,0.99,35,0.028285714,14
2748.432875,57,83,0.68,26,0.026153846,14
2748.267981,58,83,0.68,25,0.0272,14
2747.802889,35,56,0.77,21,0.036666667,14
2747.389352,34,96,0.24,62,0.003870968,14
2745.011414,43,73,0.92,30,0.030666667,14
2744.685873,44,50,0.22,6,0.036666667,14
2744.417562,45,65,0.5,20,0.025,14
2744.134271,54,78,0.78,24,0.0325,14
2744.072022,54,88,0.82,34,0.024117647,14
2744.042353,35,99,0.11,64,0.00171875,14
2744.000068,56,80,0.68,24,0.028333333,14
2743.712465,31,56,0.99,25,0.0396,14
2743.332222,53,75,0.75,22,0.034090909,14
2743.332222,52,76,0.82,24,0.034166667,14
2742.825784,41,61,0.61,20,0.0305,14
2742.672991,42,51,0.3,9,0.033333333,14
2742.647867,23,33,0.05,10,0.005,14
2742.394746,55,86,0.76,31,0.024516129,14
2741.574118,55,88,0.9,33,0.027272727,14
2741.532395,35,51,0.65,16,0.040625,14
2741.518858,46,64,0.45,18,0.025,14
2741.014522,22,32,0.14,10,0.014,14
2740.786111,38,50,0.45,12,0.0375,14
2740.634833,60,79,0.5,19,0.026315789,14
2740.523997,66,74,0.21,8,0.02625,14
2740.365157,54,87,0.81,33,0.024545455,14
2740.295849,26,28,0.01,2,0.005,14
2740.288761,38,60,0.77,22,0.035,14
2739.794046,55,85,0.84,30,0.028,14
2739.696686,46,64,0.46,18,0.025555556,14
2739.333586,33,62,0.97,29,0.033448276,14
2739.286511,43,48,0.17,5,0.034,14
2738.254506,54,86,0.9,32,0.028125,14
2737.847164,56,84,0.73,28,0.026071429,14
2737.625975,24,32,0.04,8,0.005,14
2737.481824,56,84,0.78,28,0.027857143,14
2737.080759,42,48,0.23,6,0.038333333,14
2736.629953,40,52,0.46,12,0.038333333,14
2736.535314,39,59,0.69,20,0.0345,14
2735.971946,55,84,0.83,29,0.02862069,14
2735.064999,57,84,0.74,27,0.027407407,14
2734.741845,51,85,0.97,34,0.028529412,14
2734.667051,39,51,0.44,12,0.036666667,14
2734.39381,43,52,0.29,9,0.032222222,14
2734.227154,54,79,0.75,25,0.03,14
2734.14626,37,49,0.48,12,0.04,14
2733.682458,54,87,0.91,33,0.027575758,14
2733.574253,48,75,0.68,27,0.025185185,14
2733.15199,59,69,0.22,10,0.022,14
2732.551945,45,66,0.53,21,0.025238095,14
2732.09942,57,82,0.66,25,0.0264,14
2730.973495,40,55,0.55,15,0.036666667,14
2730.910923,50,59,0.23,9,0.025555556,14
2730.378217,40,52,0.42,12,0.035,14
2730.371598,46,63,0.45,17,0.026470588,14
2730.34006,62,73,0.31,11,0.028181818,14
2730.242194,17,42,0.13,25,0.0052,14
2730.182413,36,55,0.69,19,0.036315789,14
2729.505744,45,65,0.51,20,0.0255,14
2729.233526,49,60,0.28,11,0.025454545,14
2729.036997,59,82,0.55,23,0.023913043,14
2729.036997,58,83,0.6,25,0.024,14
2729.036997,57,84,0.65,27,0.024074074,14
2728.452621,55,61,0.17,6,0.028333333,14
2728.349934,40,57,0.6,17,0.035294118,14
2728.036784,48,68,0.58,20,0.029,14
2727.924378,56,86,0.81,30,0.027,14
2727.697374,41,53,0.4,12,0.033333333,14
2727.692574,86,89,0.02,3,0.006666667,14
2727.692191,53,89,0.93,36,0.025833333,14
2727.61801,54,86,0.89,32,0.0278125,14
2727.253011,34,58,0.86,24,0.035833333,14
2726.527165,87,92,0.03,5,0.006,14
2726.320949,57,85,0.72,28,0.025714286,14
2725.907875,52,84,0.9,32,0.028125,14
2725.457455,54,89,0.97,35,0.027714286,14
2725.403204,54,88,0.93,34,0.027352941,14
2724.838108,58,83,0.65,25,0.026,14
2724.684363,34,61,0.9,27,0.033333333,14
2724.37827,36,59,0.81,23,0.035217391,14
2724.025375,53,88,0.97,35,0.027714286,14
2724.025375,53,89,0.99,36,0.0275,14
2722.957311,58,81,0.61,23,0.026521739,14
2722.88162,41,50,0.32,9,0.035555556,14
2722.572668,53,86,0.95,33,0.028787879,14
2722.481758,23,31,0.11,8,0.01375,14
2722.416416,55,79,0.7,24,0.029166667,14
2722.239819,42,69,0.7,27,0.025925926,14
2722.097825,44,71,0.84,27,0.031111111,14
2721.539903,38,59,0.67,21,0.031904762,14
2721.274218,53,88,0.91,35,0.026,14
2721.226904,20,37,0.08,17,0.004705882,14
2720.804425,63,77,0.37,14,0.026428571,14
2720.43531,55,86,0.85,31,0.027419355,14
2720.337006,40,56,0.57,16,0.035625,14
2719.852228,36,54,0.69,18,0.038333333,14
2719.833394,63,77,0.34,14,0.024285714,14
2719.597849,47,62,0.4,15,0.026666667,14
2719.443753,44,51,0.23,7,0.032857143,14
2719.442301,34,59,0.87,25,0.0348,14
2719.299818,39,56,0.57,17,0.033529412,14
2719.069234,23,33,0.03,10,0.003,14
2718.628137,34,59,0.88,25,0.0352,14
2718.440333,39,50,0.43,11,0.039090909,14
2718.25483,52,85,0.93,33,0.028181818,14
2718.18875,59,81,0.54,22,0.024545455,14
2718.033004,55,87,0.87,32,0.0271875,14
2717.981594,53,87,0.95,34,0.027941176,14
2717.615346,57,79,0.62,22,0.028181818,14
2717.538992,55,85,0.79,30,0.026333333,14
2716.969687,38,98,0.09,60,0.0015,14
2716.958969,35,57,0.76,22,0.034545455,14
2716.8925,64,76,0.29,12,0.024166667,14
2716.639516,58,84,0.67,26,0.025769231,14
2716.591873,45,55,0.31,10,0.031,14
2716.353548,55,88,0.89,33,0.026969697,14
2716.040366,62,78,0.39,16,0.024375,14
2716.040366,61,79,0.44,18,0.024444444,14
2716.040366,60,80,0.49,20,0.0245,14
2715.063076,37,62,0.86,25,0.0344,14
2714.065807,51,65,0.4,14,0.028571429,14
2713.72335,56,65,0.23,9,0.025555556,14
2713.637908,51,87,0.99,36,0.0275,14
2713.27233,44,62,0.53,18,0.029444444,14
2713.217011,40,64,0.72,24,0.03,14
2713.203087,51,85,0.96,34,0.028235294,14
2713.06214,55,86,0.81,31,0.026129032,14
2713.017651,52,64,0.34,12,0.028333333,14
2712.913451,52,89,0.96,37,0.025945946,14
2712.697073,53,83,0.84,30,0.028,14
2712.449111,37,56,0.66,19,0.034736842,14
2712.139561,41,60,0.59,19,0.031052632,14
2711.368012,35,58,0.86,23,0.037391304,14
2711.349192,54,87,0.86,33,0.026060606,14
2711.313749,37,57,0.72,20,0.036,14
2711.311412,53,87,0.96,34,0.028235294,14
2711.122774,22,33,0.04,11,0.003636364,14
2711.020116,32,55,0.93,23,0.040434783,14
2710.824775,42,65,0.67,23,0.029130435,14
2710.438301,35,52,0.67,17,0.039411765,14
2709.93682,51,86,0.97,35,0.027714286,14
2709.837127,58,82,0.59,24,0.024583333,14
2709.677865,41,56,0.52,15,0.034666667,14
2709.534306,22,34,0.04,12,0.003333333,14
2709.142558,33,55,0.88,22,0.04,14
2709.041718,48,62,0.46,14,0.032857143,14
2708.590262,52,90,0.98,38,0.025789474,14
2708.165098,37,52,0.55,15,0.036666667,14
2708.009969,47,63,0.4,16,0.025,14
2707.942247,42,64,0.65,22,0.029545455,14
2707.473479,40,57,0.54,17,0.031764706,14
2707.416387,21,35,0.11,14,0.007857143,14
2707.20144,33,60,0.96,27,0.035555556,14
2707.1884,39,53,0.49,14,0.035,14
2706.653555,40,55,0.5,15,0.033333333,14
2706.608309,34,52,0.73,18,0.040555556,14
2706.540544,37,99,0.1,62,0.001612903,14
2706.532158,35,57,0.79,22,0.035909091,14
2706.220521,55,87,0.83,32,0.0259375,14
2706.216584,44,65,0.6,21,0.028571429,14
2705.982535,38,53,0.57,15,0.038,14
2705.776116,52,59,0.17,7,0.024285714,14
2705.257205,41,48,0.26,7,0.037142857,14
2705.220367,36,51,0.58,15,0.038666667,14
2705.096496,54,86,0.84,32,0.02625,14
2705.096496,53,87,0.89,34,0.026176471,14
2705.03422,42,56,0.44,14,0.031428571,14
2704.998754,62,75,0.35,13,0.026923077,14
2704.845887,57,82,0.67,25,0.0268,14
2704.711217,22,32,0.07,10,0.007,14
2704.580318,46,65,0.47,19,0.024736842,14
2704.548488,31,59,0.97,28,0.034642857,14
2704.397148,23,32,0.03,9,0.003333333,14
2704.312084,43,54,0.35,11,0.031818182,14
2704.141797,54,71,0.51,17,0.03,14
2704.086249,54,90,0.93,36,0.025833333,14
2704.086249,53,91,0.99,38,0.026052632,14
2703.981484,56,84,0.74,28,0.026428571,14
2703.702515,58,78,0.56,20,0.028,14
2703.532943,38,99,0.09,61,0.00147541,14
2703.531492,50,59,0.24,9,0.026666667,14
2703.15319,38,48,0.4,10,0.04,14
2702.914431,59,82,0.6,23,0.026086957,14
2702.862059,33,53,0.82,20,0.041,14
2702.860021,54,87,0.87,33,0.026363636,14
2702.497256,56,78,0.64,22,0.029090909,14
2702.344249,47,69,0.65,22,0.029545455,14
2702.16364,56,85,0.83,29,0.02862069,14
2702.022327,39,57,0.65,18,0.036111111,14
2701.691135,36,93,0.16,57,0.002807018,14
2701.356034,60,75,0.43,15,0.028666667,14
2700.709482,50,58,0.27,8,0.03375,14
2700.387693,32,57,0.87,25,0.0348,14
2700.275259,33,59,0.94,26,0.036153846,14
2700.232483,42,52,0.33,10,0.033,14
2700.051678,52,85,0.92,33,0.027878788,14
2700.051678,51,86,0.98,35,0.028,14
2699.452317,58,76,0.52,18,0.028888889,14
2699.137022,39,56,0.55,17,0.032352941,14
2698.90424,63,75,0.32,12,0.026666667,14
2698.197322,45,50,0.18,5,0.036,14
2698.189484,60,81,0.5,21,0.023809524,14
2698.11745,53,88,0.93,35,0.026571429,14
2697.733908,46,50,0.14,4,0.035,14
2697.733908,45,51,0.21,6,0.035,14
2697.733908,44,52,0.28,8,0.035,14
2697.733908,43,53,0.35,10,0.035,14
2697.463159,24,29,0.07,5,0.014,14
2697.392073,59,76,0.53,17,0.031176471,14
2696.855457,55,86,0.89,31,0.028709677,14
2696.719529,37,62,0.87,25,0.0348,14
2696.572723,61,74,0.37,13,0.028461538,14
2695.703701,53,63,0.29,10,0.029,14
2695.234003,43,68,0.65,25,0.026,14
2694.990211,60,80,0.57,20,0.0285,14
2694.921024,56,82,0.7,26,0.026923077,14
2694.749128,48,62,0.35,14,0.025,14
2694.667404,57,69,0.28,12,0.023333333,14
2694.636616,45,61,0.47,16,0.029375,14
2693.839941,18,41,0.11,23,0.004782609,14
2693.416227,52,89,0.97,37,0.026216216,14
2693.010898,42,72,0.96,30,0.032,14
2692.289776,24,30,0.04,6,0.006666667,14
2692.178942,49,57,0.21,8,0.02625,14
2692.071919,57,84,0.77,27,0.028518519,14
2691.955145,53,56,0.1,3,0.033333333,14
2691.955145,50,59,0.3,9,0.033333333,14
2691.908678,79,98,0.12,19,0.006315789,14
2691.872317,46,63,0.54,17,0.031764706,14
2691.782389,18,41,0.1,23,0.004347826,14
2691.70422,45,52,0.23,7,0.032857143,14
2691.616831,56,73,0.37,17,0.021764706,14
2691.579232,40,50,0.41,10,0.041,14
2691.405513,20,38,0.09,18,0.005,14
2691.019308,32,56,0.96,24,0.04,14
2690.822691,51,83,0.95,32,0.0296875,14
2690.59552,55,82,0.75,27,0.027777778,14
2690.578784,56,83,0.71,27,0.026296296,14
2690.463237,55,84,0.77,29,0.026551724,14
2690.283767,20,36,0.08,16,0.005,14
2690.176544,34,52,0.74,18,0.041111111,14
2690.073692,49,60,0.29,11,0.026363636,14
2689.940954,53,56,0.08,3,0.026666667,14
2689.732523,50,66,0.46,16,0.02875,14
2689.663894,63,71,0.25,8,0.03125,14
2689.571216,34,58,0.87,24,0.03625,14
2689.191386,42,60,0.55,18,0.030555556,14
2688.885749,56,86,0.78,30,0.026,14
2688.50889,34,55,0.75,21,0.035714286,14
2688.415931,50,60,0.25,10,0.025,14
2688.380978,39,44,0.21,5,0.042,14
2688.211121,38,50,0.44,12,0.036666667,14
2687.990535,35,54,0.74,19,0.038947368,14
2687.902922,56,83,0.72,27,0.026666667,14
2687.110913,46,70,0.71,24,0.029583333,14
2686.969179,34,53,0.77,19,0.040526316,14
2686.782853,55,87,0.91,32,0.0284375,14
2686.782853,54,88,0.97,34,0.028529412,14
2686.708657,59,79,0.53,20,0.0265,14
2686.660543,55,85,0.8,30,0.026666667,14
2686.292019,43,48,0.19,5,0.038,14
2686.265365,46,65,0.48,19,0.025263158,14
2686.091844,34,96,0.26,62,0.004193548,14
2686.074417,36,96,0.21,60,0.0035,14
2686.031863,36,63,0.97,27,0.035925926,14
2686.012907,58,82,0.63,24,0.02625,14
2686.012907,57,84,0.7,27,0.025925926,14
2686.012907,56,85,0.75,29,0.025862069,14
2685.512612,42,72,0.97,30,0.032333333,14
2684.856855,42,73,0.98,31,0.031612903,14
2684.803575,59,78,0.52,19,0.027368421,14
2683.418249,64,76,0.32,12,0.026666667,14
2683.418249,61,79,0.48,18,0.026666667,14
2682.978265,56,68,0.37,12,0.030833333,14
2682.960176,36,94,0.22,58,0.003793103,14
2682.761789,39,59,0.7,20,0.035,14
2682.140654,53,89,0.94,36,0.026111111,14
2681.931912,43,46,0.11,3,0.036666667,14
2681.296161,36,57,0.73,21,0.034761905,14
2681.252489,46,71,0.72,25,0.0288,14
2681.010829,36,97,0.2,61,0.003278689,14
2680.886714,57,84,0.71,27,0.026296296,14
2680.768944,51,84,0.96,33,0.029090909,14
2680.762361,41,56,0.53,15,0.035333333,14
2680.597191,32,58,0.89,26,0.034230769,14
2680.167472,38,52,0.54,14,0.038571429,14
2679.90987,56,85,0.76,29,0.026206897,14
2679.476002,57,68,0.26,11,0.023636364,14
2679.441399,44,67,0.58,23,0.025217391,14
2679.237007,51,58,0.23,7,0.032857143,14
2679.148348,49,61,0.3,12,0.025,14
2678.473823,45,70,0.76,25,0.0304,14
2678.402353,53,87,0.91,34,0.026764706,14
2677.814702,62,73,0.34,11,0.030909091,14
2677.772892,51,59,0.2,8,0.025,14
2677.73618,44,66,0.57,22,0.025909091,14
2677.09173,37,46,0.38,9,0.042222222,14
2676.945806,37,53,0.59,16,0.036875,14
2676.793217,62,68,0.2,6,0.033333333,14
2676.658058,47,69,0.64,22,0.029090909,14
2676.417014,37,61,0.85,24,0.035416667,14
2676.278681,57,77,0.58,20,0.029,14
2676.278681,55,80,0.72,25,0.0288,14
2676.205004,41,55,0.45,14,0.032142857,14
2676.070478,36,93,0.15,57,0.002631579,14
2675.889011,33,60,0.97,27,0.035925926,14
2675.863614,57,83,0.65,26,0.025,14
2675.566498,55,83,0.76,28,0.027142857,14
2675.566498,54,84,0.82,30,0.027333333,14
2675.566498,52,87,0.95,35,0.027142857,14
2675.179441,54,88,0.89,34,0.026176471,14
2675.126827,40,74,0.93,34,0.027352941,14
2675.119275,54,81,0.78,27,0.028888889,14
2675.119275,53,82,0.84,29,0.028965517,14
2675.119275,52,83,0.9,31,0.029032258,14
2675.119275,52,84,0.92,32,0.02875,14
2675.119275,51,85,0.98,34,0.028823529,14
2674.69273,38,58,0.73,20,0.0365,14
2674.650697,58,80,0.59,22,0.026818182,14
2674.647969,34,54,0.8,20,0.04,14
2674.339911,36,62,0.94,26,0.036153846,14
2674.264525,61,76,0.41,15,0.027333333,14
2674.101463,35,99,0.21,64,0.00328125,14
2674.043682,61,79,0.51,18,0.028333333,14
2674.012805,36,94,0.15,58,0.002586207,14
2673.964952,59,68,0.2,9,0.022222222,14
2673.582457,58,84,0.68,26,0.026153846,14
2673.541291,34,56,0.75,22,0.034090909,14
2673.501566,39,51,0.5,12,0.041666667,14
2673.304091,53,83,0.85,30,0.028333333,14
2673.304091,52,84,0.91,32,0.0284375,14
2672.985176,53,87,0.9,34,0.026470588,14
2672.50493,68,71,0.08,3,0.026666667,14
2672.257536,35,56,0.76,21,0.036190476,14
2671.663784,57,83,0.69,26,0.026538462,14
2671.370974,33,57,0.93,24,0.03875,14
2671.093769,47,49,0.07,2,0.035,14
2671.022233,58,71,0.28,13,0.021538462,14
2671.021868,52,90,0.99,38,0.026052632,14
2670.908151,56,79,0.66,23,0.028695652,14
2670.908151,55,81,0.74,26,0.028461538,14
2670.908151,54,82,0.8,28,0.028571429,14
2670.695431,37,50,0.53,13,0.040769231,14
2670.695431,36,51,0.61,15,0.040666667,14
2670.618957,35,94,0.18,59,0.003050847,14
2670.609502,35,95,0.25,60,0.004166667,14
2670.324434,53,84,0.86,31,0.027741935,14
2669.663101,25,31,0.03,6,0.005,14
2669.63836,60,74,0.44,14,0.031428571,14
2669.210074,36,52,0.57,16,0.035625,14
2669.006943,48,64,0.52,16,0.0325,14
2668.86261,38,50,0.43,12,0.035833333,14
2668.76353,33,56,0.9,23,0.039130435,14
2668.700452,54,88,0.88,34,0.025882353,14
2667.487683,39,51,0.46,12,0.038333333,14
2667.412444,46,69,0.69,23,0.03,14
2667.358514,19,39,0.09,20,0.0045,14
2667.278459,59,76,0.48,17,0.028235294,14
2667.111973,50,62,0.3,12,0.025,14
2667.111973,49,63,0.35,14,0.025,14
2666.751851,39,56,0.6,17,0.035294118,14
2666.66431,51,54,0.08,3,0.026666667,14
2666.572285,52,88,0.95,36,0.026388889,14
2666.357953,37,56,0.72,19,0.037894737,14
2665.906046,35,60,0.89,25,0.0356,14
2665.886718,54,89,0.9,35,0.025714286,14
2665.589208,64,69,0.16,5,0.032,14
2665.333725,52,86,0.94,34,0.027647059,14
2664.936182,25,31,0.02,6,0.003333333,14
2664.759563,34,55,0.82,21,0.039047619,14
2664.591668,37,55,0.63,18,0.035,14
2664.446853,40,53,0.48,13,0.036923077,14
2664.3228,39,98,0.09,59,0.001525424,14
2663.9698,43,71,0.69,28,0.024642857,14
2663.74189,35,60,0.9,25,0.036,14
2663.650479,45,68,0.74,23,0.032173913,14
2663.535443,52,89,0.98,37,0.026486486,14
2663.50901,33,54,0.84,21,0.04,14
2663.135564,41,55,0.5,14,0.035714286,14
2662.813687,78,98,0.13,20,0.0065,14
2662.725678,39,53,0.5,14,0.035714286,14
2662.686335,39,97,0.08,58,0.00137931,14
2662.581381,58,64,0.15,6,0.025,14
2662.581381,57,65,0.2,8,0.025,14
2662.53491,51,61,0.25,10,0.025,14
2662.341599,56,66,0.25,10,0.025,14
2662.341599,55,67,0.3,12,0.025,14
2662.303847,35,98,0.22,63,0.003492063,14
2662.274621,61,79,0.47,18,0.026111111,14
2662.25019,64,70,0.19,6,0.031666667,14
2662.25019,61,73,0.38,12,0.031666667,14
2662.032456,54,85,0.83,31,0.026774194,14
2661.76411,46,63,0.43,17,0.025294118,14
2661.662051,61,78,0.43,17,0.025294118,14
2661.662051,60,79,0.48,19,0.025263158,14
2661.619122,54,86,0.85,32,0.0265625,14
2661.562885,55,69,0.43,14,0.030714286,14
2661.158491,38,99,0.08,61,0.001311475,14
2661.002729,43,63,0.59,20,0.0295,14
2660.861512,53,90,0.95,37,0.025675676,14
2660.845814,57,66,0.28,9,0.031111111,14
2660.729636,23,31,0.05,8,0.00625,14
2660.68411,35,99,0.16,64,0.0025,14
2660.465071,60,78,0.48,18,0.026666667,14
2660.02148,39,58,0.67,19,0.035263158,14
2659.998795,34,97,0.17,63,0.002698413,14
2659.146688,40,52,0.43,12,0.035833333,14
2659.010118,56,80,0.67,24,0.027916667,14
2658.665815,33,55,0.85,22,0.038636364,14
2658.501343,54,72,0.42,18,0.023333333,14
2658.473589,50,66,0.47,16,0.029375,14
2658.473589,49,67,0.53,18,0.029444444,14
2658.10642,66,72,0.16,6,0.026666667,14
2657.88282,51,92,0.99,41,0.024146341,14
2657.780078,46,51,0.16,5,0.032,14
2657.174401,53,84,0.87,31,0.028064516,14
2657.124263,51,59,0.21,8,0.02625,14
2656.996664,52,73,0.64,21,0.03047619,14
2656.996664,51,74,0.7,23,0.030434783,14
2656.838598,44,66,0.56,22,0.025454545,14
2656.723487,41,51,0.38,10,0.038,14
2656.600804,21,35,0.05,14,0.003571429,14
2656.519766,56,69,0.31,13,0.023846154,14
2656.503622,37,91,0.15,54,0.002777778,14
2656.267527,57,67,0.31,10,0.031,14
2656.073886,54,69,0.47,15,0.031333333,14
2655.847845,57,83,0.75,26,0.028846154,14
2655.612447,47,51,0.13,4,0.0325,14
2655.579988,59,80,0.61,21,0.029047619,14
2655.579988,58,81,0.67,23,0.029130435,14
2655.540026,45,71,0.78,26,0.03,14
2655.524841,45,53,0.26,8,0.0325,14
2655.263058,54,83,0.81,29,0.027931034,14
2655.006402,53,88,0.92,35,0.026285714,14
2654.939811,35,63,0.96,28,0.034285714,14
2654.837259,58,77,0.54,19,0.028421053,14
2654.837259,55,81,0.73,26,0.028076923,14
2654.837259,54,82,0.79,28,0.028214286,14
2654.649305,35,53,0.65,18,0.036111111,14
2654.069958,63,71,0.23,8,0.02875,14
2654.052535,83,90,0.05,7,0.007142857,14
2653.868921,45,65,0.53,20,0.0265,14
2653.786122,35,58,0.82,23,0.035652174,14
2653.663268,36,98,0.11,62,0.001774194,14
2653.243663,36,50,0.57,14,0.040714286,14
2652.980572,51,58,0.18,7,0.025714286,14
2652.534676,45,67,0.55,22,0.025,14
2652.468548,61,66,0.11,5,0.022,14
2652.460849,42,69,0.9,27,0.033333333,14
2652.396017,35,96,0.17,61,0.002786885,14
2652.277148,58,65,0.17,7,0.024285714,14
2652.233216,39,50,0.41,11,0.037272727,14
2651.616587,57,73,0.54,16,0.03375,14
2651.371834,43,68,0.83,25,0.0332,14
2650.78998,62,71,0.29,9,0.032222222,14
2650.490477,47,68,0.63,21,0.03,14
2650.204727,48,64,0.4,16,0.025,14
2650.158929,42,69,0.91,27,0.033703704,14
2649.950398,36,54,0.7,18,0.038888889,14
2649.391442,39,55,0.53,16,0.033125,14
2649.161175,63,72,0.28,9,0.031111111,14
2649.159825,55,86,0.82,31,0.026451613,14
2648.979794,81,95,0.09,14,0.006428571,14
2648.782934,56,85,0.7,29,0.024137931,14
2648.503176,46,66,0.5,20,0.025,14
2648.325156,48,61,0.33,13,0.025384615,14
2648.097394,53,91,0.96,38,0.025263158,14
2648.017934,38,56,0.65,18,0.036111111,14
2647.87608,44,68,0.6,24,0.025,14
2647.761363,33,56,0.91,23,0.039565217,14
2647.51549,61,77,0.47,16,0.029375,14
2646.966349,56,83,0.73,27,0.027037037,14
2646.842018,52,88,0.96,36,0.026666667,14
2646.714207,44,67,0.59,23,0.025652174,14
2646.660453,39,53,0.54,14,0.038571429,14
2646.547267,58,82,0.69,24,0.02875,14
2646.534058,40,72,0.89,32,0.0278125,14
2646.531613,58,76,0.57,18,0.031666667,14
2646.320497,33,53,0.81,20,0.0405,14
2645.868718,44,66,0.58,22,0.026363636,14
2645.706455,64,75,0.29,11,0.026363636,14
2645.592766,61,78,0.45,17,0.026470588,14
2645.546152,33,97,0.28,64,0.004375,14
2645.521838,35,95,0.23,60,0.003833333,14
2645.190037,38,48,0.41,10,0.041,14
2645.14807,46,60,0.37,14,0.026428571,14
2645.144476,57,77,0.64,20,0.032,14
2645.064168,42,57,0.48,15,0.032,14
2644.966341,40,58,0.62,18,0.034444444,14
2644.741863,43,74,0.94,31,0.030322581,14
2643.870451,46,63,0.57,17,0.033529412,14
2643.778091,35,94,0.17,59,0.002881356,14
2643.689534,53,75,0.5,22,0.022727273,14
2643.574511,35,98,0.21,63,0.003333333,14
2643.524074,36,57,0.74,21,0.035238095,14
2643.28434,65,74,0.24,9,0.026666667,14
2643.28434,62,77,0.4,15,0.026666667,14
2643.28434,60,80,0.53,20,0.0265,14
2642.836967,36,93,0.23,57,0.004035088,14
2642.54724,59,80,0.53,21,0.025238095,14
2642.382943,58,72,0.47,14,0.033571429,14
2642.339021,34,59,0.94,25,0.0376,14
2642.318905,53,61,0.24,8,0.03,14
2642.095099,55,78,0.75,23,0.032608696,14
2642.018663,36,94,0.23,58,0.003965517,14
2641.927464,33,99,0.3,66,0.004545455,14
2641.798304,83,98,0.05,15,0.003333333,14
2641.642644,48,67,0.57,19,0.03,14
2641.624238,46,64,0.47,18,0.026111111,14
2640.916683,53,88,0.86,35,0.024571429,14
2640.855826,55,87,0.84,32,0.02625,14
2640.726479,51,90,0.99,39,0.025384615,14
2640.483817,23,33,0.06,10,0.006,14
2640.43871,35,56,0.82,21,0.039047619,14
2640.345437,53,83,0.86,30,0.028666667,14
2640.344967,34,54,0.75,20,0.0375,14
2640.304023,60,79,0.51,19,0.026842105,14
2640.188271,36,54,0.65,18,0.036111111,14
2639.986655,51,61,0.24,10,0.024,14
2639.788097,36,63,0.95,27,0.035185185,14
2639.714187,54,70,0.49,16,0.030625,14
2639.661397,59,79,0.54,20,0.027,14
2639.661397,57,81,0.65,24,0.027083333,14
2639.659358,48,80,0.77,32,0.0240625,14
2638.931291,45,56,0.34,11,0.030909091,14
2638.921585,56,78,0.6,22,0.027272727,14
2638.870976,84,90,0.04,6,0.006666667,14
2638.795848,41,70,0.98,29,0.033793103,14
2638.737495,46,67,0.67,21,0.031904762,14
2638.720204,52,71,0.48,19,0.025263158,14
2638.692682,36,58,0.75,22,0.034090909,14
2638.5742,38,49,0.45,11,0.040909091,14
2638.437142,36,63,0.96,27,0.035555556,14
2638.351004,56,77,0.58,21,0.027619048,14
2638.200388,54,90,0.91,36,0.025277778,14
2638.0074,55,72,0.38,17,0.022352941,14
2637.82433,37,61,0.87,24,0.03625,14
2637.754551,33,59,0.95,26,0.036538462,14
2637.518679,36,55,0.73,19,0.038421053,14
2637.315152,37,92,0.14,55,0.002545455,14
2637.298083,36,52,0.59,16,0.036875,14
2637.033311,23,30,0.1,7,0.014285714,14
2636.985597,33,56,0.8,23,0.034782609,14
2636.790305,34,99,0.22,65,0.003384615,14
2636.700185,60,81,0.55,21,0.026190476,14
2636.629792,56,69,0.39,13,0.03,14
2636.629792,55,70,0.45,15,0.03,14
2636.559427,54,68,0.35,14,0.025,14
2636.472608,18,39,0.15,21,0.007142857,14
2636.330944,53,89,0.87,36,0.024166667,14
2636.185263,40,47,0.26,7,0.037142857,14
2635.90449,38,99,0.1,61,0.001639344,14
2635.758902,63,76,0.35,13,0.026923077,14
2635.441389,56,77,0.68,21,0.032380952,14
2635.0672,60,78,0.53,18,0.029444444,14
2635.0672,59,79,0.59,20,0.0295,14
2634.624565,44,49,0.17,5,0.034,14
2634.557814,37,56,0.67,19,0.035263158,14
2634.548888,34,97,0.16,63,0.002539683,14
2634.508275,59,74,0.48,15,0.032,14
2634.492924,16,45,0.07,29,0.002413793,14
2634.447144,47,64,0.43,17,0.025294118,14
2634.263478,57,78,0.6,21,0.028571429,14
2634.246781,53,73,0.47,20,0.0235,14
2633.782001,58,85,0.61,27,0.022592593,14
2633.757677,44,67,0.76,23,0.033043478,14
2633.428191,43,54,0.38,11,0.034545455,14
2633.237128,35,55,0.68,20,0.034,14
2633.08118,34,99,0.25,65,0.003846154,14
2633.018553,37,58,0.68,21,0.032380952,14
2632.742975,52,72,0.62,20,0.031,14
2632.700286,47,63,0.42,16,0.02625,14
2632.688846,64,74,0.27,10,0.027,14
2632.688846,62,76,0.38,14,0.027142857,14
2632.669346,49,76,0.83,27,0.030740741,14
2632.635962,47,65,0.45,18,0.025,14
2632.624302,38,60,0.7,22,0.031818182,14
2632.544483,62,77,0.44,15,0.029333333,14
2632.518542,37,55,0.68,18,0.037777778,14
2632.491937,53,88,0.88,35,0.025142857,14
2632.125071,54,60,0.18,6,0.03,14
2631.916831,50,57,0.18,7,0.025714286,14
2631.777988,56,78,0.7,22,0.031818182,14
2631.638328,43,67,0.63,24,0.02625,14
2631.589491,59,75,0.51,16,0.031875,14
2631.355506,55,68,0.32,13,0.024615385,14
2631.334791,62,78,0.42,16,0.02625,14
2631.334791,59,81,0.58,22,0.026363636,14
2631.295962,45,65,0.52,20,0.026,14
2631.124497,39,58,0.68,19,0.035789474,14
2630.947717,42,70,0.72,28,0.025714286,14
2630.859376,40,53,0.45,13,0.034615385,14
2630.718372,49,88,0.8,39,0.020512821,14
2630.616272,53,72,0.58,19,0.030526316,14
2630.462859,40,51,0.4,11,0.036363636,14
2630.301276,56,84,0.75,28,0.026785714,14
2630.220102,37,62,0.78,25,0.0312,14
2630.0562,38,54,0.56,16,0.035,14
2629.949417,39,54,0.53,15,0.035333333,14
2629.838321,57,70,0.29,13,0.022307692,14
2629.660996,55,84,0.78,29,0.026896552,14
2629.660996,54,85,0.84,31,0.027096774,14
2629.346848,33,58,0.97,25,0.0388,14
2629.119369,51,90,0.98,39,0.025128205,14
2629.013828,38,99,0.11,61,0.001803279,14
2628.946466,56,71,0.35,15,0.023333333,14
2628.73738,52,88,0.92,36,0.025555556,14
2628.68501,48,68,0.59,20,0.0295,14
2628.666897,36,58,0.81,22,0.036818182,14
2628.638981,33,61,0.97,28,0.034642857,14
2627.761625,51,85,0.99,34,0.029117647,14
2627.711904,53,86,0.89,33,0.026969697,14
2627.673363,33,98,0.24,65,0.003692308,14
2627.663683,35,94,0.25,59,0.004237288,14
2627.585961,54,89,0.82,35,0.023428571,14
2627.519824,52,59,0.16,7,0.022857143,14
2627.204062,53,71,0.56,18,0.031111111,14
2626.927958,40,51,0.42,11,0.038181818,14
2626.8318,52,80,0.61,28,0.021785714,14
2626.710626,35,99,0.22,64,0.0034375,14
2626.710577,51,70,0.49,19,0.025789474,14
2626.432378,63,74,0.3,11,0.027272727,14
2626.369743,57,70,0.3,13,0.023076923,14
2626.350616,47,63,0.53,16,0.033125,14
2626.218513,36,97,0.21,61,0.003442623,14
2626.073805,61,77,0.43,16,0.026875,14
2625.771551,35,95,0.17,60,0.002833333,14
2625.650685,50,60,0.26,10,0.026,14
2625.63664,49,68,0.55,19,0.028947368,14
2625.393386,51,73,0.68,22,0.030909091,14
2625.348093,51,63,0.37,12,0.030833333,14
2625.316772,35,59,0.79,24,0.032916667,14
2625.195274,37,59,0.77,22,0.035,14
2624.901853,36,93,0.17,57,0.002982456,14
2624.831578,27,90,0.15,63,0.002380952,14
2624.797634,35,98,0.17,63,0.002698413,14
2624.675804,61,67,0.13,6,0.021666667,14
2624.36382,34,55,0.74,21,0.035238095,14
2624.327996,34,58,0.84,24,0.035,14
2624.098783,53,81,0.83,28,0.029642857,14
2624.076552,55,73,0.41,18,0.022777778,14
2623.744539,59,80,0.56,21,0.026666667,14
2623.608348,33,61,0.93,28,0.033214286,14
2623.373262,61,78,0.49,17,0.028823529,14
2623.373262,60,79,0.55,19,0.028947368,14
2623.299591,46,62,0.41,16,0.025625,14
2623.212213,42,68,0.69,26,0.026538462,14
2623.108562,63,75,0.35,12,0.029166667,14
2623.012601,39,55,0.54,16,0.03375,14
2622.970338,39,98,0.08,59,0.001355932,14
2622.70232,53,80,0.75,27,0.027777778,14
2622.70232,51,83,0.88,32,0.0275,14
2622.627559,20,36,0.21,16,0.013125,14
2622.201621,65,72,0.19,7,0.027142857,14
2622.185864,52,60,0.2,8,0.025,14
2622.039974,32,57,0.98,25,0.0392,14
2621.960319,33,56,0.79,23,0.034347826,14
2621.954389,66,73,0.2,7,0.028571429,14
2621.473283,37,61,0.86,24,0.035833333,14
2621.41028,61,80,0.45,19,0.023684211,14
2621.306916,84,95,0.06,11,0.005454545,14
2621.274079,39,54,0.56,15,0.037333333,14
2621.236828,37,55,0.6,18,0.033333333,14
2621.175158,51,91,0.98,40,0.0245,14
2621.114506,57,85,0.73,28,0.026071429,14
2621.02315,39,51,0.47,12,0.039166667,14
2621.02315,38,52,0.55,14,0.039285714,14
2620.961749,82,92,0.07,10,0.007,14
2620.959439,57,86,0.66,29,0.022758621,14
2620.840836,52,90,0.93,38,0.024473684,14
2620.717348,52,57,0.12,5,0.024,14
2620.684282,34,53,0.76,19,0.04,14
2620.635347,40,54,0.51,14,0.036428571,14
2620.412095,39,67,0.83,28,0.029642857,14
2620.178638,57,75,0.59,18,0.032777778,14
2619.917361,20,35,0.2,15,0.013333333,14
2619.804731,39,48,0.37,9,0.041111111,14
2619.762564,43,52,0.33,9,0.036666667,14
2619.631564,64,68,0.13,4,0.0325,14
2619.631564,62,70,0.26,8,0.0325,14
2619.631564,60,72,0.39,12,0.0325,14
2619.567263,37,92,0.15,55,0.002727273,14
2619.527651,52,89,0.93,37,0.025135135,14
2619.428383,18,40,0.12,22,0.005454545,14
2619.17979,51,91,0.99,40,0.02475,14
2619.105423,57,76,0.61,19,0.032105263,14
2618.903263,56,74,0.61,18,0.033888889,14
2618.778865,48,61,0.34,13,0.026153846,14
2618.710035,51,76,0.58,25,0.0232,14
2618.56425,54,80,0.77,26,0.029615385,14
2618.56425,52,83,0.91,31,0.029354839,14
2618.56425,51,84,0.97,33,0.029393939,14
2618.298715,52,61,0.28,9,0.031111111,14
2618.191303,36,94,0.14,58,0.002413793,14
2618.150082,36,53,0.62,17,0.036470588,14
2618.043078,49,59,0.27,10,0.027,14
2618.039288,49,59,0.34,10,0.034,14
2617.673291,35,54,0.71,19,0.037368421,14
2617.531497,35,94,0.16,59,0.002711864,14
2617.321215,20,36,0.13,16,0.008125,14
2617.152693,64,75,0.32,11,0.029090909,14
2617.152693,63,76,0.38,13,0.029230769,14
2617.152693,60,80,0.58,20,0.029,14
2617.152693,59,81,0.64,22,0.029090909,14
2617.152693,58,82,0.7,24,0.029166667,14
2616.379884,45,64,0.51,19,0.026842105,14
2616.307021,47,67,0.63,20,0.0315,14
2616.307021,45,69,0.76,24,0.031666667,14
2615.807556,81,97,0.1,16,0.00625,14
2615.791315,58,64,0.19,6,0.031666667,14
2615.167393,36,64,0.87,28,0.031071429,14
2615.031286,42,70,0.92,28,0.032857143,14
2614.822853,62,76,0.41,14,0.029285714,14
2614.808899,17,42,0.08,25,0.0032,14
2614.664773,21,36,0.09,15,0.006,14
2614.469624,36,92,0.16,56,0.002857143,14
2614.463708,35,53,0.66,18,0.036666667,14
2614.415251,53,90,0.87,37,0.023513514,14
2614.313035,47,66,0.61,19,0.032105263,14
2614.031528,56,58,0.06,2,0.03,14
2614.031528,55,59,0.12,4,0.03,14
2613.966644,26,30,0.02,4,0.005,14
2613.827243,45,63,0.52,18,0.028888889,14
2613.583548,42,54,0.43,12,0.035833333,14
2613.336296,49,61,0.39,12,0.0325,14
2613.290173,56,86,0.71,30,0.023666667,14
2613.237385,51,60,0.22,9,0.024444444,14
2613.237385,50,61,0.27,11,0.024545455,14
2613.237385,49,62,0.32,13,0.024615385,14
2613.116424,37,57,0.73,20,0.0365,14
2612.997454,79,97,0.12,18,0.006666667,14
2612.619389,62,69,0.23,7,0.032857143,14
2612.481692,59,72,0.43,13,0.033076923,14
2612.457102,52,82,0.89,30,0.029666667,14
2612.391385,54,56,0.05,2,0.025,14
2612.391385,53,57,0.1,4,0.025,14
2612.391385,52,58,0.15,6,0.025,14
2612.34602,40,71,0.87,31,0.028064516,14
2612.317687,39,56,0.61,17,0.035882353,14
2612.242352,46,49,0.11,3,0.036666667,14
2612.086865,56,67,0.34,11,0.030909091,14
2611.662357,52,58,0.14,6,0.023333333,14
2611.626851,43,48,0.18,5,0.036,14
2611.575889,36,94,0.16,58,0.002758621,14
2611.298402,55,87,0.76,32,0.02375,14
2611.298402,54,88,0.81,34,0.023823529,14
2611.297047,37,53,0.58,16,0.03625,14
2611.221807,48,57,0.24,9,0.026666667,14
2611.20903,43,67,0.68,24,0.028333333,14
2611.182533,42,70,0.93,28,0.033214286,14
2611.019147,47,71,0.67,24,0.027916667,14
2610.892174,36,61,0.86,25,0.0344,14
2610.843716,53,72,0.45,19,0.023684211,14
2610.482628,37,60,0.84,23,0.036521739,14
2610.402022,52,81,0.81,29,0.027931034,14
2610.258621,42,51,0.33,9,0.036666667,14
2610.210249,83,98,0.08,15,0.005333333,14
2610.194478,64,74,0.29,10,0.029,14
2610.194478,62,77,0.43,15,0.028666667,14
2610.185526,52,82,0.82,30,0.027333333,14
2609.724549,53,70,0.53,17,0.031176471,14
2609.584863,47,64,0.42,17,0.024705882,14
2609.387322,60,62,0.05,2,0.025,14
2609.387322,59,63,0.1,4,0.025,14
2609.36274,20,37,0.12,17,0.007058824,14
2609.232225,43,55,0.38,12,0.031666667,14
2609.156537,50,84,0.94,34,0.027647059,14
2609.119508,34,98,0.29,64,0.00453125,14
2608.987205,82,99,0.09,17,0.005294118,14
2608.725231,59,81,0.63,22,0.028636364,14
2608.625955,58,83,0.71,25,0.0284,14
2608.008975,58,74,0.52,16,0.0325,14
2607.813376,46,66,0.49,20,0.0245,14
2607.813376,45,67,0.54,22,0.024545455,14
2607.795388,23,31,0.1,8,0.0125,14
2607.486663,34,58,0.92,24,0.038333333,14
2607.446902,48,61,0.44,13,0.033846154,14
2607.395147,45,66,0.54,21,0.025714286,14
2607.367131,57,84,0.78,27,0.028888889,14
2607.281526,51,79,0.96,28,0.034285714,14
2607.241168,54,79,0.69,25,0.0276,14
2606.975627,89,92,0.01,3,0.003333333,14
2606.925594,58,81,0.62,23,0.026956522,14
2606.66895,37,52,0.56,15,0.037333333,14
2606.416997,34,55,0.79,21,0.037619048,14
2606.357648,18,40,0.14,22,0.006363636,14
2606.291612,83,97,0.08,14,0.005714286,14
2606.238246,43,58,0.47,15,0.031333333,14
2606.051709,35,62,0.93,27,0.034444444,14
2606.028089,43,68,0.64,25,0.0256,14
2605.93595,47,62,0.38,15,0.025333333,14
2605.878623,26,30,0.01,4,0.0025,14
2605.793458,34,97,0.15,63,0.002380952,14
2605.690925,54,69,0.37,15,0.024666667,14
2605.656837,35,55,0.78,20,0.039,14
2605.55527,36,61,0.91,25,0.0364,14
2605.467982,38,51,0.47,13,0.036153846,14
2605.081225,39,46,0.29,7,0.041428571,14
2604.804411,86,95,0.03,9,0.003333333,14
2604.76116,32,58,0.98,26,0.037692308,14
2604.637902,54,87,0.82,33,0.024848485,14
2604.471988,18,40,0.13,22,0.005909091,14
2604.159918,42,59,0.53,17,0.031176471,14
2604.117856,34,97,0.22,63,0.003492063,14
2604.054733,38,44,0.26,6,0.043333333,14
2603.867803,36,55,0.74,19,0.038947368,14
2603.774923,43,70,0.67,27,0.024814815,14
2603.476541,38,60,0.78,22,0.035454545,14
2603.276328,55,78,0.69,23,0.03,14
2603.190304,46,54,0.25,8,0.03125,14
2603.118386,48,62,0.37,14,0.026428571,14
2603.045132,33,98,0.18,65,0.002769231,14
2602.906204,49,61,0.31,12,0.025833333,14
2602.298296,52,85,0.94,33,0.028484848,14
2602.27299,40,50,0.35,10,0.035,14
2602.178504,46,70,0.72,24,0.03,14
2602.007431,37,92,0.21,55,0.003818182,14
2601.711623,60,78,0.49,18,0.027222222,14
2601.711623,58,80,0.6,22,0.027272727,14
2601.711623,56,82,0.71,26,0.027307692,14
2601.365229,37,53,0.62,16,0.03875,14
2600.974971,43,67,0.81,24,0.03375,14
2600.910698,52,91,0.92,39,0.023589744,14
2600.728553,43,62,0.57,19,0.03,14
2600.660329,26,92,0.18,66,0.002727273,14
2600.321727,52,75,0.53,23,0.023043478,14
2600.290275,53,88,0.87,35,0.024857143,14
2600.290275,52,89,0.92,37,0.024864865,14
2600.183403,44,69,0.61,25,0.0244,14
2600.117303,58,83,0.66,25,0.0264,14
2600.036003,48,63,0.37,15,0.024666667,14
2599.995569,19,37,0.16,18,0.008888889,14
2599.93571,43,69,0.85,26,0.032692308,14
2599.908194,42,52,0.36,10,0.036,14
2599.758948,34,60,0.98,26,0.037692308,14
2599.601283,39,52,0.5,13,0.038461538,14
2599.475393,33,57,0.82,24,0.034166667,14
2599.394195,51,74,0.71,23,0.030869565,14
2599.383911,50,75,0.77,25,0.0308,14
2599.269713,34,99,0.23,65,0.003538462,14
2599.231037,61,69,0.27,8,0.03375,14
2599.193695,36,52,0.58,16,0.03625,14
2598.833412,51,84,0.98,33,0.02969697,14
2598.801861,53,83,0.87,30,0.029,14
2598.801861,52,84,0.93,32,0.0290625,14
2598.746935,35,53,0.64,18,0.035555556,14
2598.666515,44,72,0.84,28,0.03,14
2598.501288,51,57,0.16,6,0.026666667,14
2598.231353,77,96,0.14,19,0.007368421,14
2598.130958,40,55,0.53,15,0.035333333,14
2597.975293,41,49,0.31,8,0.03875,14
2597.954765,38,59,0.75,21,0.035714286,14
2597.871675,49,74,0.63,25,0.0252,14
2597.850342,24,33,0.03,9,0.003333333,14
2597.578954,52,71,0.6,19,0.031578947,14
2597.172105,31,59,0.96,28,0.034285714,14
2597.154612,48,77,0.9,29,0.031034483,14
2596.954851,50,74,0.75,24,0.03125,14
2596.834672,56,67,0.27,11,0.024545455,14
2596.565586,35,99,0.17,64,0.00265625,14
2596.35472,34,57,0.83,23,0.036086957,14
2596.259964,35,95,0.24,60,0.004,14
2596.226093,54,91,0.91,37,0.024594595,14
2596.185695,40,57,0.62,17,0.036470588,14
2596.117875,50,73,0.58,23,0.025217391,14
2596.011642,59,76,0.49,17,0.028823529,14
2595.866699,45,65,0.67,20,0.0335,14
2595.841136,38,60,0.79,22,0.035909091,14
2595.765043,18,41,0.12,23,0.005217391,14
2595.606307,34,62,0.99,28,0.035357143,14
2595.569438,56,78,0.66,22,0.03,14
2595.434817,40,56,0.58,16,0.03625,14
2595.353521,51,89,0.98,38,0.025789474,14
2595.316346,42,70,0.78,28,0.027857143,14
2595.181662,36,98,0.12,62,0.001935484,14
2595.108774,44,65,0.67,21,0.031904762,14
2595.04547,19,39,0.11,20,0.0055,14
2594.9432,37,58,0.7,21,0.033333333,14
2594.871325,33,55,0.84,22,0.038181818,14
2594.626108,39,97,0.09,58,0.001551724,14
2594.447547,49,60,0.37,11,0.033636364,14
2594.204481,52,70,0.45,18,0.025,14
2594.182882,19,38,0.13,19,0.006842105,14
2594.159551,54,85,0.8,31,0.025806452,14
2593.690862,36,57,0.7,21,0.033333333,14
2593.58014,53,92,0.96,39,0.024615385,14
2593.520704,53,75,0.51,22,0.023181818,14
2593.519944,33,63,0.98,30,0.032666667,14
2593.354727,57,67,0.24,10,0.024,14
2593.339044,38,59,0.76,21,0.036190476,14
2593.227682,43,69,0.86,26,0.033076923,14
2592.980308,48,64,0.39,16,0.024375,14
2592.972112,40,54,0.47,14,0.033571429,14
2592.770588,51,83,0.96,32,0.03,14
2592.405141,44,69,0.81,25,0.0324,14
2592.374313,83,99,0.06,16,0.00375,14
2592.341451,35,96,0.15,61,0.002459016,14
2592.248269,38,92,0.13,54,0.002407407,14
2592.188903,50,58,0.23,8,0.02875,14
2592.112306,33,56,0.84,23,0.036521739,14
2591.969571,22,35,0.05,13,0.003846154,14
2591.868869,81,99,0.08,18,0.004444444,14
2591.783229,51,90,0.97,39,0.024871795,14
2591.620574,44,56,0.38,12,0.031666667,14
2591.120686,42,52,0.34,10,0.034,14
2590.829609,37,93,0.14,56,0.0025,14
2590.736374,59,73,0.46,14,0.032857143,14
2590.724565,56,76,0.56,20,0.028,14
2590.198276,41,67,0.75,26,0.028846154,14
2590.159229,47,62,0.39,15,0.026,14
2590.112103,36,64,0.97,28,0.034642857,14
2590.000534,35,97,0.23,62,0.003709677,14
2589.998511,38,55,0.6,17,0.035294118,14
2589.844804,48,65,0.54,17,0.031764706,14
2589.738378,37,49,0.49,12,0.040833333,14
2589.702132,55,80,0.73,25,0.0292,14
2589.702132,54,81,0.79,27,0.029259259,14
2589.702132,53,82,0.85,29,0.029310345,14
2589.571971,51,73,0.55,22,0.025,14
2589.5008,60,73,0.42,13,0.032307692,14
2589.410171,33,60,0.93,27,0.034444444,14
2589.323254,43,59,0.49,16,0.030625,14
2589.242827,44,70,0.64,26,0.024615385,14
2589.002556,58,70,0.26,12,0.021666667,14
2588.938087,52,89,0.99,37,0.026756757,14
2588.878798,36,98,0.1,62,0.001612903,14
2588.80382,41,56,0.54,15,0.036,14
2588.546426,36,56,0.72,20,0.036,14
2588.454327,52,73,0.5,21,0.023809524,14
2587.939937,38,58,0.71,20,0.0355,14
2587.803678,57,83,0.76,26,0.029230769,14
2587.784794,61,68,0.24,7,0.034285714,14
2587.784794,55,75,0.68,20,0.034,14
2587.665135,21,37,0.08,16,0.005,14
2587.580384,58,75,0.55,17,0.032352941,14
2587.367181,36,62,0.93,26,0.035769231,14
2587.215977,60,73,0.36,13,0.027692308,14
2586.945644,21,33,0.16,12,0.013333333,14
2586.942929,34,98,0.27,64,0.00421875,14
2586.825528,34,96,0.18,62,0.002903226,14
2586.557606,59,73,0.39,14,0.027857143,14
2586.339128,51,89,0.97,38,0.025526316,14
2586.318506,26,27,0.01,1,0.01,14
2586.178606,34,60,0.96,26,0.036923077,14
2585.576399,53,70,0.43,17,0.025294118,14
2585.409496,36,59,0.82,23,0.035652174,14
2585.162061,36,95,0.21,59,0.003559322,14
2585.132856,55,89,0.8,34,0.023529412,14
2585.078234,35,55,0.77,20,0.0385,14
2585.014565,46,61,0.39,15,0.026,14
2584.936719,35,58,0.88,23,0.03826087,14
2584.43716,43,68,0.84,25,0.0336,14
2584.216245,23,31,0.06,8,0.0075,14
2584.194988,56,84,0.7,28,0.025,14
2583.755025,46,69,0.71,23,0.030869565,14
2583.745931,49,84,0.75,35,0.021428571,14
2583.700472,44,67,0.77,23,0.033478261,14
2583.682826,32,57,0.99,25,0.0396,14
2583.545938,35,65,0.93,30,0.031,14
2583.274076,45,66,0.55,21,0.026190476,14
2583.216094,37,54,0.66,17,0.038823529,14
2582.997439,25,29,0.05,4,0.0125,14
2582.769605,36,97,0.22,61,0.003606557,14
2582.759395,33,55,0.89,22,0.040454545,14
2582.702818,54,76,0.75,22,0.034090909,14
2582.335067,37,58,0.74,21,0.035238095,14
2582.250941,36,53,0.63,17,0.037058824,14
2581.970079,37,54,0.65,17,0.038235294,14
2581.904444,36,47,0.47,11,0.042727273,14
2581.873161,53,69,0.4,16,0.025,14
2581.849854,35,55,0.73,20,0.0365,14
2581.795136,55,85,0.75,30,0.025,14
2581.772665,54,89,0.81,35,0.023142857,14
2581.590947,77,99,0.15,22,0.006818182,14
2581.527651,37,59,0.78,22,0.035454545,14
2581.505475,33,61,0.92,28,0.032857143,14
2581.483078,21,36,0.06,15,0.004,14
2581.4279,34,60,0.86,26,0.033076923,14
2581.253774,61,81,0.47,20,0.0235,14
2581.171601,53,69,0.41,16,0.025625,14
2580.969771,35,58,0.77,23,0.033478261,14
2580.969495,52,88,0.98,36,0.027222222,14
2580.805328,47,61,0.36,14,0.025714286,14
2580.714017,40,57,0.61,17,0.035882353,14
2580.680129,38,57,0.62,19,0.032631579,14
2580.215968,54,69,0.38,15,0.025333333,14
2580.039051,34,96,0.25,62,0.004032258,14
2579.625073,33,61,0.95,28,0.033928571,14
2579.423959,53,68,0.38,15,0.025333333,14
2579.332382,49,64,0.47,15,0.031333333,14
2579.206207,17,42,0.07,25,0.0028,14
2579.090358,54,74,0.46,20,0.023,14
2578.992459,55,85,0.76,30,0.025333333,14
2578.875408,35,95,0.16,60,0.002666667,14
2578.745192,43,57,0.44,14,0.031428571,14
2578.664871,37,59,0.79,22,0.035909091,14
2578.531837,51,81,0.65,30,0.021666667,14
2578.43598,48,67,0.58,19,0.030526316,14
2578.388371,39,52,0.47,13,0.036153846,14
2578.34457,43,81,0.08,38,0.002105263,14
2578.12633,36,60,0.84,24,0.035,14
2578.07241,41,64,0.69,23,0.03,14
2578.007547,43,45,0.07,2,0.035,14
2578.007547,42,46,0.14,4,0.035,14
2577.670997,57,86,0.69,29,0.023793103,14
2577.670997,56,86,0.72,30,0.024,14
2577.670997,56,87,0.74,31,0.023870968,14
2577.670997,55,87,0.77,32,0.0240625,14
2577.670997,55,88,0.79,33,0.023939394,14
2577.505613,38,99,0.07,61,0.001147541,14
2577.379107,46,65,0.49,19,0.025789474,14
2577.21548,38,98,0.11,60,0.001833333,14
2577.139748,48,65,0.42,17,0.024705882,14
2577.094958,38,57,0.67,19,0.035263158,14
2577.037256,57,66,0.22,9,0.024444444,14
2576.986455,35,58,0.81,23,0.035217391,14
2576.901165,47,60,0.34,13,0.026153846,14
2576.875788,41,57,0.55,16,0.034375,14
2576.487506,45,71,0.77,26,0.029615385,14
2576.345215,33,62,0.94,29,0.032413793,14
2576.206428,44,52,0.29,8,0.03625,14
2576.183494,57,77,0.6,20,0.03,14
2576.123804,46,50,0.13,4,0.0325,14
2576.031937,50,78,0.64,28,0.022857143,14
2575.967955,35,95,0.18,60,0.003,14
2575.820528,48,62,0.36,14,0.025714286,14
2575.633302,39,48,0.32,9,0.035555556,14
2575.597966,33,58,0.91,25,0.0364,14
2575.497843,57,83,0.71,26,0.027307692,14
2575.482271,48,63,0.38,15,0.025333333,14
2575.475098,35,96,0.14,61,0.002295082,14
2575.372395,85,88,0.02,3,0.006666667,14
2575.147857,49,66,0.51,17,0.03,14
2575.065222,38,57,0.68,19,0.035789474,14
2574.983083,27,29,0.01,2,0.005,14
2574.802581,39,66,0.81,27,0.03,14
2574.677959,33,58,0.98,25,0.0392,14
2574.604409,54,80,0.71,26,0.027307692,14
2574.438639,51,72,0.53,21,0.025238095,14
2574.251623,55,67,0.38,12,0.031666667,14
2574.064427,35,61,0.91,26,0.035,14
2573.96626,62,76,0.36,14,0.025714286,14
2573.897917,55,79,0.66,24,0.0275,14
2573.673028,47,68,0.64,21,0.03047619,14
2573.553365,33,97,0.26,64,0.0040625,14
2573.096405,34,63,0.95,29,0.032758621,14
2573.002391,59,74,0.45,15,0.03,14
2572.915754,53,87,0.87,34,0.025588235,14
2572.840506,44,71,0.85,27,0.031481481,14
2572.811601,35,98,0.23,63,0.003650794,14
2572.781891,39,58,0.69,19,0.036315789,14
2572.757945,56,72,0.35,16,0.021875,14
2572.418477,34,57,0.84,23,0.036521739,14
2572.415025,80,94,0.1,14,0.007142857,14
2572.401972,38,54,0.57,16,0.035625,14
2572.331902,37,56,0.63,19,0.033157895,14
2571.897407,40,54,0.5,14,0.035714286,14
2571.849805,37,93,0.15,56,0.002678571,14
2571.728084,47,65,0.44,18,0.024444444,14
2571.606996,42,63,0.63,21,0.03,14
2571.530243,61,72,0.35,11,0.031818182,14
2571.515478,44,66,0.74,22,0.033636364,14
2571.347737,55,86,0.9,31,0.029032258,14
2571.347737,54,87,0.96,33,0.029090909,14
