% profit,ema1,ema2,threshold,diff,thresh / diff,ID
3672.838437,56,73,0.56,17,0.032941176,59
3666.454616,61,67,0.2,6,0.033333333,59
3666.454616,58,70,0.4,12,0.033333333,59
3664.152346,59,70,0.36,11,0.032727273,59
3657.783222,61,68,0.23,7,0.032857143,59
3654.780089,55,74,0.63,19,0.033157895,59
3654.105688,57,73,0.52,16,0.0325,59
3611.025252,58,71,0.43,13,0.033076923,59
3588.746084,56,74,0.59,18,0.032777778,59
3578.36133,61,76,0.45,15,0.03,59
3570.409282,59,71,0.39,12,0.0325,59
3568.217939,57,71,0.47,14,0.033571429,59
3558.427333,54,75,0.7,21,0.033333333,59
3537.087225,61,66,0.17,5,0.034,59
3535.803949,56,72,0.54,16,0.03375,59
3522.461788,55,73,0.61,18,0.033888889,59
3517.382231,53,76,0.77,23,0.033478261,59
3508.787519,58,79,0.64,21,0.03047619,59
3501.498933,52,77,0.84,25,0.0336,59
3500.135609,58,70,0.41,12,0.034166667,59
3485.120207,60,67,0.24,7,0.034285714,59
3483.237605,54,74,0.68,20,0.034,59
3483.237605,53,75,0.75,22,0.034090909,59
3474.747634,58,69,0.37,11,0.033636364,59
3474.058122,57,72,0.5,15,0.033333333,59
3468.791072,51,78,0.91,27,0.033703704,59
3467.456768,62,74,0.37,12,0.030833333,59
3461.718502,60,69,0.3,9,0.033333333,59
3458.286668,59,70,0.37,11,0.033636364,59
3454.476429,51,79,0.94,28,0.033571429,59
3448.727125,60,68,0.27,8,0.03375,59
3446.494951,58,71,0.44,13,0.033846154,59
3436.806829,63,73,0.31,10,0.031,59
3435.505958,57,70,0.44,13,0.033846154,59
3433.426438,54,76,0.74,22,0.033636364,59
3427.035981,56,73,0.57,17,0.033529412,59
3426.719348,59,69,0.34,10,0.034,59
3425.581202,64,73,0.27,9,0.03,59
3425.581202,63,74,0.33,11,0.03,59
3425.581202,62,75,0.39,13,0.03,59
3425.207929,63,66,0.1,3,0.033333333,59
3410.048953,55,75,0.66,20,0.033,59
3404.008683,55,71,0.55,16,0.034375,59
3404.008683,54,72,0.62,18,0.034444444,59
3403.428947,58,78,0.62,20,0.031,59
3399.736843,67,69,0.06,2,0.03,59
3395.95447,68,69,0.03,1,0.03,59
3395.95447,67,70,0.09,3,0.03,59
3395.95447,66,71,0.15,5,0.03,59
3395.95447,65,72,0.21,7,0.03,59
3395.605694,63,67,0.13,4,0.0325,59
3395.605694,61,69,0.26,8,0.0325,59
3395.004373,55,74,0.64,19,0.033684211,59
3394.32392,60,76,0.49,16,0.030625,59
3393.768005,61,75,0.43,14,0.030714286,59
3390.466331,57,80,0.7,23,0.030434783,59
3389.713178,54,75,0.71,21,0.033809524,59
3389.713178,53,76,0.78,23,0.033913043,59
3386.114063,57,72,0.51,15,0.034,59
3382.311298,54,76,0.73,22,0.033181818,59
3382.125597,52,78,0.87,26,0.033461538,59
3381.123992,56,70,0.48,14,0.034285714,59
3368.72745,62,67,0.17,5,0.034,59
3368.72745,53,77,0.81,24,0.03375,59
3368.059922,59,77,0.56,18,0.031111111,59
3361.660267,53,94,0.99,41,0.024146341,59
3350.746893,56,71,0.51,15,0.034,59
3350.746893,55,72,0.58,17,0.034117647,59
3347.436959,53,77,0.8,24,0.033333333,59
3330.026851,60,70,0.33,10,0.033,59
3321.767466,58,72,0.46,14,0.032857143,59
3321.563214,57,69,0.41,12,0.034166667,59
3309.158562,54,77,0.75,23,0.032608696,59
3300.035047,59,77,0.55,18,0.030555556,59
3300.035047,58,77,0.59,19,0.031052632,59
3293.432984,59,71,0.4,12,0.033333333,59
3290.382101,56,74,0.6,18,0.033333333,59
3275.965246,51,80,0.97,29,0.033448276,59
3271.641437,63,72,0.28,9,0.031111111,59
3271.018658,54,93,0.94,39,0.024102564,59
3270.248993,53,78,0.83,25,0.0332,59
3270.248993,52,79,0.9,27,0.033333333,59
3267.474153,63,71,0.25,8,0.03125,59
3261.334419,54,73,0.65,19,0.034210526,59
3260.129582,54,86,0.92,32,0.02875,59
3259.448735,55,75,0.67,20,0.0335,59
3255.643798,61,70,0.27,9,0.03,59
3255.643798,60,71,0.33,11,0.03,59
3255.643798,59,72,0.39,13,0.03,59
3255.643798,58,73,0.45,15,0.03,59
3255.643798,57,74,0.51,17,0.03,59
3254.04612,59,73,0.45,14,0.032142857,59
3251.524191,62,69,0.21,7,0.03,59
3247.041065,55,81,0.81,26,0.031153846,59
3244.255813,55,84,0.85,29,0.029310345,59
3244.255813,54,85,0.91,31,0.029354839,59
3243.195116,53,87,0.98,34,0.028823529,59
3237.77853,62,73,0.34,11,0.030909091,59
3237.509287,54,92,0.94,38,0.024736842,59
3237.509287,53,93,0.99,40,0.02475,59
3236.370084,57,77,0.63,20,0.0315,59
3235.167727,53,74,0.72,21,0.034285714,59
3233.200605,59,76,0.53,17,0.031176471,59
3233.200605,56,79,0.72,23,0.031304348,59
3233.01198,57,79,0.68,22,0.030909091,59
3230.724788,61,72,0.35,11,0.031818182,59
3230.564319,53,78,0.82,25,0.0328,59
3230.564319,52,79,0.89,27,0.032962963,59
3227.560672,60,75,0.47,15,0.031333333,59
3226.496911,61,74,0.4,13,0.030769231,59
3226.496911,57,78,0.65,21,0.030952381,59
3223.995231,54,79,0.8,25,0.032,59
3223.352965,53,79,0.78,26,0.03,59
3217.960465,56,80,0.74,24,0.030833333,59
3216.465893,57,73,0.53,16,0.033125,59
3216.152823,56,83,0.79,27,0.029259259,59
3216.103039,53,87,0.99,34,0.029117647,59
3213.232278,57,75,0.58,18,0.032222222,59
3213.170321,63,69,0.19,6,0.031666667,59
3213.170321,60,72,0.38,12,0.031666667,59
3208.504824,47,67,0.6,20,0.03,59
3206.118121,60,75,0.46,15,0.030666667,59
3205.351706,58,74,0.51,16,0.031875,59
3204.432319,62,68,0.2,6,0.033333333,59
3202.772678,63,68,0.16,5,0.032,59
3202.550839,56,75,0.57,19,0.03,59
3202.550839,55,76,0.63,21,0.03,59
3200.297851,63,70,0.22,7,0.031428571,59
3200.297851,60,73,0.41,13,0.031538462,59
3197.751403,61,71,0.32,10,0.032,59
3196.738249,56,80,0.75,24,0.03125,59
3196.17143,43,75,0.74,32,0.023125,59
3195.771333,58,75,0.54,17,0.031764706,59
3195.771333,56,77,0.67,21,0.031904762,59
3195.771333,55,79,0.76,24,0.031666667,59
3191.497362,57,76,0.6,19,0.031578947,59
3191.354189,72,75,0.08,3,0.026666667,59
3191.354189,69,78,0.24,9,0.026666667,59
3191.354189,67,81,0.37,14,0.026428571,59
3191.334063,60,74,0.44,14,0.031428571,59
3189.457025,46,68,0.67,22,0.030454545,59
3189.234733,53,78,0.76,25,0.0304,59
3188.78389,53,83,0.94,30,0.031333333,59
3187.196962,64,71,0.22,7,0.031428571,59
3187.196962,58,77,0.6,19,0.031578947,59
3185.503686,64,70,0.19,6,0.031666667,59
3184.631921,57,78,0.66,21,0.031428571,59
3182.703777,61,74,0.41,13,0.031538462,59
3182.703777,59,76,0.54,17,0.031764706,59
3182.703777,56,79,0.73,23,0.03173913,59
3182.703777,54,81,0.86,27,0.031851852,59
3182.121705,61,70,0.29,9,0.032222222,59
3181.947829,66,80,0.39,14,0.027857143,59
3180.286779,54,81,0.85,27,0.031481481,59
3180.232203,63,71,0.26,8,0.0325,59
3179.057033,57,74,0.55,17,0.032352941,59
3177.935991,52,80,0.84,28,0.03,59
3176.887879,57,73,0.54,16,0.03375,59
3174.836033,42,76,0.8,34,0.023529412,59
3174.236736,51,80,0.96,29,0.033103448,59
3173.696573,59,74,0.47,15,0.031333333,59
3173.268179,59,90,0.83,31,0.026774194,59
3172.651827,51,82,0.9,31,0.029032258,59
3172.449913,55,77,0.65,22,0.029545455,59
3172.449913,54,78,0.71,24,0.029583333,59
3172.449913,53,79,0.77,26,0.029615385,59
3172.030619,61,73,0.38,12,0.031666667,59
3171.764294,56,77,0.7,21,0.033333333,59
3171.339386,58,72,0.47,14,0.033571429,59
3169.681705,55,80,0.79,25,0.0316,59
3169.213948,56,76,0.65,20,0.0325,59
3169.213948,55,78,0.74,23,0.032173913,59
3169.12936,62,72,0.32,10,0.032,59
3169.12936,59,75,0.51,16,0.031875,59
3168.566898,65,82,0.47,17,0.027647059,59
3164.913531,62,71,0.28,9,0.031111111,59
3164.139624,67,80,0.36,13,0.027692308,59
3162.984237,59,75,0.5,16,0.03125,59
3162.670423,56,78,0.69,22,0.031363636,59
3161.023671,68,78,0.28,10,0.028,59
3161.023671,62,85,0.64,23,0.027826087,59
3159.784635,48,66,0.54,18,0.03,59
3159.280522,57,77,0.64,20,0.032,59
3158.406023,48,65,0.53,17,0.031176471,59
3157.524093,65,82,0.46,17,0.027058824,59
3157.211456,50,63,0.4,13,0.030769231,59
3153.974816,67,80,0.35,13,0.026923077,59
3153.974816,65,83,0.48,18,0.026666667,59
3153.215479,63,85,0.59,22,0.026818182,59
3153.215479,61,87,0.7,26,0.026923077,59
3151.576057,59,74,0.5,15,0.033333333,59
3150.797072,60,74,0.45,14,0.032142857,59
3150.151595,63,84,0.58,21,0.027619048,59
3149.130417,53,92,0.99,39,0.025384615,59
3148.075113,57,76,0.63,19,0.033157895,59
3147.902661,50,83,0.97,33,0.029393939,59
3147.109711,59,72,0.42,13,0.032307692,59
3146.463412,53,82,0.92,29,0.031724138,59
3145.655966,51,66,0.38,15,0.025333333,59
3142.994539,62,72,0.31,10,0.031,59
3142.460091,60,71,0.36,11,0.032727273,59
3142.460091,58,73,0.49,15,0.032666667,59
3140.153119,59,89,0.83,30,0.027666667,59
3139.039614,57,83,0.66,26,0.025384615,59
3138.780052,54,80,0.85,26,0.032692308,59
3135.123832,60,89,0.77,29,0.026551724,59
3134.65236,55,77,0.71,22,0.032272727,59
3134.607816,53,86,0.97,33,0.029393939,59
3133.499007,56,76,0.64,20,0.032,59
3133.30081,58,82,0.61,24,0.025416667,59
3132.769286,58,76,0.57,18,0.031666667,59
3131.823443,64,84,0.54,20,0.027,59
3131.823443,62,86,0.65,24,0.027083333,59
3131.823443,60,88,0.76,28,0.027142857,59
3131.823443,60,89,0.78,29,0.026896552,59
3131.823443,58,91,0.89,33,0.026969697,59
3131.687226,66,81,0.41,15,0.027333333,59
3131.687226,64,83,0.52,19,0.027368421,59
3131.687226,61,87,0.71,26,0.027307692,59
3130.872848,63,85,0.6,22,0.027272727,59
3130.219629,58,91,0.91,33,0.027575758,59
3129.852672,50,68,0.41,18,0.022777778,59
3129.43239,53,80,0.87,27,0.032222222,59
3129.43239,52,81,0.94,29,0.032413793,59
3129.43239,52,82,0.96,30,0.032,59
3129.272763,57,82,0.73,25,0.0292,59
3128.576285,57,78,0.67,21,0.031904762,59
3128.576285,55,80,0.8,25,0.032,59
3127.286033,56,84,0.8,28,0.028571429,59
3127.286033,55,85,0.86,30,0.028666667,59
3127.271779,52,83,0.99,31,0.031935484,59
3126.100323,55,79,0.77,24,0.032083333,59
3126.100323,53,81,0.9,28,0.032142857,59
3124.56209,51,81,0.9,30,0.03,59
3123.306888,50,83,0.98,33,0.02969697,59
3122.567819,54,79,0.81,25,0.0324,59
3121.274193,58,76,0.58,18,0.032222222,59
3120.352804,62,86,0.66,24,0.0275,59
3119.307007,52,80,0.83,28,0.029642857,59
3118.953312,58,90,0.89,32,0.0278125,59
3116.837018,57,74,0.56,17,0.032941176,59
3116.712028,45,51,0.5,6,0.083333333,59
3115.172277,59,74,0.48,15,0.032,59
3114.296629,54,86,0.93,32,0.0290625,59
3114.137803,58,75,0.56,17,0.032941176,59
3114.114239,54,93,0.95,39,0.024358974,59
3113.727808,58,90,0.88,32,0.0275,59
3113.549834,58,91,0.9,33,0.027272727,59
3113.549834,57,92,0.96,35,0.027428571,59
3113.473585,60,87,0.75,27,0.027777778,59
3113.182183,68,75,0.2,7,0.028571429,59
3112.917956,60,88,0.77,28,0.0275,59
3112.870854,56,78,0.7,22,0.031818182,59
3111.889259,71,75,0.11,4,0.0275,59
3111.889259,70,77,0.19,7,0.027142857,59
3111.257708,68,79,0.3,11,0.027272727,59
3110.252105,50,82,0.97,32,0.0303125,59
3107.399152,47,71,0.63,24,0.02625,59
3106.151136,53,81,0.91,28,0.0325,59
3105.784715,49,64,0.46,15,0.030666667,59
3105.046133,59,81,0.56,22,0.025454545,59
3105.046133,58,83,0.63,25,0.0252,59
3105.046133,57,84,0.68,27,0.025185185,59
3104.383628,60,79,0.49,19,0.025789474,59
3104.185693,56,78,0.71,22,0.032272727,59
3104.178943,61,87,0.72,26,0.027692308,59
3103.652319,59,75,0.52,16,0.0325,59
3103.652319,57,77,0.65,20,0.0325,59
3103.597638,67,78,0.31,11,0.028181818,59
3103.583132,56,84,0.72,28,0.025714286,59
3103.022387,61,73,0.39,12,0.0325,59
3103.004088,55,76,0.69,21,0.032857143,59
3103.004088,54,78,0.78,24,0.0325,59
3102.767117,70,75,0.14,5,0.028,59
3102.561065,54,74,0.69,20,0.0345,59
3101.978868,62,85,0.63,23,0.027391304,59
3101.978868,61,86,0.69,25,0.0276,59
3100.54106,52,81,0.96,29,0.033103448,59
3100.499822,53,80,0.9,27,0.033333333,59
3099.824888,65,68,0.1,3,0.033333333,59
3099.824888,62,71,0.3,9,0.033333333,59
3099.222736,49,65,0.48,16,0.03,59
3098.372515,55,79,0.78,24,0.0325,59
3097.634119,62,73,0.35,11,0.031818182,59
3097.101943,55,77,0.72,22,0.032727273,59
3096.315814,54,79,0.83,25,0.0332,59
3096.1996,50,82,0.96,32,0.03,59
3095.664527,53,79,0.85,26,0.032692308,59
3095.205138,64,68,0.13,4,0.0325,59
3095.205138,62,70,0.26,8,0.0325,59
3095.205138,60,72,0.39,12,0.0325,59
3095.205138,56,77,0.68,21,0.032380952,59
3094.976707,57,92,0.95,35,0.027142857,59
3094.842043,59,89,0.82,30,0.027333333,59
3094.732865,60,73,0.43,13,0.033076923,59
3094.665114,59,90,0.84,31,0.027096774,59
3094.341185,65,69,0.13,4,0.0325,59
3093.968563,65,81,0.45,16,0.028125,59
3093.426882,54,87,0.94,33,0.028484848,59
3092.94153,50,64,0.42,14,0.03,59
3092.922217,56,75,0.62,19,0.032631579,59
3091.967273,60,78,0.47,18,0.026111111,59
3091.967273,58,80,0.58,22,0.026363636,59
3091.696889,54,78,0.72,24,0.03,59
3091.630821,45,69,0.74,24,0.030833333,59
3090.406989,51,81,0.99,30,0.033,59
3088.556038,54,80,0.84,26,0.032307692,59
3088.512718,36,59,0.74,23,0.032173913,59
3087.622555,54,77,0.76,23,0.033043478,59
3086.542182,52,82,0.98,30,0.032666667,59
3084.842229,53,88,0.99,35,0.028285714,59
3084.018913,51,63,0.36,12,0.03,59
3083.794438,58,81,0.67,23,0.029130435,59
3083.14964,58,95,0.94,37,0.025405405,59
3082.908738,56,76,0.67,20,0.0335,59
3082.864283,60,87,0.74,27,0.027407407,59
3082.362901,69,77,0.22,8,0.0275,59
3082.32136,57,92,0.97,35,0.027714286,59
3082.102363,58,74,0.52,16,0.0325,59
3082.102363,57,76,0.61,19,0.032105263,59
3082.102363,54,80,0.83,26,0.031923077,59
3082.015009,61,86,0.7,25,0.028,59
3081.241691,58,84,0.65,26,0.025,59
3080.804099,47,67,0.61,20,0.0305,59
3080.793124,61,72,0.36,11,0.032727273,59
3080.318241,52,80,0.92,28,0.032857143,59
3080.205162,57,82,0.65,25,0.026,59
3080.167687,63,70,0.23,7,0.032857143,59
3079.756971,63,84,0.57,21,0.027142857,59
3078.821104,64,69,0.16,5,0.032,59
3078.420643,63,75,0.31,12,0.025833333,59
3078.420643,59,79,0.52,20,0.026,59
3078.32449,62,79,0.43,17,0.025294118,59
3078.31107,57,76,0.62,19,0.032631579,59
3078.31107,54,79,0.82,25,0.0328,59
3077.262956,62,69,0.23,7,0.032857143,59
3076.887062,58,81,0.6,23,0.026086957,59
3076.381648,61,78,0.44,17,0.025882353,59
3076.381648,61,79,0.46,18,0.025555556,59
3076.381648,60,80,0.51,20,0.0255,59
3076.381648,57,83,0.67,26,0.025769231,59
3075.244322,47,71,0.55,24,0.022916667,59
3075.076072,59,68,0.31,9,0.034444444,59
3073.015276,44,75,0.81,31,0.026129032,59
3073.013244,64,83,0.53,19,0.027894737,59
3072.482115,62,78,0.41,16,0.025625,59
3071.566372,52,82,0.97,30,0.032333333,59
3071.241586,49,63,0.44,14,0.031428571,59
3070.880772,35,97,0.16,62,0.002580645,59
3070.436808,58,94,0.93,36,0.025833333,59
3069.98238,60,73,0.42,13,0.032307692,59
3069.98238,58,75,0.55,17,0.032352941,59
3069.232241,51,62,0.34,11,0.030909091,59
3068.975822,57,70,0.45,13,0.034615385,59
3068.975822,56,71,0.52,15,0.034666667,59
3068.099845,58,69,0.38,11,0.034545455,59
3068.066708,53,80,0.88,27,0.032592593,59
3068.066708,52,81,0.95,29,0.032758621,59
3067.660933,60,72,0.4,12,0.033333333,59
3066.204656,59,80,0.54,21,0.025714286,59
3065.277574,59,74,0.49,15,0.032666667,59
3065.137703,56,85,0.73,29,0.025172414,59
3065.067326,55,72,0.6,17,0.035294118,59
3065.067326,54,73,0.67,19,0.035263158,59
3065.067326,52,76,0.84,24,0.035,59
3064.192419,54,78,0.8,24,0.033333333,59
3063.365416,68,77,0.25,9,0.027777778,59
3063.365416,65,81,0.44,16,0.0275,59
3063.365416,63,83,0.55,20,0.0275,59
3062.934758,48,65,0.52,17,0.030588235,59
3062.297385,56,77,0.69,21,0.032857143,59
3062.297385,55,78,0.76,23,0.033043478,59
3062.297385,53,80,0.89,27,0.032962963,59
3061.675585,63,69,0.2,6,0.033333333,59
3061.25548,53,74,0.75,21,0.035714286,59
3060.77667,59,72,0.43,13,0.033076923,59
3060.337072,46,72,0.6,26,0.023076923,59
3060.214049,55,86,0.87,31,0.028064516,59
3060.065375,54,81,0.75,27,0.027777778,59
3059.133221,59,94,0.88,35,0.025142857,59
3059.079716,62,71,0.29,9,0.032222222,59
3058.798815,56,83,0.7,27,0.025925926,59
3058.462773,59,90,0.85,31,0.027419355,59
3057.993613,55,78,0.75,23,0.032608696,59
3057.229027,57,71,0.48,14,0.034285714,59
3055.973181,54,94,0.96,40,0.024,59
3055.964538,57,83,0.75,26,0.028846154,59
3054.499942,54,60,0.18,6,0.03,59
3054.499942,53,61,0.24,8,0.03,59
3054.499942,52,62,0.3,10,0.03,59
3054.426071,63,78,0.38,15,0.025333333,59
3054.0853,63,83,0.56,20,0.028,59
3053.96545,54,87,0.93,33,0.028181818,59
3053.96545,53,88,0.98,35,0.028,59
3053.185746,64,77,0.33,13,0.025384615,59
3052.76328,62,84,0.62,22,0.028181818,59
3052.497838,66,73,0.18,7,0.025714286,59
3052.497838,65,73,0.21,8,0.02625,59
3052.497838,62,77,0.39,15,0.026,59
3051.801205,47,66,0.59,19,0.031052632,59
3051.749556,65,84,0.5,19,0.026315789,59
3051.749556,64,85,0.55,21,0.026190476,59
3051.749556,62,88,0.68,26,0.026153846,59
3051.749556,61,89,0.73,28,0.026071429,59
3051.749556,61,90,0.75,29,0.025862069,59
3051.72024,64,86,0.57,22,0.025909091,59
3051.72024,63,87,0.62,24,0.025833333,59
3051.72024,62,89,0.69,27,0.025555556,59
3051.72024,60,91,0.8,31,0.025806452,59
3051.72024,59,93,0.87,34,0.025588235,59
3051.368261,60,88,0.78,28,0.027857143,59
3051.188914,55,85,0.78,30,0.026,59
3050.896878,55,85,0.77,30,0.025666667,59
3050.748026,55,72,0.59,17,0.034705882,59
3050.616759,51,54,0.08,3,0.026666667,59
3050.252229,34,60,0.87,26,0.033461538,59
3050.204745,69,78,0.25,9,0.027777778,59
3049.606539,51,77,0.92,26,0.035384615,59
3049.286138,60,87,0.76,27,0.028148148,59
3047.873545,59,73,0.46,14,0.032857143,59
3047.873545,56,76,0.66,20,0.033,59
3047.633422,55,87,0.8,32,0.025,59
3046.639193,43,72,0.9,29,0.031034483,59
3046.178573,53,79,0.87,26,0.033461538,59
3045.850646,62,85,0.65,23,0.02826087,59
3045.803419,62,86,0.67,24,0.027916667,59
3045.803419,59,89,0.84,30,0.028,59
3044.909742,61,70,0.3,9,0.033333333,59
3044.162403,56,84,0.81,28,0.028928571,59
3043.116575,54,87,0.84,33,0.025454545,59
3041.469952,53,75,0.76,22,0.034545455,59
3041.469952,52,76,0.83,24,0.034583333,59
3041.390316,67,82,0.39,15,0.026,59
3041.166793,57,75,0.59,18,0.032777778,59
3041.067209,64,74,0.26,10,0.026,59
3040.949045,52,77,0.85,25,0.034,59
3040.949045,51,78,0.92,27,0.034074074,59
3040.949045,50,79,0.99,29,0.034137931,59
3040.28253,61,77,0.42,16,0.02625,59
3039.71785,38,56,0.59,18,0.032777778,59
3038.350847,54,89,0.88,35,0.025142857,59
3037.373417,56,72,0.55,16,0.034375,59
3037.373417,55,73,0.62,18,0.034444444,59
3037.325401,60,71,0.37,11,0.033636364,59
3037.325401,57,75,0.6,18,0.033333333,59
3037.307257,52,76,0.82,24,0.034166667,59
3036.272782,56,58,0.06,2,0.03,59
3036.272782,55,59,0.12,4,0.03,59
3036.103249,52,90,0.97,38,0.025526316,59
3035.205373,56,75,0.64,19,0.033684211,59
3034.964867,61,71,0.33,10,0.033,59
3034.940503,54,78,0.79,24,0.032916667,59
3034.87859,70,76,0.17,6,0.028333333,59
3034.87859,67,79,0.34,12,0.028333333,59
3034.831528,63,84,0.59,21,0.028095238,59
3034.215772,52,60,0.25,8,0.03125,59
3033.553486,61,87,0.73,26,0.028076923,59
3032.886915,58,85,0.67,27,0.024814815,59
3032.104072,61,86,0.71,25,0.0284,59
3032.071332,56,75,0.63,19,0.033157895,59
3032.064391,53,89,0.91,36,0.025277778,59
3032.013217,64,67,0.1,3,0.033333333,59
3032.013217,58,74,0.53,16,0.033125,59
3032.013217,55,77,0.73,22,0.033181818,59
3031.303442,59,88,0.82,29,0.028275862,59
3031.106725,57,74,0.57,17,0.033529412,59
3030.132096,55,85,0.87,30,0.029,59
3029.180031,60,82,0.55,22,0.025,59
3029.180031,59,83,0.6,24,0.025,59
3029.122407,55,76,0.7,21,0.033333333,59
3028.904543,48,64,0.51,16,0.031875,59
3027.698664,45,61,0.42,16,0.02625,59
3027.54907,54,91,0.94,37,0.025405405,59
3027.247262,54,77,0.77,23,0.033478261,59
3027.247262,53,78,0.84,25,0.0336,59
3026.936738,63,68,0.15,5,0.03,59
3025.629425,65,69,0.11,4,0.0275,59
3025.537782,64,82,0.5,18,0.027777778,59
3025.218396,51,78,0.93,27,0.034444444,59
3023.673511,58,78,0.54,20,0.027,59
3023.186129,58,96,0.96,38,0.025263158,59
3022.994153,53,88,0.9,35,0.025714286,59
3022.485573,45,73,0.65,28,0.023214286,59
3022.485573,44,74,0.7,30,0.023333333,59
3022.24098,64,71,0.19,7,0.027142857,59
3021.961216,45,74,0.75,29,0.025862069,59
3021.952144,58,73,0.5,15,0.033333333,59
3021.952144,53,79,0.86,26,0.033076923,59
3021.952144,52,80,0.93,28,0.033214286,59
3021.576139,61,69,0.27,8,0.03375,59
3021.44127,62,87,0.66,25,0.0264,59
3021.164576,66,84,0.46,18,0.025555556,59
3021.093326,57,77,0.56,20,0.028,59
3020.305831,56,76,0.59,20,0.0295,59
3019.717729,42,73,0.82,31,0.026451613,59
3018.911039,47,68,0.63,21,0.03,59
3018.911039,46,69,0.69,23,0.03,59
3018.895441,57,87,0.74,30,0.024666667,59
3018.651146,65,76,0.32,11,0.029090909,59
3018.455528,44,74,0.69,30,0.023,59
3017.800953,46,68,0.66,22,0.03,59
3017.280862,57,91,0.96,34,0.028235294,59
3017.272791,54,87,0.85,33,0.025757576,59
3017.234064,58,90,0.9,32,0.028125,59
3017.071298,57,93,0.96,36,0.026666667,59
3016.999607,59,92,0.86,33,0.026060606,59
3016.999607,57,94,0.97,37,0.026216216,59
3015.858143,49,69,0.46,20,0.023,59
3015.094488,50,62,0.38,12,0.031666667,59
3014.845157,64,69,0.14,5,0.028,59
3014.346247,59,81,0.63,22,0.028636364,59
3013.437621,67,72,0.13,5,0.026,59
3013.258184,57,84,0.69,27,0.025555556,59
3013.258184,56,85,0.74,29,0.025517241,59
3012.602579,55,86,0.79,31,0.025483871,59
3012.141492,56,70,0.51,14,0.036428571,59
3011.210587,70,78,0.21,8,0.02625,59
3010.407763,53,90,0.95,37,0.025675676,59
3009.808812,55,86,0.88,31,0.028387097,59
3008.650193,45,69,0.59,24,0.024583333,59
3007.953627,33,62,0.96,29,0.033103448,59
3007.565734,65,66,0.03,1,0.03,59
3007.565734,64,67,0.09,3,0.03,59
3006.949781,54,85,0.81,31,0.026129032,59
3006.488462,55,86,0.8,31,0.025806452,59
3006.390108,67,79,0.33,12,0.0275,59
3006.060178,69,76,0.2,7,0.028571429,59
3006.060178,64,82,0.51,18,0.028333333,59
3006.060178,63,83,0.57,20,0.0285,59
3006.050878,54,88,0.85,34,0.025,59
3005.815674,63,79,0.46,16,0.02875,59
3005.767929,64,81,0.48,17,0.028235294,59
3005.552631,52,89,0.96,37,0.025945946,59
3005.47017,54,88,0.86,34,0.025294118,59
3005.244156,44,63,0.49,19,0.025789474,59
3005.095382,58,91,0.92,33,0.027878788,59
3005.095382,57,92,0.98,35,0.028,59
3004.224772,63,89,0.66,26,0.025384615,59
3002.800237,37,63,0.94,26,0.036153846,59
3002.489797,63,77,0.36,14,0.025714286,59
3001.871805,54,86,0.84,32,0.02625,59
3001.313788,47,65,0.58,18,0.032222222,59
3000.980933,62,80,0.52,18,0.028888889,59
3000.954564,53,91,0.95,38,0.025,59
3000.642857,53,75,0.77,22,0.035,59
3000.193776,53,86,0.87,33,0.026363636,59
2999.663508,68,74,0.17,6,0.028333333,59
2999.663508,65,77,0.34,12,0.028333333,59
2999.644245,66,72,0.16,6,0.026666667,59
2998.806151,59,67,0.29,8,0.03625,59
2998.366467,58,82,0.62,24,0.025833333,59
2997.90424,60,90,0.79,30,0.026333333,59
2997.600453,53,87,0.9,34,0.026470588,59
2997.107654,52,89,0.97,37,0.026216216,59
2997.094001,58,86,0.69,28,0.024642857,59
2997.092689,58,82,0.69,24,0.02875,59
2997.092689,56,85,0.83,29,0.02862069,59
2997.07856,44,46,0.07,2,0.035,59
2996.604026,54,91,0.91,37,0.024594595,59
2996.604026,53,92,0.96,39,0.024615385,59
2994.74384,62,87,0.67,25,0.0268,59
2994.271636,53,88,0.91,35,0.026,59
2993.833564,63,86,0.62,23,0.026956522,59
2993.782056,45,54,0.28,9,0.031111111,59
2993.693769,51,60,0.23,9,0.025555556,59
2993.378393,39,55,0.52,16,0.0325,59
2991.78863,59,82,0.58,23,0.025217391,59
2991.57331,60,88,0.79,28,0.028214286,59
2991.226523,57,85,0.72,28,0.025714286,59
2991.139155,55,87,0.83,32,0.0259375,59
2990.9745,55,90,0.86,35,0.024571429,59
2990.65053,64,85,0.56,21,0.026666667,59
2990.65053,61,89,0.74,28,0.026428571,59
2990.65053,59,91,0.85,32,0.0265625,59
2990.479371,60,90,0.8,30,0.026666667,59
2990.479371,59,92,0.87,33,0.026363636,59
2990.429561,63,77,0.4,14,0.028571429,59
2990.12957,56,83,0.71,27,0.026296296,59
2990.12957,53,87,0.89,34,0.026176471,59
2989.460805,62,73,0.3,11,0.027272727,59
2989.460805,60,75,0.41,15,0.027333333,59
2989.381489,53,89,0.92,36,0.025555556,59
2989.35554,33,61,0.94,28,0.033571429,59
2989.227071,57,78,0.58,21,0.027619048,59
2989.15572,64,87,0.59,23,0.025652174,59
2989.15572,62,90,0.71,28,0.025357143,59
2989.15572,61,91,0.76,30,0.025333333,59
2989.15572,60,92,0.82,32,0.025625,59
2989.15572,59,94,0.89,35,0.025428571,59
2989.033716,44,71,0.82,27,0.03037037,59
2988.789513,45,70,0.75,25,0.03,59
2988.419722,34,99,0.17,65,0.002615385,59
2988.31185,47,59,0.31,12,0.025833333,59
2988.145817,57,94,0.99,37,0.026756757,59
2987.992948,60,81,0.53,21,0.025238095,59
2987.529914,55,81,0.71,26,0.027307692,59
2987.516599,69,75,0.17,6,0.028333333,59
2987.025489,58,92,0.9,34,0.026470588,59
2986.940501,65,71,0.16,6,0.026666667,59
2986.940501,62,74,0.32,12,0.026666667,59
2986.940501,60,76,0.43,16,0.026875,59
2986.933415,54,85,0.82,31,0.026451613,59
2986.563498,54,88,0.93,34,0.027352941,59
2986.49791,62,82,0.57,20,0.0285,59
2985.080246,57,79,0.6,22,0.027272727,59
2984.368382,37,57,0.66,20,0.033,59
2984.184526,59,88,0.81,29,0.027931034,59
2983.835508,48,65,0.42,17,0.024705882,59
2983.375891,58,68,0.36,10,0.036,59
2983.375891,54,73,0.68,19,0.035789474,59
2982.96885,45,70,0.76,25,0.0304,59
2981.938598,35,59,0.78,24,0.0325,59
2981.791348,64,77,0.37,13,0.028461538,59
2981.771973,64,78,0.4,14,0.028571429,59
2980.916376,55,88,0.83,33,0.025151515,59
2980.831312,35,60,0.82,25,0.0328,59
2980.803831,60,93,0.83,33,0.025151515,59
2980.803831,59,95,0.9,36,0.025,59
2980.803831,58,96,0.95,38,0.025,59
2979.772744,53,91,0.94,38,0.024736842,59
2979.318637,63,85,0.61,22,0.027727273,59
2979.054269,41,75,0.87,34,0.025588235,59
2978.97541,33,62,0.94,29,0.032413793,59
2978.767642,55,84,0.76,29,0.026206897,59
2978.748465,56,83,0.72,27,0.026666667,59
2978.687833,53,74,0.74,21,0.035238095,59
2978.053108,62,76,0.37,14,0.026428571,59
2977.836813,51,77,0.91,26,0.035,59
2977.68523,44,70,0.64,26,0.024615385,59
2977.543323,66,79,0.37,13,0.028461538,59
2977.490534,51,79,0.97,28,0.034642857,59
2977.245315,58,92,0.92,34,0.027058824,59
2977.081878,45,70,0.74,25,0.0296,59
2977.081878,44,71,0.8,27,0.02962963,59
2976.967742,63,76,0.34,13,0.026153846,59
2976.89635,52,64,0.31,12,0.025833333,59
2976.83384,53,72,0.7,19,0.036842105,59
2976.670427,58,77,0.51,19,0.026842105,59
2976.330028,66,75,0.26,9,0.028888889,59
2976.243897,53,89,0.99,36,0.0275,59
2975.792926,55,92,0.9,37,0.024324324,59
2975.710036,42,74,0.99,32,0.0309375,59
2975.465041,51,79,0.95,28,0.033928571,59
2975.369123,68,82,0.3,14,0.021428571,59
2975.340068,58,67,0.32,9,0.035555556,59
2975.044658,56,84,0.73,28,0.026071429,59
2974.987946,54,86,0.83,32,0.0259375,59
2974.616202,56,86,0.77,30,0.025666667,59
2974.502199,35,98,0.15,63,0.002380952,59
2974.384822,55,86,0.81,31,0.026129032,59
2974.262647,51,81,0.93,30,0.031,59
2973.462932,60,91,0.81,31,0.026129032,59
2973.462932,58,93,0.92,35,0.026285714,59
2973.292725,58,94,0.94,36,0.026111111,59
2973.195402,59,84,0.72,25,0.0288,59
2972.515492,58,94,0.78,36,0.021666667,59
2972.433555,71,77,0.16,6,0.026666667,59
2972.352889,57,82,0.66,25,0.0264,59
2971.990135,50,78,0.99,28,0.035357143,59
2971.204953,56,84,0.74,28,0.026428571,59
2970.926828,52,89,0.95,37,0.025675676,59
2970.854492,57,85,0.7,28,0.025,59
2970.185877,62,72,0.28,10,0.028,59
2969.97819,35,98,0.13,63,0.002063492,59
2968.985684,56,79,0.62,23,0.026956522,59
2968.985684,55,80,0.68,25,0.0272,59
2968.751124,54,82,0.75,28,0.026785714,59
2968.359822,66,78,0.34,12,0.028333333,59
2968.038516,61,80,0.48,19,0.025263158,59
2968.011118,46,60,0.36,14,0.025714286,59
2967.998312,57,83,0.68,26,0.026153846,59
2967.998312,57,84,0.7,27,0.025925926,59
2967.998312,56,85,0.75,29,0.025862069,59
2967.998312,54,87,0.86,33,0.026060606,59
2967.842408,59,92,0.73,33,0.022121212,59
2967.60402,53,89,0.93,36,0.025833333,59
2967.166303,60,91,0.68,31,0.021935484,59
2967.062449,54,90,0.94,36,0.026111111,59
2967.062449,53,91,0.99,38,0.026052632,59
2966.736558,47,65,0.51,18,0.028333333,59
2966.014707,52,59,0.17,7,0.024285714,59
2965.914596,57,91,0.95,34,0.027941176,59
2965.845443,46,60,0.37,14,0.026428571,59
2965.747629,41,50,0.31,9,0.034444444,59
2965.741468,54,88,0.94,34,0.027647059,59
2965.612139,58,84,0.66,26,0.025384615,59
2965.612139,57,85,0.71,28,0.025357143,59
2964.954535,50,89,0.99,39,0.025384615,59
2964.825048,55,85,0.79,30,0.026333333,59
2964.796836,57,82,0.72,25,0.0288,59
2964.684825,61,88,0.73,27,0.027037037,59
2964.395365,49,66,0.51,17,0.03,59
2964.395365,48,67,0.57,19,0.03,59
2964.370259,40,75,0.92,35,0.026285714,59
2964.254281,67,75,0.23,8,0.02875,59
2964.082218,65,83,0.49,18,0.027222222,59
2964.024559,36,96,0.15,60,0.0025,59
2963.91216,54,73,0.66,19,0.034736842,59
2963.827615,60,70,0.31,10,0.031,59
2963.454933,58,77,0.52,19,0.027368421,59
2963.379344,57,84,0.77,27,0.028518519,59
2963.372925,65,80,0.42,15,0.028,59
2963.372925,62,83,0.59,21,0.028095238,59
2963.243176,51,74,0.83,23,0.036086957,59
2963.021163,35,59,0.79,24,0.032916667,59
2963.009055,50,76,0.93,26,0.035769231,59
2962.748656,64,75,0.32,11,0.029090909,59
2962.552799,52,85,0.9,33,0.027272727,59
2962.505255,46,69,0.7,23,0.030434783,59
2962.335198,41,48,0.25,7,0.035714286,59
2962.019363,44,71,0.83,27,0.030740741,59
2961.885136,55,92,0.91,37,0.024594595,59
2961.652202,50,78,0.96,28,0.034285714,59
2961.579192,51,68,0.42,17,0.024705882,59
2961.301577,37,58,0.78,21,0.037142857,59
2960.968969,34,60,0.86,26,0.033076923,59
2960.968175,61,92,0.77,31,0.02483871,59
2960.929793,61,88,0.72,27,0.026666667,59
2960.805398,57,67,0.37,10,0.037,59
2960.689884,57,95,0.99,38,0.026052632,59
2960.649944,51,77,0.89,26,0.034230769,59
2960.228396,56,83,0.78,27,0.028888889,59
2959.982786,62,90,0.72,28,0.025714286,59
2959.59179,54,89,0.89,35,0.025428571,59
2959.206613,66,85,0.48,19,0.025263158,59
2959.161601,59,91,0.86,32,0.026875,59
2959.120205,63,86,0.61,23,0.026521739,59
2959.008498,46,52,0.19,6,0.031666667,59
2958.861822,57,91,0.94,34,0.027647059,59
2958.80604,60,80,0.57,20,0.0285,59
2958.682836,68,81,0.34,13,0.026153846,59
2958.654386,63,88,0.64,25,0.0256,59
2958.610168,57,85,0.79,28,0.028214286,59
2958.368936,59,87,0.79,28,0.028214286,59
2957.949454,36,57,0.69,21,0.032857143,59
2957.914676,66,74,0.23,8,0.02875,59
2957.750057,52,75,0.82,23,0.035652174,59
2957.269273,41,74,0.86,33,0.026060606,59
2956.709548,55,70,0.55,15,0.036666667,59
2956.705744,60,86,0.73,26,0.028076923,59
2956.698018,64,84,0.53,20,0.0265,59
2956.698018,62,86,0.64,24,0.026666667,59
2956.698018,61,88,0.71,27,0.026296296,59
2956.698018,59,90,0.82,31,0.026451613,59
2956.190868,53,84,0.84,31,0.027096774,59
2956.053562,53,87,0.88,34,0.025882353,59
2955.917331,59,87,0.69,28,0.024642857,59
2955.917331,58,88,0.74,30,0.024666667,59
2955.836221,54,69,0.56,15,0.037333333,59
2955.649222,36,59,0.75,23,0.032608696,59
2955.6222,54,82,0.77,28,0.0275,59
2955.388858,58,81,0.59,23,0.025652174,59
2955.388858,57,82,0.64,25,0.0256,59
2955.369487,50,78,0.98,28,0.035,59
2955.24413,58,93,0.93,35,0.026571429,59
2955.24413,57,94,0.98,37,0.026486486,59
2955.13117,52,75,0.83,23,0.036086957,59
2955.031865,53,86,0.88,33,0.026666667,59
2953.8923,56,88,0.79,32,0.0246875,59
2953.8923,55,89,0.84,34,0.024705882,59
2953.8923,54,90,0.89,36,0.024722222,59
2953.877362,53,93,0.97,40,0.02425,59
2953.516131,55,91,0.89,36,0.024722222,59
2953.447601,37,57,0.67,20,0.0335,59
2953.197847,59,76,0.47,17,0.027647059,59
2952.965131,59,81,0.57,22,0.025909091,59
2952.883841,54,71,0.61,17,0.035882353,59
2952.754046,57,71,0.5,14,0.035714286,59
2952.699295,59,85,0.72,26,0.027692308,59
2952.432923,57,81,0.64,24,0.026666667,59
2952.022749,39,56,0.62,17,0.036470588,59
2951.953154,57,86,0.72,29,0.024827586,59
2951.866694,49,71,0.54,22,0.024545455,59
2951.866694,48,72,0.59,24,0.024583333,59
2951.797958,56,85,0.82,29,0.028275862,59
2951.712323,58,85,0.68,27,0.025185185,59
2951.308062,61,84,0.65,23,0.02826087,59
2951.212374,60,74,0.39,14,0.027857143,59
2950.999133,56,86,0.75,30,0.025,59
2950.423091,64,84,0.55,20,0.0275,59
2950.278885,56,87,0.77,31,0.02483871,59
2950.278885,55,88,0.82,33,0.024848485,59
2950.160417,67,70,0.08,3,0.026666667,59
2950.134258,55,69,0.52,14,0.037142857,59
2949.465553,37,64,0.91,27,0.033703704,59
2949.390838,59,80,0.55,21,0.026190476,59
2949.255942,50,81,0.97,31,0.031290323,59
2949.255942,50,82,0.99,32,0.0309375,59
2948.846466,55,86,0.78,31,0.02516129,59
2948.766183,63,75,0.32,12,0.026666667,59
2948.766183,60,79,0.5,19,0.026315789,59
2948.766183,58,81,0.61,23,0.026521739,59
2948.716958,58,93,0.94,35,0.026857143,59
2948.685557,55,84,0.77,29,0.026551724,59
2948.685557,52,88,0.95,36,0.026388889,59
2948.657847,72,77,0.13,5,0.026,59
2948.62949,68,82,0.36,14,0.025714286,59
2948.585417,62,79,0.48,17,0.028235294,59
2948.564588,52,73,0.76,21,0.036190476,59
2948.54321,50,77,0.98,27,0.036296296,59
2948.508878,36,57,0.7,21,0.033333333,59
2948.398495,58,70,0.43,12,0.035833333,59
2948.398495,53,76,0.82,23,0.035652174,59
2948.246799,59,66,0.25,7,0.035714286,59
2948.145831,60,93,0.84,33,0.025454545,59
2948.058981,54,70,0.58,16,0.03625,59
2947.889104,51,78,0.94,27,0.034814815,59
2947.816653,40,76,0.94,36,0.026111111,59
2947.704342,61,79,0.52,18,0.028888889,59
2947.651316,39,53,0.47,14,0.033571429,59
2947.341415,60,89,0.8,29,0.027586207,59
2946.934684,66,75,0.2,9,0.022222222,59
2946.934684,64,77,0.29,13,0.022307692,59
2946.679534,66,82,0.42,16,0.02625,59
2946.636397,43,75,0.75,32,0.0234375,59
2946.516239,54,77,0.71,23,0.030869565,59
2946.455196,62,89,0.57,27,0.021111111,59
2946.348878,57,90,0.92,33,0.027878788,59
2946.340796,58,65,0.26,7,0.037142857,59
2946.207032,66,82,0.43,16,0.026875,59
2945.969343,56,73,0.58,17,0.034117647,59
2945.969343,52,78,0.88,26,0.033846154,59
2945.897451,58,71,0.45,13,0.034615385,59
2945.869392,57,68,0.39,11,0.035454545,59
2945.511367,51,79,0.88,28,0.031428571,59
2945.298205,39,54,0.51,15,0.034,59
2945.296993,67,73,0.17,6,0.028333333,59
2945.204354,55,89,0.94,34,0.027647059,59
2945.181864,60,77,0.45,17,0.026470588,59
2945.181864,57,81,0.63,24,0.02625,59
2944.891691,55,86,0.89,31,0.028709677,59
2944.891691,54,87,0.95,33,0.028787879,59
2944.442862,53,84,0.82,31,0.026451613,59
2944.413203,57,86,0.73,29,0.025172414,59
2944.413203,56,87,0.78,31,0.02516129,59
2944.190361,50,62,0.3,12,0.025,59
2944.173353,42,49,0.24,7,0.034285714,59
2943.61419,36,59,0.86,23,0.037391304,59
2943.429268,53,72,0.68,19,0.035789474,59
2943.414306,42,72,0.8,30,0.026666667,59
2943.303725,58,85,0.78,27,0.028888889,59
2943.225834,37,59,0.8,22,0.036363636,59
2943.167206,40,55,0.55,15,0.036666667,59
2943.038276,56,89,0.81,33,0.024545455,59
2943.002131,38,57,0.7,19,0.036842105,59
2942.994024,58,84,0.58,26,0.022307692,59
2942.887999,68,80,0.32,12,0.026666667,59
2942.765795,63,74,0.29,11,0.026363636,59
2942.742145,56,67,0.41,11,0.037272727,59
2942.693917,65,78,0.36,13,0.027692308,59
2942.529474,67,76,0.25,9,0.027777778,59
2942.529474,64,79,0.42,15,0.028,59
2942.429895,57,95,0.83,38,0.021842105,59
2942.264374,66,81,0.42,15,0.028,59
2942.040115,51,76,0.9,25,0.036,59
2941.985035,52,84,0.89,32,0.0278125,59
2941.897253,59,79,0.53,20,0.0265,59
2941.780053,58,82,0.63,24,0.02625,59
2941.600752,58,84,0.73,26,0.028076923,59
2941.600752,55,88,0.92,33,0.027878788,59
2941.421799,34,99,0.16,65,0.002461538,59
2941.18831,52,72,0.73,20,0.0365,59
2941.18831,49,76,0.98,27,0.036296296,59
2941.137919,61,83,0.63,22,0.028636364,59
2941.137919,60,84,0.69,24,0.02875,59
2941.092264,60,85,0.71,25,0.0284,59
2940.955874,50,75,0.91,25,0.0364,59
2940.580768,58,93,0.78,35,0.022285714,59
2940.547885,52,90,0.98,38,0.025789474,59
2940.458153,57,88,0.84,31,0.027096774,59
2940.306293,61,88,0.74,27,0.027407407,59
2940.117069,39,56,0.63,17,0.037058824,59
2939.901444,57,92,0.94,35,0.026857143,59
2939.773381,48,58,0.26,10,0.026,59
2939.50889,52,88,0.94,36,0.026111111,59
2939.479328,41,54,0.47,13,0.036153846,59
2939.479328,38,58,0.72,20,0.036,59
2939.26185,52,79,0.84,27,0.031111111,59
2939.157189,56,85,0.81,29,0.027931034,59
2939.066788,58,92,0.93,34,0.027352941,59
2938.857568,53,92,0.97,39,0.024871795,59
2938.788062,51,74,0.85,23,0.036956522,59
2938.503737,51,86,0.96,35,0.027428571,59
2938.261124,61,90,0.62,29,0.02137931,59
2937.963135,56,69,0.47,13,0.036153846,59
2937.952927,34,63,0.92,29,0.031724138,59
2937.893275,62,79,0.38,17,0.022352941,59
2937.888862,54,83,0.76,29,0.026206897,59
2937.888862,52,85,0.87,33,0.026363636,59
2937.692309,61,68,0.22,7,0.031428571,59
2937.60413,45,71,0.77,26,0.029615385,59
2937.60413,44,72,0.83,28,0.029642857,59
2937.495924,34,99,0.18,65,0.002769231,59
2937.441943,57,98,0.86,41,0.02097561,59
2937.3634,58,73,0.46,15,0.030666667,59
2937.013846,60,81,0.6,21,0.028571429,59
2936.92271,44,65,0.53,21,0.025238095,59
2936.79741,54,90,0.9,36,0.025,59
2936.740111,57,84,0.76,27,0.028148148,59
2936.569022,57,89,0.79,32,0.0246875,59
2936.569022,56,90,0.84,34,0.024705882,59
2936.569022,54,93,0.96,39,0.024615385,59
2936.567269,61,68,0.24,7,0.034285714,59
2936.363793,39,76,0.96,37,0.025945946,59
2936.354353,52,74,0.78,22,0.035454545,59
2936.288342,44,53,0.73,9,0.081111111,59
2936.288342,43,54,0.89,11,0.080909091,59
2936.186597,61,77,0.43,16,0.026875,59
2936.125328,63,89,0.65,26,0.025,59
2936.03492,43,47,0.14,4,0.035,59
2936.03492,42,48,0.21,6,0.035,59
2935.673087,52,77,0.89,25,0.0356,59
2935.453849,53,90,0.93,37,0.025135135,59
2935.453849,52,91,0.98,39,0.025128205,59
2935.27401,59,70,0.38,11,0.034545455,59
2935.076231,60,81,0.61,21,0.029047619,59
2935.076231,56,86,0.87,30,0.029,59
2935.028218,57,70,0.46,13,0.035384615,59
2934.558987,60,89,0.79,29,0.027241379,59
2934.370561,57,67,0.36,10,0.036,59
2933.880934,55,88,0.84,33,0.025454545,59
2933.848912,55,89,0.85,34,0.025,59
2933.761253,63,79,0.45,16,0.028125,59
2933.761253,62,81,0.53,19,0.027894737,59
2933.58626,53,93,0.98,40,0.0245,59
2933.523871,34,60,0.85,26,0.032692308,59
2933.517001,65,86,0.54,21,0.025714286,59
2933.517001,61,91,0.77,30,0.025666667,59
2933.496282,48,63,0.49,15,0.032666667,59
2933.154241,37,55,0.61,18,0.033888889,59
2933.125714,56,73,0.59,17,0.034705882,59
2933.125714,55,74,0.66,19,0.034736842,59
2933.125714,54,75,0.73,21,0.034761905,59
2932.666443,52,72,0.74,20,0.037,59
2932.593918,58,83,0.65,25,0.026,59
2932.434659,50,75,0.92,25,0.0368,59
2932.39445,43,74,0.74,31,0.023870968,59
2932.332023,46,50,0.13,4,0.0325,59
2932.123979,52,78,0.82,26,0.031538462,59
2932.060507,58,80,0.59,22,0.026818182,59
2932.060507,56,82,0.7,26,0.026923077,59
2931.997425,58,85,0.75,27,0.027777778,59
2931.997425,56,87,0.86,31,0.027741935,59
2931.996179,51,79,0.89,28,0.031785714,59
2931.911811,63,79,0.35,16,0.021875,59
2931.545155,57,70,0.47,13,0.036153846,59
2931.545155,53,74,0.76,21,0.036190476,59
2931.545155,53,75,0.79,22,0.035909091,59
2931.360342,54,90,0.91,36,0.025277778,59
2931.294193,50,65,0.45,15,0.03,59
2931.281434,55,83,0.84,28,0.03,59
2931.054152,51,80,0.91,29,0.03137931,59
2930.872686,61,81,0.44,20,0.022,59
2930.844153,59,65,0.22,6,0.036666667,59
2930.844153,56,68,0.44,12,0.036666667,59
2930.716254,58,96,0.8,38,0.021052632,59
2930.621671,67,87,0.38,20,0.019,59
2930.612508,57,68,0.4,11,0.036363636,59
2930.612508,54,71,0.62,17,0.036470588,59
2930.612508,53,72,0.69,19,0.036315789,59
2930.492896,59,85,0.71,26,0.027307692,59
2930.455493,51,86,0.92,35,0.026285714,59
2930.380501,57,87,0.75,30,0.025,59
2930.380501,56,88,0.8,32,0.025,59
2930.034672,43,72,0.71,29,0.024482759,59
2929.935845,62,90,0.73,28,0.026071429,59
2929.879437,64,75,0.29,11,0.026363636,59
2929.879437,61,78,0.45,17,0.026470588,59
2929.871378,58,92,0.91,34,0.026764706,59
2929.871378,57,93,0.97,36,0.026944444,59
2929.574079,52,80,0.86,28,0.030714286,59
2929.512505,43,73,0.91,30,0.030333333,59
2929.481177,36,65,0.98,29,0.033793103,59
2929.320374,46,67,0.66,21,0.031428571,59
2929.239831,61,74,0.35,13,0.026923077,59
2929.229292,59,81,0.58,22,0.026363636,59
2929.130538,64,87,0.6,23,0.026086957,59
2929.130538,62,89,0.71,27,0.026296296,59
2929.130538,61,91,0.78,30,0.026,59
2929.000987,67,83,0.41,16,0.025625,59
2928.978513,56,88,0.88,32,0.0275,59
2928.846086,51,87,0.97,36,0.026944444,59
2928.844963,61,85,0.68,24,0.028333333,59
2928.836707,60,84,0.65,24,0.027083333,59
2928.836707,56,89,0.89,33,0.026969697,59
2928.637507,55,74,0.67,19,0.035263158,59
2928.637507,54,75,0.74,21,0.035238095,59
2928.637507,53,76,0.81,23,0.035217391,59
2928.440523,56,76,0.6,20,0.03,59
2928.440523,55,77,0.66,22,0.03,59
2928.361613,59,82,0.65,23,0.02826087,59
2928.189791,45,69,0.73,24,0.030416667,59
2928.071413,65,79,0.4,14,0.028571429,59
2928.025954,63,82,0.54,19,0.028421053,59
2927.987108,54,90,0.99,36,0.0275,59
2927.960257,54,71,0.63,17,0.037058824,59
2927.909923,56,87,0.88,31,0.028387097,59
2927.7823,59,84,0.71,25,0.0284,59
2926.979136,60,93,0.85,33,0.025757576,59
2926.979136,59,94,0.9,35,0.025714286,59
2926.964071,37,59,0.81,22,0.036818182,59
2926.955529,62,78,0.46,16,0.02875,59
2926.887217,58,67,0.33,9,0.036666667,59
2926.851368,59,95,0.89,36,0.024722222,59
2926.831479,62,80,0.51,18,0.028333333,59
2926.813439,55,74,0.65,19,0.034210526,59
2926.738071,64,76,0.35,12,0.029166667,59
2926.595739,59,81,0.64,22,0.029090909,59
2926.595739,58,82,0.7,24,0.029166667,59
2926.282422,52,71,0.71,19,0.037368421,59
2926.238352,55,90,0.87,35,0.024857143,59
2926.125148,57,86,0.82,29,0.028275862,59
2926.066478,61,79,0.47,18,0.026111111,59
2926.054126,54,70,0.59,16,0.036875,59
2925.976505,54,87,0.83,33,0.025151515,59
2925.876548,61,66,0.18,5,0.036,59
2925.876548,56,71,0.54,15,0.036,59
2925.822847,51,74,0.84,23,0.036521739,59
2925.691303,55,88,0.88,33,0.026666667,59
2925.689946,64,76,0.34,12,0.028333333,59
2925.493504,58,84,0.75,26,0.028846154,59
2925.493504,57,85,0.81,28,0.028928571,59
2925.426809,40,75,0.91,35,0.026,59
2925.217002,41,52,0.4,11,0.036363636,59
2925.070376,55,69,0.51,14,0.036428571,59
2924.39364,59,75,0.44,16,0.0275,59
2924.32683,45,68,0.73,23,0.03173913,59
2923.817945,66,76,0.28,10,0.028,59
2923.791155,55,79,0.68,24,0.028333333,59
2923.571153,55,98,0.94,43,0.021860465,59
2923.41307,51,89,0.97,38,0.025526316,59
2923.328516,61,80,0.53,19,0.027894737,59
2923.328516,58,84,0.72,26,0.027692308,59
2923.328516,57,85,0.78,28,0.027857143,59
2923.296569,35,58,0.78,23,0.033913043,59
2923.287127,46,68,0.68,22,0.030909091,59
2922.99607,58,91,0.88,33,0.026666667,59
2922.99607,57,93,0.95,36,0.026388889,59
2922.964636,53,91,0.96,38,0.025263158,59
2922.844018,53,78,0.78,25,0.0312,59
2922.819193,54,92,0.93,38,0.024473684,59
2922.606169,59,82,0.66,23,0.028695652,59
2922.568177,45,62,0.44,17,0.025882353,59
2922.523694,50,76,0.94,26,0.036153846,59
2922.435692,59,83,0.69,24,0.02875,59
2922.283068,38,58,0.73,20,0.0365,59
2922.254201,48,57,0.24,9,0.026666667,59
2922.059899,59,83,0.67,24,0.027916667,59
2922.059899,59,84,0.69,25,0.0276,59
2921.901459,56,86,0.85,30,0.028333333,59
2921.900824,57,85,0.8,28,0.028571429,59
2921.513981,50,76,0.92,26,0.035384615,59
2921.313396,36,98,0.12,62,0.001935484,59
2921.308775,41,53,0.45,12,0.0375,59
2921.283049,51,75,0.85,24,0.035416667,59
2921.150087,59,91,0.87,32,0.0271875,59
2921.010712,53,86,0.98,33,0.02969697,59
2920.974468,54,89,0.9,35,0.025714286,59
2920.97179,52,88,0.91,36,0.025277778,59
2920.97179,51,89,0.96,38,0.025263158,59
2920.7936,45,71,0.61,26,0.023461538,59
2920.662109,53,87,0.91,34,0.026764706,59
2920.589389,59,68,0.32,9,0.035555556,59
2920.543823,58,79,0.56,21,0.026666667,59
2920.480398,53,71,0.67,18,0.037222222,59
2920.478908,47,68,0.64,21,0.03047619,59
2920.333313,56,86,0.78,30,0.026,59
2920.18155,52,89,0.98,37,0.026486486,59
2920.118577,39,55,0.6,16,0.0375,59
2919.526875,60,80,0.52,20,0.026,59
2919.478338,54,76,0.69,22,0.031363636,59
2919.431043,46,66,0.57,20,0.0285,59
2919.21878,55,84,0.84,29,0.028965517,59
2919.148562,40,54,0.52,14,0.037142857,59
2919.07554,56,81,0.67,25,0.0268,59
2918.813649,61,74,0.36,13,0.027692308,59
2918.641817,58,83,0.71,25,0.0284,59
2918.550643,50,78,0.97,28,0.034642857,59
2918.488901,55,81,0.69,26,0.026538462,59
2918.488901,53,83,0.8,30,0.026666667,59
2918.483658,56,97,0.87,41,0.021219512,59
2918.439143,56,80,0.66,24,0.0275,59
2918.380147,53,83,0.81,30,0.027,59
2918.307175,57,95,0.84,38,0.022105263,59
2918.293382,62,84,0.45,22,0.020454545,59
2918.147302,61,76,0.4,15,0.026666667,59
2918.086295,52,84,0.88,32,0.0275,59
2918.026114,48,66,0.55,18,0.030555556,59
2917.968031,54,77,0.72,23,0.031304348,59
2917.930827,63,80,0.48,17,0.028235294,59
2917.864089,61,72,0.31,11,0.028181818,59
2917.716246,51,77,0.9,26,0.034615385,59
2917.679236,56,86,0.76,30,0.025333333,59
2917.418791,36,56,0.68,20,0.034,59
2917.369495,52,73,0.77,21,0.036666667,59
2917.237272,48,49,0.08,1,0.08,59
2917.237272,47,50,0.24,3,0.08,59
2917.218797,56,74,0.56,18,0.031111111,59
2917.184499,56,98,0.89,42,0.021190476,59
2917.165952,63,72,0.24,9,0.026666667,59
2917.037275,66,75,0.25,9,0.027777778,59
2916.721709,55,99,0.93,44,0.021136364,59
2916.70046,47,70,0.54,23,0.023478261,59
2916.617444,43,51,0.29,8,0.03625,59
2916.449817,51,77,0.93,26,0.035769231,59
2916.43803,62,80,0.49,18,0.027222222,59
2916.437458,65,75,0.29,10,0.029,59
2916.413197,56,84,0.71,28,0.025357143,59
2916.321698,35,97,0.17,62,0.002741935,59
2916.248541,40,76,0.98,36,0.027222222,59
2915.9607,66,84,0.47,18,0.026111111,59
2915.453685,66,69,0.08,3,0.026666667,59
2915.223217,61,75,0.37,14,0.026428571,59
2915.163866,58,96,0.97,38,0.025526316,59
2915.119675,55,70,0.54,15,0.036,59
2915.0864,56,87,0.79,31,0.025483871,59
2914.998775,55,87,0.91,32,0.0284375,59
2914.974626,56,71,0.53,15,0.035333333,59
2914.634537,68,82,0.37,14,0.026428571,59
2914.634537,63,88,0.66,25,0.0264,59
2914.513645,43,55,0.93,12,0.0775,59
2914.461348,58,93,0.77,35,0.022,59
2914.345442,66,77,0.3,11,0.027272727,59
2914.159244,49,63,0.35,14,0.025,59
2914.104531,63,81,0.47,18,0.026111111,59
2913.946834,51,86,0.93,35,0.026571429,59
2913.826104,55,91,0.97,36,0.026944444,59
2913.72997,42,73,0.75,31,0.024193548,59
2913.43461,65,78,0.35,13,0.026923077,59
2913.362697,37,58,0.77,21,0.036666667,59
2913.320277,66,83,0.46,17,0.027058824,59
2913.252263,60,81,0.54,21,0.025714286,59
2913.24686,35,59,0.8,24,0.033333333,59
2913.234535,53,82,0.82,29,0.028275862,59
2913.084692,57,72,0.52,15,0.034666667,59
2913.062815,58,84,0.74,26,0.028461538,59
2913.047399,57,74,0.52,17,0.030588235,59
2913.047399,56,75,0.58,19,0.030526316,59
2913.047399,55,76,0.64,21,0.03047619,59
2913.046745,69,73,0.11,4,0.0275,59
2913.046745,67,75,0.22,8,0.0275,59
2913.046745,65,77,0.33,12,0.0275,59
2913.046745,63,79,0.44,16,0.0275,59
2913.046745,61,81,0.55,20,0.0275,59
2913.046745,60,83,0.63,23,0.027391304,59
2913.046745,58,85,0.74,27,0.027407407,59
2913.046745,56,88,0.87,32,0.0271875,59
2913.046745,55,89,0.93,34,0.027352941,59
2912.935818,67,74,0.2,7,0.028571429,59
2912.935818,63,78,0.43,15,0.028666667,59
2912.468749,46,51,0.4,5,0.08,59
2912.468749,45,52,0.56,7,0.08,59
2912.468749,44,53,0.72,9,0.08,59
2912.285063,60,92,0.83,32,0.0259375,59
2912.227354,61,71,0.29,10,0.029,59
2912.112687,63,78,0.42,15,0.028,59
2912.021476,57,69,0.44,12,0.036666667,59
2911.892248,46,71,0.59,25,0.0236,59
2911.869206,58,95,0.97,37,0.026216216,59
2911.816735,55,80,0.69,25,0.0276,59
2911.816735,53,83,0.82,30,0.027333333,59
2911.816735,52,84,0.87,32,0.0271875,59
2911.80933,38,54,0.54,16,0.03375,59
2911.676615,40,76,0.93,36,0.025833333,59
2911.374146,51,88,0.94,37,0.025405405,59
2911.286482,59,79,0.58,20,0.029,59
2911.24351,54,88,0.89,34,0.026176471,59
2911.230263,50,61,0.28,11,0.025454545,59
2911.171727,63,76,0.38,13,0.029230769,59
2911.126522,60,80,0.58,20,0.029,59
2911.117348,54,88,0.87,34,0.025588235,59
2911.094849,36,58,0.74,22,0.033636364,59
2911.010282,44,70,0.82,26,0.031538462,59
2910.968556,50,75,0.9,25,0.036,59
2910.958726,52,75,0.84,23,0.036521739,59
2910.753848,55,89,0.96,34,0.028235294,59
2910.637886,56,83,0.69,27,0.025555556,59
2910.637886,55,84,0.74,29,0.025517241,59
2910.637886,54,86,0.81,32,0.0253125,59
2910.533812,50,57,0.18,7,0.025714286,59
2910.49067,44,48,0.15,4,0.0375,59
2910.46905,62,77,0.44,15,0.029333333,59
2910.347886,59,71,0.37,12,0.030833333,59
2910.241132,60,86,0.54,26,0.020769231,59
2910.237079,56,75,0.59,19,0.031052632,59
2910.130319,55,87,0.81,32,0.0253125,59
2910.046701,58,86,0.76,28,0.027142857,59
2909.985461,62,82,0.53,20,0.0265,59
2909.940752,45,63,0.46,18,0.025555556,59
2909.737693,59,93,0.72,34,0.021176471,59
2909.575563,44,69,0.69,25,0.0276,59
2909.538514,64,80,0.42,16,0.02625,59
2909.470004,53,90,0.96,37,0.025945946,59
2909.45879,51,78,0.95,27,0.035185185,59
2909.408451,33,63,0.98,30,0.032666667,59
2909.399812,56,80,0.64,24,0.026666667,59
2909.233496,61,81,0.57,20,0.0285,59
2909.233496,60,83,0.65,23,0.02826087,59
2909.158903,60,82,0.62,22,0.028181818,59
2909.158903,56,87,0.87,31,0.028064516,59
2909.123473,49,77,0.99,28,0.035357143,59
2908.945975,51,78,0.96,27,0.035555556,59
2908.863604,60,81,0.59,21,0.028095238,59
2908.559556,52,76,0.86,24,0.035833333,59
2908.426934,54,88,0.88,34,0.025882353,59
2908.420209,49,62,0.33,13,0.025384615,59
2908.1953,55,86,0.9,31,0.029032258,59
2908.1953,54,87,0.96,33,0.029090909,59
2908.161903,40,53,0.43,13,0.033076923,59
2908.106383,60,84,0.66,24,0.0275,59
2908.106383,55,90,0.96,35,0.027428571,59
2908.013268,54,80,0.74,26,0.028461538,59
2908.013268,53,81,0.8,28,0.028571429,59
2907.997397,39,76,0.98,37,0.026486486,59
2907.940805,62,66,0.14,4,0.035,59
2907.940805,61,67,0.21,6,0.035,59
2907.940805,60,68,0.28,8,0.035,59
2907.940805,59,69,0.35,10,0.035,59
2907.907518,57,93,0.99,36,0.0275,59
2907.90376,56,87,0.85,31,0.027419355,59
2907.726091,55,85,0.76,30,0.025333333,59
2907.552209,52,78,0.89,26,0.034230769,59
2907.552209,51,79,0.96,28,0.034285714,59
2907.201283,59,95,0.76,36,0.021111111,59
2907.173473,66,79,0.27,13,0.020769231,59
2906.958722,61,80,0.55,19,0.028947368,59
2906.91358,62,79,0.49,17,0.028823529,59
2906.881387,45,69,0.6,24,0.025,59
2906.516943,59,76,0.46,17,0.027058824,59
2906.516943,57,78,0.57,21,0.027142857,59
2906.485322,57,93,0.98,36,0.027222222,59
2906.421031,53,76,0.8,23,0.034782609,59
2906.172968,45,70,0.77,25,0.0308,59
2906.16273,60,83,0.64,23,0.027826087,59
2906.16273,56,88,0.89,32,0.0278125,59
2906.147599,65,86,0.53,21,0.025238095,59
2906.114941,63,81,0.46,18,0.025555556,59
2905.984558,55,91,0.96,36,0.026666667,59
2905.921223,56,99,0.9,43,0.020930233,59
2905.826105,54,84,0.8,30,0.026666667,59
2905.496002,55,90,0.95,35,0.027142857,59
2905.33728,54,85,0.8,31,0.025806452,59
2905.310634,58,85,0.77,27,0.028518519,59
2905.310634,57,86,0.83,29,0.02862069,59
2905.310634,56,87,0.89,31,0.028709677,59
2905.135954,54,77,0.7,23,0.030434783,59
2905.096185,54,89,0.98,35,0.028,59
2905.089776,44,70,0.65,26,0.025,59
2905.045279,34,61,0.89,27,0.032962963,59
2904.834647,55,84,0.78,29,0.026896552,59
2904.603581,58,66,0.29,8,0.03625,59
2904.581065,59,77,0.48,18,0.026666667,59
2904.492141,57,95,0.82,38,0.021578947,59
2904.487049,61,90,0.63,29,0.021724138,59
2904.127666,56,89,0.9,33,0.027272727,59
2904.102646,58,82,0.56,24,0.023333333,59
2904.072087,61,86,0.51,25,0.0204,59
2903.919643,60,82,0.63,22,0.028636364,59
2903.823694,56,78,0.62,22,0.028181818,59
2903.667218,56,77,0.6,21,0.028571429,59
2903.642867,52,88,0.97,36,0.026944444,59
2903.592964,65,85,0.52,20,0.026,59
2903.592964,62,89,0.7,27,0.025925926,59
2903.565026,69,81,0.31,12,0.025833333,59
2903.524509,55,72,0.61,17,0.035882353,59
2903.524509,54,74,0.71,20,0.0355,59
2903.524509,53,75,0.78,22,0.035454545,59
2903.524509,52,76,0.85,24,0.035416667,59
2903.412787,51,85,0.95,34,0.027941176,59
2903.402333,56,86,0.86,30,0.028666667,59
2903.076196,54,62,0.21,8,0.02625,59
2902.993676,55,73,0.63,18,0.035,59
2902.993676,54,74,0.7,20,0.035,59
2902.933929,60,67,0.25,7,0.035714286,59
2902.933929,56,72,0.57,16,0.035625,59
2902.933929,55,73,0.64,18,0.035555556,59
2902.818992,49,65,0.49,16,0.030625,59
2902.773719,60,92,0.85,32,0.0265625,59
2902.77184,56,81,0.77,25,0.0308,59
2902.75059,52,74,0.77,22,0.035,59
2902.75059,51,75,0.84,24,0.035,59
2902.75059,50,76,0.91,26,0.035,59
2902.689555,62,84,0.61,22,0.027727273,59
2902.689555,59,88,0.8,29,0.027586207,59
2902.643307,69,79,0.27,10,0.027,59
2902.605329,61,80,0.54,19,0.028421053,59
2902.602464,68,73,0.14,5,0.028,59
2902.602464,62,80,0.5,18,0.027777778,59
2902.602464,60,82,0.61,22,0.027727273,59
2902.602464,57,86,0.8,29,0.027586207,59
2902.598918,44,72,0.84,28,0.03,59
2902.562731,52,77,0.88,25,0.0352,59
2902.503952,52,85,0.86,33,0.026060606,59
2902.497846,61,84,0.58,23,0.025217391,59
2902.497846,60,85,0.63,25,0.0252,59
2902.497846,58,88,0.75,30,0.025,59
2902.497846,57,89,0.8,32,0.025,59
2902.477022,67,81,0.38,14,0.027142857,59
2902.477022,65,84,0.51,19,0.026842105,59
2902.274473,53,84,0.81,31,0.026129032,59
2902.274473,51,87,0.93,36,0.025833333,59
2902.274473,50,88,0.98,38,0.025789474,59
2902.18033,68,73,0.11,5,0.022,59
2902.104729,48,69,0.5,21,0.023809524,59
2902.104729,47,70,0.55,23,0.023913043,59
2901.854671,56,86,0.84,30,0.028,59
2901.854671,55,87,0.9,32,0.028125,59
2901.854671,54,88,0.96,34,0.028235294,59
2901.767613,55,70,0.53,15,0.035333333,59
2901.659372,53,82,0.81,29,0.027931034,59
2901.659372,52,83,0.87,31,0.028064516,59
2901.617626,36,61,0.91,25,0.0364,59
2901.596252,56,79,0.64,23,0.027826087,59
2901.24654,58,86,0.78,28,0.027857143,59
2900.919539,53,90,0.92,37,0.024864865,59
2900.651296,52,83,0.89,31,0.028709677,59
2900.553463,70,79,0.17,9,0.018888889,59
2900.410994,64,83,0.51,19,0.026842105,59
2900.314286,44,50,0.22,6,0.036666667,59
2900.314286,41,53,0.44,12,0.036666667,59
2900.312197,56,88,0.9,32,0.028125,59
2900.311508,42,52,0.37,10,0.037,59
2900.194612,37,56,0.63,19,0.033157895,59
2900.16433,54,75,0.72,21,0.034285714,59
2900.16433,53,76,0.79,23,0.034347826,59
2900.101755,54,89,0.97,35,0.027714286,59
2900.070306,60,78,0.48,18,0.026666667,59
2899.904496,58,95,0.95,37,0.025675676,59
2899.831695,59,83,0.68,24,0.028333333,59
2899.600264,42,73,0.8,31,0.025806452,59
2899.221874,62,88,0.69,26,0.026538462,59
2899.221874,61,90,0.76,29,0.026206897,59
2899.221874,60,91,0.82,31,0.026451613,59
2899.055141,51,75,0.86,24,0.035833333,59
2898.928456,59,94,0.92,35,0.026285714,59
2898.928456,58,96,0.99,38,0.026052632,59
2898.804858,35,61,0.83,26,0.031923077,59
2898.782438,56,89,0.91,33,0.027575758,59
2898.644647,63,73,0.27,10,0.027,59
2898.632139,65,85,0.53,20,0.0265,59
2898.598201,51,85,0.96,34,0.028235294,59
2898.46334,38,57,0.71,19,0.037368421,59
2898.439084,40,52,0.4,12,0.033333333,59
2898.426202,35,98,0.14,63,0.002222222,59
2898.418414,56,69,0.48,13,0.036923077,59
2898.406826,54,90,0.98,36,0.027222222,59
2898.400969,37,64,0.92,27,0.034074074,59
2898.391371,66,77,0.29,11,0.026363636,59
2898.121064,49,76,0.99,27,0.036666667,59
2898.007596,49,61,0.31,12,0.025833333,59
2897.830709,55,84,0.75,29,0.025862069,59
2897.790073,40,75,0.93,35,0.026571429,59
2897.63781,52,90,0.99,38,0.026052632,59
2897.452679,59,86,0.69,27,0.025555556,59
2897.452679,57,89,0.81,32,0.0253125,59
2897.44975,63,65,0.07,2,0.035,59
2897.265943,75,77,0.04,2,0.02,59
2897.265943,74,78,0.08,4,0.02,59
2897.265943,73,79,0.12,6,0.02,59
2897.265943,72,80,0.16,8,0.02,59
2897.265943,71,81,0.2,10,0.02,59
2897.127117,52,86,0.89,34,0.026176471,59
2896.84481,59,84,0.7,25,0.028,59
2896.770515,55,82,0.73,27,0.027037037,59
2896.481752,54,83,0.75,29,0.025862069,59
2896.467216,56,69,0.46,13,0.035384615,59
2896.467216,53,73,0.7,20,0.035,59
2896.252733,52,86,0.87,34,0.025588235,59
2896.03102,64,91,0.51,27,0.018888889,59
2895.759921,61,85,0.67,24,0.027916667,59
2895.645336,64,79,0.41,15,0.027333333,59
2895.645336,62,81,0.52,19,0.027368421,59
2895.645336,57,87,0.82,30,0.027333333,59
2895.624068,55,84,0.86,29,0.029655172,59
2895.624068,54,85,0.92,31,0.029677419,59
2895.612225,68,81,0.35,13,0.026923077,59
2895.231106,51,86,0.94,35,0.026857143,59
2895.155578,38,62,0.85,24,0.035416667,59
2895.061427,54,88,0.97,34,0.028529412,59
2895.026558,56,88,0.91,32,0.0284375,59
2895.001747,37,95,0.14,58,0.002413793,59
2894.997714,54,91,0.93,37,0.025135135,59
2894.981094,57,79,0.58,22,0.026363636,59
2894.829541,61,82,0.56,21,0.026666667,59
2894.829541,61,83,0.58,22,0.026363636,59
2894.807555,51,81,0.92,30,0.030666667,59
2894.660133,58,81,0.66,23,0.028695652,59
2894.594748,59,93,0.89,34,0.026176471,59
2894.550802,57,76,0.54,19,0.028421053,59
2894.537321,54,86,0.85,32,0.0265625,59
2894.537321,53,88,0.92,35,0.026285714,59
2894.475782,56,73,0.54,17,0.031764706,59
2894.475782,54,75,0.67,21,0.031904762,59
2894.419794,57,80,0.75,23,0.032608696,59
2894.321626,66,76,0.27,10,0.027,59
2894.172375,41,73,0.87,32,0.0271875,59
2894.169681,58,96,0.98,38,0.025789474,59
2894.045807,55,88,0.94,33,0.028484848,59
2893.928753,53,87,0.86,34,0.025294118,59
2893.928458,59,75,0.45,16,0.028125,59
2893.849157,67,76,0.24,9,0.026666667,59
2893.849157,64,79,0.4,15,0.026666667,59
2893.831198,63,88,0.65,25,0.026,59
2893.679428,64,78,0.38,14,0.027142857,59
2893.64804,59,70,0.35,11,0.031818182,59
2893.64804,55,75,0.63,20,0.0315,59
2893.64804,53,77,0.76,24,0.031666667,59
2893.424003,54,89,0.87,35,0.024857143,59
2893.347688,52,77,0.86,25,0.0344,59
2893.272948,56,77,0.63,21,0.03,59
2893.125123,61,81,0.56,20,0.028,59
2892.60547,58,78,0.53,20,0.0265,59
2892.45263,57,72,0.48,15,0.032,59
2892.427615,50,66,0.43,16,0.026875,59
2892.424493,57,86,0.81,29,0.027931034,59
2892.383204,35,58,0.76,23,0.033043478,59
2892.02618,50,74,0.89,24,0.037083333,59
2891.963351,60,66,0.22,6,0.036666667,59
2891.963351,54,73,0.69,19,0.036315789,59
2891.602317,52,84,0.86,32,0.026875,59
2891.590314,56,87,0.69,31,0.022258065,59
2891.486931,37,64,0.9,27,0.033333333,59
2891.450902,52,64,0.29,12,0.024166667,59
2891.3968,52,79,0.85,27,0.031481481,59
2891.378953,57,88,0.83,31,0.026774194,59
2891.373671,52,85,0.88,33,0.026666667,59
2891.373671,50,87,0.99,37,0.026756757,59
2891.211531,54,89,0.94,35,0.026857143,59
2891.084371,57,73,0.5,16,0.03125,59
2891.034337,56,91,0.85,35,0.024285714,59
2891.033119,53,88,0.88,35,0.025142857,59
2890.993555,44,73,0.68,29,0.023448276,59
2890.87923,55,92,0.92,37,0.024864865,59
2890.87923,54,93,0.97,39,0.024871795,59
2890.868228,70,73,0.08,3,0.026666667,59
2890.855764,55,76,0.65,21,0.030952381,59
2890.746137,53,95,0.99,42,0.023571429,59
2890.649936,54,94,0.97,40,0.02425,59
2890.508932,58,86,0.79,28,0.028214286,59
2890.508932,57,87,0.85,30,0.028333333,59
2890.305385,55,89,0.88,34,0.025882353,59
2890.284199,35,54,0.68,19,0.035789474,59
2890.199339,44,64,0.51,20,0.0255,59
2890.185756,54,84,0.91,30,0.030333333,59
2890.185756,53,85,0.98,32,0.030625,59
2890.11104,54,86,0.76,32,0.02375,59
2889.76649,57,83,0.76,26,0.029230769,59
2889.630398,63,83,0.41,20,0.0205,59
2889.594205,59,86,0.77,27,0.028518519,59
2889.594205,58,87,0.83,29,0.02862069,59
2889.594205,57,89,0.91,32,0.0284375,59
2889.552992,62,64,0.07,2,0.035,59
2889.552992,61,65,0.14,4,0.035,59
2889.552992,60,66,0.21,6,0.035,59
2889.552992,59,67,0.28,8,0.035,59
2889.552992,58,68,0.35,10,0.035,59
2889.551835,44,71,0.84,27,0.031111111,59
2889.444983,58,86,0.77,28,0.0275,59
2889.444983,57,87,0.83,30,0.027666667,59
2889.09252,68,80,0.33,12,0.0275,59
2889.09252,66,82,0.44,16,0.0275,59
2888.961491,58,88,0.85,30,0.028333333,59
2888.840834,62,83,0.6,21,0.028571429,59
2888.593001,35,58,0.77,23,0.033478261,59
2888.476759,33,64,0.98,31,0.031612903,59
2888.450551,34,99,0.19,65,0.002923077,59
2888.084364,60,89,0.76,29,0.026206897,59
2888.084364,57,93,0.94,36,0.026111111,59
2888.024463,51,87,0.94,36,0.026111111,59
2887.994336,55,78,0.66,23,0.028695652,59
2887.994336,54,79,0.72,25,0.0288,59
2887.696152,40,73,0.93,33,0.028181818,59
2887.528131,52,85,0.89,33,0.026969697,59
2887.514091,55,89,0.86,34,0.025294118,59
2887.101109,51,65,0.34,14,0.024285714,59
2887.043248,58,83,0.7,25,0.028,59
2886.784384,54,80,0.73,26,0.028076923,59
2886.690399,54,82,0.76,28,0.027142857,59
2886.686276,41,73,0.86,32,0.026875,59
2886.673426,40,76,0.95,36,0.026388889,59
2886.672305,57,73,0.49,16,0.030625,59
2886.556457,52,77,0.87,25,0.0348,59
2886.528327,52,83,0.86,31,0.027741935,59
2886.519492,58,72,0.43,14,0.030714286,59
2886.504478,59,92,0.88,33,0.026666667,59
2886.323979,52,87,0.89,35,0.025428571,59
2886.313644,55,88,0.91,33,0.027575758,59
2886.212019,59,83,0.61,24,0.025416667,59
2886.141577,40,74,0.93,34,0.027352941,59
2886.094107,53,77,0.75,24,0.03125,59
2886.086289,52,64,0.32,12,0.026666667,59
2886.002743,58,89,0.86,31,0.027741935,59
2885.998824,64,76,0.31,12,0.025833333,59
2885.90456,60,72,0.35,12,0.029166667,59
2885.584727,44,70,0.69,26,0.026538462,59
2885.576562,58,89,0.87,31,0.028064516,59
2885.502474,53,71,0.66,18,0.036666667,59
2885.502474,51,73,0.81,22,0.036818182,59
2885.442875,53,88,0.89,35,0.025428571,59
2885.232261,37,63,0.93,26,0.035769231,59
2885.225289,63,71,0.22,8,0.0275,59
2885.225289,61,73,0.33,12,0.0275,59
2885.1307,56,81,0.66,25,0.0264,59
2885.1307,54,83,0.77,29,0.026551724,59
2885.119276,55,82,0.71,27,0.026296296,59
2885.119276,53,85,0.83,32,0.0259375,59
2885.107382,51,77,0.94,26,0.036153846,59
2884.869001,63,87,0.64,24,0.026666667,59
2884.654829,59,73,0.41,14,0.029285714,59
2884.654829,58,74,0.47,16,0.029375,59
2884.654829,57,75,0.53,18,0.029444444,59
2884.453248,36,60,0.89,24,0.037083333,59
2884.449357,52,73,0.75,21,0.035714286,59
2884.426714,56,77,0.61,21,0.029047619,59
2884.426714,55,78,0.67,23,0.029130435,59
2884.426714,54,79,0.73,25,0.0292,59
2884.403766,38,61,0.83,23,0.036086957,59
2884.377286,45,69,0.75,24,0.03125,59
2884.37055,59,93,0.9,34,0.026470588,59
2884.200064,52,82,0.86,30,0.028666667,59
2884.175855,52,91,0.99,39,0.025384615,59
2884.137293,57,69,0.43,12,0.035833333,59
2884.137032,40,76,0.97,36,0.026944444,59
2884.129963,61,74,0.43,13,0.033076923,59
2884.12038,47,66,0.47,19,0.024736842,59
2884.099262,64,79,0.43,15,0.028666667,59
2884.056085,66,88,0.42,22,0.019090909,59
2883.882201,56,90,0.87,34,0.025588235,59
2883.871239,59,86,0.68,27,0.025185185,59
2883.871239,58,87,0.73,29,0.025172414,59
2883.871239,57,88,0.78,31,0.02516129,59
2883.871239,56,90,0.85,34,0.025,59
2883.871239,55,91,0.9,36,0.025,59
2883.871239,54,92,0.95,38,0.025,59
2883.744595,60,75,0.4,15,0.026666667,59
2883.726656,59,94,0.91,35,0.026,59
2883.725233,66,81,0.4,15,0.026666667,59
2883.723651,42,74,0.94,32,0.029375,59
2883.366156,65,77,0.26,12,0.021666667,59
2883.315003,65,76,0.31,11,0.028181818,59
2883.024469,41,75,0.88,34,0.025882353,59
2882.976199,62,82,0.54,20,0.027,59
2882.93363,58,94,0.95,36,0.026388889,59
2882.896396,52,89,0.93,37,0.025135135,59
2882.896396,51,90,0.98,39,0.025128205,59
2882.672416,59,78,0.5,19,0.026315789,59
2882.66246,37,52,0.54,15,0.036,59
2882.627696,61,82,0.59,21,0.028095238,59
2882.627696,58,85,0.76,27,0.028148148,59
2882.622359,56,89,0.84,33,0.025454545,59
2882.622359,54,92,0.96,38,0.025263158,59
2882.306138,54,85,0.84,31,0.027096774,59
2882.304331,54,88,0.95,34,0.027941176,59
2882.171252,36,66,0.99,30,0.033,59
2882.097335,36,60,0.88,24,0.036666667,59
2882.065058,53,83,0.83,30,0.027666667,59
2882.043147,57,79,0.59,22,0.026818182,59
2882.021822,64,71,0.23,7,0.032857143,59
2881.93168,57,87,0.84,30,0.028,59
2881.876637,59,93,0.91,34,0.026764706,59
2881.808223,61,89,0.62,28,0.022142857,59
2881.708925,69,80,0.29,11,0.026363636,59
2881.637235,54,91,0.92,37,0.024864865,59
2881.522658,50,67,0.39,17,0.022941176,59
2881.473284,58,69,0.4,11,0.036363636,59
2881.457858,58,70,0.42,12,0.035,59
2881.109316,53,80,0.79,27,0.029259259,59
2881.109316,52,81,0.85,29,0.029310345,59
2881.013123,66,83,0.45,17,0.026470588,59
2881.013123,63,87,0.63,24,0.02625,59
2880.908661,58,89,0.88,31,0.028387097,59
2880.866191,41,72,0.87,31,0.028064516,59
2880.848036,67,83,0.42,16,0.02625,59
2880.848036,64,86,0.58,22,0.026363636,59
2880.806058,57,87,0.86,30,0.028666667,59
2880.806058,56,88,0.92,32,0.02875,59
2880.762836,54,80,0.75,26,0.028846154,59
2880.762836,53,81,0.81,28,0.028928571,59
2880.702111,57,86,0.64,29,0.022068966,59
2880.672888,55,72,0.62,17,0.036470588,59
2880.669088,62,71,0.26,9,0.028888889,59
2880.579848,55,79,0.67,24,0.027916667,59
2880.554265,41,74,0.9,33,0.027272727,59
2880.552125,53,82,0.8,29,0.027586207,59
2880.485293,50,88,0.99,38,0.026052632,59
2880.261915,70,79,0.24,9,0.026666667,59
2880.261915,67,82,0.4,15,0.026666667,59
2880.234895,58,83,0.72,25,0.0288,59
2880.059371,65,72,0.19,7,0.027142857,59
2879.990992,51,76,0.91,25,0.0364,59
2879.703672,59,79,0.54,20,0.027,59
2879.646924,63,80,0.47,17,0.027647059,59
2879.646924,61,82,0.58,21,0.027619048,59
2879.568924,41,80,0.99,39,0.025384615,59
2879.559249,53,85,0.86,32,0.026875,59
2879.426596,65,89,0.46,24,0.019166667,59
2879.426596,64,90,0.5,26,0.019230769,59
2879.405087,55,90,0.89,35,0.025428571,59
2879.307826,43,69,0.74,26,0.028461538,59
2879.079799,62,83,0.53,21,0.025238095,59
2879.040891,57,81,0.62,24,0.025833333,59
2878.964744,64,85,0.57,21,0.027142857,59
2878.964744,64,86,0.59,22,0.026818182,59
2878.94108,60,90,0.67,30,0.022333333,59
2878.821786,45,52,0.25,7,0.035714286,59
2878.767968,54,85,0.83,31,0.026774194,59
2878.767968,53,86,0.89,33,0.026969697,59
2878.531953,36,58,0.73,22,0.033181818,59
2878.483465,36,60,0.87,24,0.03625,59
2878.45775,60,84,0.62,24,0.025833333,59
2878.417207,65,78,0.34,13,0.026153846,59
2878.369022,51,84,0.93,33,0.028181818,59
2878.273129,66,78,0.32,12,0.026666667,59
2878.272941,60,78,0.52,18,0.028888889,59
2878.062823,52,86,0.88,34,0.025882353,59
2878.015949,39,77,0.99,38,0.026052632,59
2877.774953,62,89,0.72,27,0.026666667,59
2877.700612,49,68,0.45,19,0.023684211,59
2877.509799,56,91,0.86,35,0.024571429,59
2877.245274,58,95,0.98,37,0.026486486,59
2877.221947,52,82,0.87,30,0.029,59
2877.221947,51,83,0.93,32,0.0290625,59
2877.122445,51,83,0.92,32,0.02875,59
2877.122445,50,84,0.98,34,0.028823529,59
2877.122445,50,85,0.99,35,0.028285714,59
2877.097058,59,83,0.53,24,0.022083333,59
2877.043884,59,90,0.86,31,0.027741935,59
2876.902261,51,86,0.95,35,0.027142857,59
2876.874283,51,84,0.94,33,0.028484848,59
2876.87235,59,92,0.72,33,0.021818182,59
2876.820285,52,83,0.88,31,0.028387097,59
2876.765984,66,80,0.38,14,0.027142857,59
2876.470737,35,61,0.96,26,0.036923077,59
2876.440307,66,84,0.48,18,0.026666667,59
2876.307638,52,90,0.95,38,0.025,59
2876.238023,57,80,0.71,23,0.030869565,59
2876.102651,45,67,0.56,22,0.025454545,59
2875.986516,56,85,0.76,29,0.026206897,59
2875.986516,54,87,0.87,33,0.026363636,59
2875.894813,36,57,0.71,21,0.033809524,59
2875.785952,50,66,0.44,16,0.0275,59
2875.776999,56,82,0.78,26,0.03,59
2875.776306,56,89,0.85,33,0.025757576,59
2875.763816,61,72,0.32,11,0.029090909,59
2875.698365,53,90,0.94,37,0.025405405,59
2875.60117,53,96,0.99,43,0.023023256,59
2875.438111,52,75,0.81,23,0.035217391,59
2875.318745,55,91,0.92,36,0.025555556,59
2875.273074,56,90,0.86,34,0.025294118,59
2875.273074,54,93,0.98,39,0.025128205,59
2875.259808,59,80,0.59,21,0.028095238,59
2875.244971,57,87,0.78,30,0.026,59
2875.151592,60,82,0.49,22,0.022272727,59
2874.892441,54,74,0.72,20,0.036,59
2874.705982,68,75,0.19,7,0.027142857,59
2874.688562,44,71,0.64,27,0.023703704,59
2874.673792,36,61,0.9,25,0.036,59
2874.04021,55,83,0.74,28,0.026428571,59
2873.988405,65,78,0.37,13,0.028461538,59
2873.873258,52,88,0.98,36,0.027222222,59
2873.842791,52,76,0.87,24,0.03625,59
2873.80887,55,87,0.82,32,0.025625,59
2873.502477,54,83,0.79,29,0.027241379,59
2873.369966,52,82,0.9,30,0.03,59
2873.248378,34,71,0.99,37,0.026756757,59
2872.906457,52,92,0.99,40,0.02475,59
2872.82872,68,78,0.27,10,0.027,59
2872.82872,62,85,0.62,23,0.026956522,59
2872.821325,55,90,0.94,35,0.026857143,59
2872.594151,66,72,0.17,6,0.028333333,59
2872.594151,62,76,0.4,14,0.028571429,59
2872.529677,59,82,0.64,23,0.027826087,59
2872.529677,55,87,0.89,32,0.0278125,59
2872.52031,35,62,0.86,27,0.031851852,59
2872.210173,40,74,0.91,34,0.026764706,59
2872.166819,51,66,0.35,15,0.023333333,59
2872.155555,37,94,0.15,57,0.002631579,59
2872.089645,53,85,0.82,32,0.025625,59
2871.981921,42,70,0.8,28,0.028571429,59
2871.967702,50,67,0.4,17,0.023529412,59
2871.942236,52,88,0.96,36,0.026666667,59
2871.588205,57,88,0.76,31,0.024516129,59
2871.484737,41,59,0.56,18,0.031111111,59
2871.393925,48,71,0.52,23,0.022608696,59
2871.259627,59,89,0.81,30,0.027,59
2871.091024,55,88,0.95,33,0.028787879,59
2870.906822,61,91,0.79,30,0.026333333,59
2870.895661,35,62,0.97,27,0.035925926,59
2870.826244,56,59,0.08,3,0.026666667,59
2870.790093,57,86,0.77,29,0.026551724,59
2870.781602,64,87,0.61,23,0.026521739,59
2870.64311,56,72,0.56,16,0.035,59
2870.312028,59,93,0.88,34,0.025882353,59
2870.24761,48,64,0.4,16,0.025,59
2870.180498,59,86,0.7,27,0.025925926,59
2870.180498,57,89,0.82,32,0.025625,59
2870.171051,56,88,0.83,32,0.0259375,59
2870.114265,51,88,0.95,37,0.025675676,59
2870.082153,35,62,0.98,27,0.036296296,59
2870.010751,47,58,0.29,11,0.026363636,59
2869.965129,52,63,0.3,11,0.027272727,59
2869.913118,57,80,0.6,23,0.026086957,59
2869.830649,41,56,0.55,15,0.036666667,59
2869.80693,59,77,0.59,18,0.032777778,59
2869.589827,41,74,0.87,33,0.026363636,59
2869.570129,54,89,0.96,35,0.027428571,59
2869.55243,41,73,0.89,32,0.0278125,59
2869.487964,55,75,0.62,20,0.031,59
2869.487543,53,89,0.9,36,0.025,59
2869.470332,52,86,0.92,34,0.027058824,59
2869.345462,52,87,0.94,35,0.026857143,59
2869.275634,51,84,0.95,33,0.028787879,59
2869.248284,69,79,0.26,10,0.026,59
2869.242546,60,92,0.84,32,0.02625,59
2869.200431,56,90,0.97,34,0.028529412,59
2868.994849,38,61,0.79,23,0.034347826,59
2868.704351,58,87,0.78,29,0.026896552,59
2868.66713,53,78,0.77,25,0.0308,59
2868.66713,51,80,0.9,29,0.031034483,59
2868.646139,62,86,0.58,24,0.024166667,59
2868.645848,61,90,0.78,29,0.026896552,59
2868.598015,56,86,0.83,30,0.027666667,59
2868.538914,44,53,0.29,9,0.032222222,59
2868.467088,67,77,0.26,10,0.026,59
2868.452199,56,91,0.99,35,0.028285714,59
2868.386497,37,63,0.92,26,0.035384615,59
2868.348787,36,61,0.89,25,0.0356,59
2868.245115,61,89,0.75,28,0.026785714,59
2868.134067,62,81,0.5,19,0.026315789,59
2867.610973,63,70,0.2,7,0.028571429,59
2867.515762,56,89,0.94,33,0.028484848,59
2867.510673,46,66,0.51,20,0.0255,59
2867.384161,55,80,0.7,25,0.028,59
2867.363381,58,69,0.39,11,0.035454545,59
2867.29176,42,56,0.51,14,0.036428571,59
2867.133119,47,66,0.6,19,0.031578947,59
2867.120998,36,68,0.86,32,0.026875,59
2867.059287,57,88,0.79,31,0.025483871,59
2866.926169,65,79,0.36,14,0.025714286,59
2866.884978,57,90,0.93,33,0.028181818,59
2866.868951,45,68,0.63,23,0.027391304,59
2866.797073,60,72,0.36,12,0.03,59
2866.797073,59,73,0.42,14,0.03,59
