% profit,ema1,ema2,threshold,diff,thresh / diff,ID
3203.257178,38,68,0.1,30,0.003333333,16
3183.731528,37,69,0.12,32,0.00375,16
3170.977473,38,68,0.12,30,0.004,16
3167.743508,33,56,0.86,23,0.037391304,16
3163.37913,36,71,0.14,35,0.004,16
3123.925637,37,70,0.12,33,0.003636364,16
3123.099207,40,65,0.09,25,0.0036,16
3116.881188,40,46,0.23,6,0.038333333,16
3085.55187,37,51,0.52,14,0.037142857,16
3077.895407,35,73,0.15,38,0.003947368,16
3076.851334,38,68,0.11,30,0.003666667,16
3070.134223,40,53,0.49,13,0.037692308,16
3061.109772,35,73,0.14,38,0.003684211,16
3061.001766,32,56,0.92,24,0.038333333,16
3058.186365,33,55,0.84,22,0.038181818,16
3050.170728,32,57,0.94,25,0.0376,16
3049.427005,34,53,0.76,19,0.04,16
3044.208953,36,52,0.6,16,0.0375,16
3030.79358,56,76,0.64,20,0.032,16
3025.014173,41,53,0.43,12,0.035833333,16
3017.898331,36,71,0.12,35,0.003428571,16
3013.345843,36,70,0.14,34,0.004117647,16
3007.686064,36,71,0.13,35,0.003714286,16
3005.923116,37,70,0.11,33,0.003333333,16
3005.892754,37,69,0.13,32,0.0040625,16
3004.5037,59,72,0.42,13,0.032307692,16
3003.463556,45,48,0.11,3,0.036666667,16
3001.379761,43,49,0.23,6,0.038333333,16
2997.772145,73,74,0.02,1,0.02,16
2997.572557,42,51,0.34,9,0.037777778,16
2986.469444,37,69,0.14,32,0.004375,16
2984.780598,38,67,0.2,29,0.006896552,16
2984.379521,32,56,0.94,24,0.039166667,16
2982.443747,61,70,0.29,9,0.032222222,16
2979.845291,40,54,0.52,14,0.037142857,16
2979.474158,36,71,0.15,35,0.004285714,16
2977.581809,37,58,0.78,21,0.037142857,16
2974.735511,44,59,0.07,15,0.004666667,16
2972.870973,56,75,0.62,19,0.032631579,16
2969.340206,57,73,0.53,16,0.033125,16
2967.100202,39,47,0.31,8,0.03875,16
2961.438293,32,56,0.93,24,0.03875,16
2957.346437,35,69,0.25,34,0.007352941,16
2955.608446,60,70,0.33,10,0.033,16
2955.571162,53,90,0.97,37,0.026216216,16
2952.650881,72,75,0.06,3,0.02,16
2952.650881,71,76,0.1,5,0.02,16
2951.413609,34,55,0.78,21,0.037142857,16
2950.685849,55,77,0.71,22,0.032272727,16
2950.244071,34,53,0.73,19,0.038421053,16
2948.878443,54,78,0.78,24,0.0325,16
2948.704192,52,80,0.92,28,0.032857143,16
2948.704192,51,81,0.99,30,0.033,16
2947.959735,68,73,0.14,5,0.028,16
2947.155361,53,78,0.82,25,0.0328,16
2944.315271,55,76,0.69,21,0.032857143,16
2944.163088,39,66,0.11,27,0.004074074,16
2944.14128,54,77,0.76,23,0.033043478,16
2943.03344,53,96,0.95,43,0.022093023,16
2942.57716,56,74,0.6,18,0.033333333,16
2941.864648,38,67,0.12,29,0.004137931,16
2940.926718,38,95,0.07,57,0.00122807,16
2940.547697,60,71,0.36,11,0.032727273,16
2940.547697,58,73,0.49,15,0.032666667,16
2939.392832,36,70,0.13,34,0.003823529,16
2935.064755,53,79,0.85,26,0.032692308,16
2933.165532,42,50,0.29,8,0.03625,16
2933.15896,35,69,0.24,34,0.007058824,16
2928.990957,43,52,0.32,9,0.035555556,16
2928.792021,53,78,0.83,25,0.0332,16
2927.144416,52,79,0.89,27,0.032962963,16
2927.015691,43,50,0.26,7,0.037142857,16
2926.889824,63,68,0.16,5,0.032,16
2925.043657,57,74,0.56,17,0.032941176,16
2923.010867,61,69,0.27,8,0.03375,16
2922.654709,63,67,0.13,4,0.0325,16
2921.671517,36,70,0.15,34,0.004411765,16
2920.928477,60,69,0.31,9,0.034444444,16
2918.524463,59,71,0.39,12,0.0325,16
2918.249003,34,74,0.15,40,0.00375,16
2915.636841,35,52,0.66,17,0.038823529,16
2913.512446,36,60,0.85,24,0.035416667,16
2912.578135,51,84,0.93,33,0.028181818,16
2912.578135,50,85,0.99,35,0.028285714,16
2912.502476,61,69,0.26,8,0.0325,16
2912.502476,57,74,0.55,17,0.032352941,16
2911.874032,37,49,0.47,12,0.039166667,16
2911.670223,35,99,0.19,64,0.00296875,16
2911.488312,59,70,0.38,11,0.034545455,16
2911.113081,59,71,0.4,12,0.033333333,16
2910.698776,60,69,0.3,9,0.033333333,16
2906.973508,50,57,0.18,7,0.025714286,16
2906.634823,48,58,0.26,10,0.026,16
2906.446989,37,50,0.48,13,0.036923077,16
2906.128402,37,68,0.22,31,0.007096774,16
2904.252251,38,48,0.39,10,0.039,16
2903.960846,65,76,0.31,11,0.028181818,16
2903.410587,34,54,0.72,20,0.036,16
2903.345808,62,68,0.2,6,0.033333333,16
2902.953174,61,68,0.23,7,0.032857143,16
2902.851272,36,97,0.13,61,0.002131148,16
2902.761816,39,66,0.1,27,0.003703704,16
2901.990471,38,65,0.19,27,0.007037037,16
2901.954198,53,77,0.8,24,0.033333333,16
2900.802106,63,69,0.19,6,0.031666667,16
2897.367861,43,51,0.27,8,0.03375,16
2895.99196,35,72,0.17,37,0.004594595,16
2895.529343,37,95,0.08,58,0.00137931,16
2895.518142,63,66,0.1,3,0.033333333,16
2895.518142,56,73,0.57,17,0.033529412,16
2894.939425,41,53,0.44,12,0.036666667,16
2893.919664,32,55,0.89,23,0.038695652,16
2893.820441,41,52,0.41,11,0.037272727,16
2893.717528,54,76,0.73,22,0.033181818,16
2893.279906,35,71,0.17,36,0.004722222,16
2892.867113,59,70,0.36,11,0.032727273,16
2892.867113,56,73,0.56,17,0.032941176,16
2892.275378,38,56,0.68,18,0.037777778,16
2891.199431,52,83,0.87,31,0.028064516,16
2890.937935,58,69,0.37,11,0.033636364,16
2890.859322,51,80,0.96,29,0.033103448,16
2890.581757,35,72,0.15,37,0.004054054,16
2885.689997,58,74,0.51,16,0.031875,16
2884.432163,84,99,0.05,15,0.003333333,16
2884.393388,35,51,0.63,16,0.039375,16
2883.527769,41,52,0.42,11,0.038181818,16
2883.408845,35,72,0.14,37,0.003783784,16
2881.449308,41,47,0.22,6,0.036666667,16
2881.213153,57,92,0.76,35,0.021714286,16
2879.883684,36,98,0.13,62,0.002096774,16
2879.499818,38,70,0.1,32,0.003125,16
2879.059929,42,50,0.3,8,0.0375,16
2878.927523,53,89,0.96,36,0.026666667,16
2878.136873,35,52,0.65,17,0.038235294,16
2877.701323,55,95,0.87,40,0.02175,16
2875.114456,39,54,0.57,15,0.038,16
2874.942331,53,97,0.97,44,0.022045455,16
2874.493307,33,98,0.23,65,0.003538462,16
2874.329268,54,77,0.75,23,0.032608696,16
2874.079363,53,55,0.05,2,0.025,16
2874.057515,52,78,0.87,26,0.033461538,16
2873.040057,70,77,0.14,7,0.02,16
2872.866546,55,75,0.68,20,0.034,16
2872.802963,36,71,0.16,35,0.004571429,16
2872.697107,59,70,0.37,11,0.033636364,16
2872.691524,35,99,0.18,64,0.0028125,16
2872.322109,36,70,0.16,34,0.004705882,16
2870.279366,34,54,0.76,20,0.038,16
2869.131857,65,77,0.33,12,0.0275,16
2869.000147,57,73,0.52,16,0.0325,16
2868.299724,52,79,0.91,27,0.033703704,16
2868.299724,51,80,0.98,29,0.033793103,16
2868.055329,61,81,0.56,20,0.028,16
2867.931277,35,99,0.17,64,0.00265625,16
2867.220205,56,77,0.61,21,0.029047619,16
2866.536901,54,75,0.71,21,0.033809524,16
2866.486092,32,54,0.89,22,0.040454545,16
2866.442446,38,48,0.4,10,0.04,16
2866.442446,37,49,0.48,12,0.04,16
2866.018049,62,71,0.26,9,0.028888889,16
2865.281309,33,54,0.81,21,0.038571429,16
2865.275196,44,49,0.19,5,0.038,16
2865.035791,37,64,0.22,27,0.008148148,16
2864.692198,37,58,0.75,21,0.035714286,16
2864.540713,55,74,0.64,19,0.033684211,16
2863.57981,69,78,0.18,9,0.02,16
2863.57981,68,79,0.22,11,0.02,16
2862.92741,51,84,0.94,33,0.028484848,16
2862.20712,35,72,0.16,37,0.004324324,16
2861.046118,56,94,0.81,38,0.021315789,16
2860.627203,37,96,0.07,59,0.001186441,16
2859.777688,54,76,0.75,22,0.034090909,16
2859.736034,36,98,0.16,62,0.002580645,16
2859.307965,33,99,0.22,66,0.003333333,16
2858.397409,59,69,0.34,10,0.034,16
2857.620321,58,72,0.46,14,0.032857143,16
2857.09512,37,69,0.11,32,0.0034375,16
2855.599182,58,91,0.72,33,0.021818182,16
2855.494024,67,80,0.26,13,0.02,16
2855.187231,37,68,0.12,31,0.003870968,16
2854.817669,31,56,0.98,25,0.0392,16
2854.75484,54,96,0.92,42,0.021904762,16
2854.002377,36,70,0.23,34,0.006764706,16
2853.306341,35,53,0.68,18,0.037777778,16
2852.842943,35,98,0.18,63,0.002857143,16
2852.058776,63,78,0.42,15,0.028,16
2851.071392,39,55,0.6,16,0.0375,16
2850.910632,51,80,0.99,29,0.034137931,16
2850.200297,36,95,0.09,59,0.001525424,16
2850.121104,56,93,0.81,37,0.021891892,16
2849.720828,49,58,0.23,9,0.025555556,16
2849.688075,39,48,0.32,9,0.035555556,16
2849.35104,34,97,0.19,63,0.003015873,16
2849.036398,37,70,0.1,33,0.003030303,16
2848.848409,33,55,0.8,22,0.036363636,16
2848.720212,33,54,0.82,21,0.039047619,16
2848.158453,51,83,0.93,32,0.0290625,16
2848.026498,37,94,0.09,57,0.001578947,16
2847.657389,39,49,0.37,10,0.037,16
2847.558519,42,52,0.34,10,0.034,16
2847.430791,60,68,0.27,8,0.03375,16
2847.255221,39,66,0.12,27,0.004444444,16
2846.986361,37,68,0.14,31,0.004516129,16
2846.555501,34,74,0.17,40,0.00425,16
2845.668567,31,89,0.15,58,0.002586207,16
2845.631223,34,54,0.73,20,0.0365,16
2845.604253,33,55,0.83,22,0.037727273,16
2845.528273,56,89,0.85,33,0.025757576,16
2844.696357,57,92,0.77,35,0.022,16
2844.445731,55,94,0.86,39,0.022051282,16
2844.14124,35,72,0.25,37,0.006756757,16
2843.174353,27,92,0.22,65,0.003384615,16
2842.921575,34,71,0.26,37,0.007027027,16
2842.852582,39,90,0.09,51,0.001764706,16
2842.829626,36,50,0.55,14,0.039285714,16
2842.397968,55,88,0.86,33,0.026060606,16
2842.036328,50,84,0.99,34,0.029117647,16
2840.795242,35,72,0.18,37,0.004864865,16
2840.599901,38,94,0.07,56,0.00125,16
2840.477059,40,54,0.5,14,0.035714286,16
2840.061934,56,74,0.59,18,0.032777778,16
2839.476234,43,50,0.25,7,0.035714286,16
2839.25367,55,95,0.86,40,0.0215,16
2836.647628,36,97,0.12,61,0.001967213,16
2835.614086,53,89,0.97,36,0.026944444,16
2835.220051,51,76,0.86,25,0.0344,16
2835.220051,50,77,0.93,27,0.034444444,16
2833.675512,35,73,0.13,38,0.003421053,16
2833.635257,54,96,0.91,42,0.021666667,16
2833.49422,35,71,0.25,36,0.006944444,16
2833.493508,55,79,0.69,24,0.02875,16
2833.493508,54,80,0.75,26,0.028846154,16
2833.493508,53,81,0.81,28,0.028928571,16
2833.493508,52,82,0.87,30,0.029,16
2832.628054,34,53,0.74,19,0.038947368,16
2832.314311,57,70,0.44,13,0.033846154,16
2832.314311,56,71,0.51,15,0.034,16
2831.945217,52,75,0.79,23,0.034347826,16
2831.635674,62,80,0.5,18,0.027777778,16
2831.195405,52,84,0.88,32,0.0275,16
2830.907464,35,52,0.67,17,0.039411765,16
2830.813391,40,53,0.47,13,0.036153846,16
2830.084678,67,73,0.17,6,0.028333333,16
2829.929826,46,52,0.19,6,0.031666667,16
2829.025279,59,90,0.67,31,0.021612903,16
2828.630921,33,60,0.94,27,0.034814815,16
2828.191169,60,88,0.62,28,0.022142857,16
2827.669135,54,77,0.77,23,0.033478261,16
2827.669135,53,78,0.84,25,0.0336,16
2827.651207,35,54,0.7,19,0.036842105,16
2827.401836,55,78,0.67,23,0.029130435,16
2826.863315,40,62,0.17,22,0.007727273,16
2826.633539,35,98,0.16,63,0.002539683,16
2826.552537,56,74,0.61,18,0.033888889,16
2826.223981,55,74,0.63,19,0.033157895,16
2826.180921,55,76,0.7,21,0.033333333,16
2826.095957,53,74,0.72,21,0.034285714,16
2826.064574,55,95,0.88,40,0.022,16
2825.947493,62,79,0.48,17,0.028235294,16
2825.797416,57,75,0.58,18,0.032222222,16
2825.264466,36,51,0.58,15,0.038666667,16
2824.915058,55,72,0.58,17,0.034117647,16
2824.67794,32,56,0.91,24,0.037916667,16
2824.228834,56,75,0.65,19,0.034210526,16
2823.942483,61,68,0.24,7,0.034285714,16
2823.599324,60,85,0.68,25,0.0272,16
2823.287374,58,72,0.47,14,0.033571429,16
2823.287374,57,73,0.54,16,0.03375,16
2823.223062,38,50,0.44,12,0.036666667,16
2822.558472,28,90,0.18,62,0.002903226,16
2822.351797,55,91,0.92,36,0.025555556,16
2822.168583,57,72,0.5,15,0.033333333,16
2822.168583,53,76,0.77,23,0.033478261,16
2822.072041,27,92,0.2,65,0.003076923,16
2822.047795,41,66,0.08,25,0.0032,16
2821.988704,38,49,0.42,11,0.038181818,16
2821.029133,51,79,0.96,28,0.034285714,16
2820.386135,58,71,0.43,13,0.033076923,16
2819.988357,35,71,0.15,36,0.004166667,16
2819.233271,54,95,0.9,41,0.02195122,16
2818.457117,33,75,0.22,42,0.005238095,16
2818.003396,33,54,0.83,21,0.03952381,16
2817.964195,66,75,0.25,9,0.027777778,16
2817.868499,34,73,0.18,39,0.004615385,16
2817.329922,42,50,0.31,8,0.03875,16
2816.837593,57,88,0.8,31,0.025806452,16
2816.821854,51,74,0.7,23,0.030434783,16
2816.473472,27,91,0.23,64,0.00359375,16
2816.393371,29,85,0.24,56,0.004285714,16
2816.333776,39,71,0.11,32,0.0034375,16
2815.540855,55,75,0.67,20,0.0335,16
2815.540855,52,79,0.9,27,0.033333333,16
2815.164335,35,68,0.24,33,0.007272727,16
2815.096552,34,72,0.2,38,0.005263158,16
2814.332908,60,72,0.38,12,0.031666667,16
2814.230945,88,94,0.02,6,0.003333333,16
2814.141024,36,51,0.56,15,0.037333333,16
2813.196692,28,87,0.19,59,0.003220339,16
2813.166022,38,68,0.13,30,0.004333333,16
2812.437939,41,62,0.16,21,0.007619048,16
2812.423443,27,92,0.21,65,0.003230769,16
2811.932649,56,75,0.63,19,0.033157895,16
2811.896594,54,91,0.95,37,0.025675676,16
2811.508045,53,76,0.79,23,0.034347826,16
2811.508045,52,77,0.86,25,0.0344,16
2811.217219,53,77,0.82,24,0.034166667,16
2811.217219,52,78,0.89,26,0.034230769,16
2810.871665,37,67,0.21,30,0.007,16
2810.311898,36,54,0.61,18,0.033888889,16
2810.03452,57,78,0.58,21,0.027619048,16
2810.016373,61,72,0.32,11,0.029090909,16
2809.826288,38,99,0.11,61,0.001803279,16
2809.152059,51,79,0.94,28,0.033571429,16
2809.095248,55,75,0.66,20,0.033,16
2809.095248,54,75,0.7,21,0.033333333,16
2808.793012,59,76,0.47,17,0.027647059,16
2808.318913,31,88,0.16,57,0.002807018,16
2807.398084,36,50,0.56,14,0.04,16
2807.109343,57,89,0.86,32,0.026875,16
2806.987527,35,73,0.16,38,0.004210526,16
2806.906143,35,52,0.68,17,0.04,16
2806.865166,62,67,0.17,5,0.034,16
2806.299623,51,78,0.93,27,0.034444444,16
2804.128266,32,55,0.92,23,0.04,16
2803.8896,32,99,0.24,67,0.00358209,16
2803.567888,56,87,0.81,31,0.026129032,16
2802.275071,42,45,0.11,3,0.036666667,16
2801.394439,29,87,0.19,58,0.003275862,16
2800.613383,62,85,0.52,23,0.022608696,16
2800.516522,89,92,0.01,3,0.003333333,16
2800.496639,33,55,0.85,22,0.038636364,16
2799.983338,50,57,0.23,7,0.032857143,16
2799.918004,60,73,0.42,13,0.032307692,16
2799.782265,37,97,0.11,60,0.001833333,16
2799.747999,27,88,0.27,61,0.00442623,16
2799.262477,54,83,0.79,29,0.027241379,16
2799.262477,52,85,0.9,33,0.027272727,16
2799.262105,41,65,0.08,24,0.003333333,16
2797.948894,40,90,0.09,50,0.0018,16
2797.743966,29,86,0.21,57,0.003684211,16
2797.547041,61,74,0.36,13,0.027692308,16
2796.614482,67,75,0.22,8,0.0275,16
2796.477346,34,74,0.2,40,0.005,16
2796.313643,36,98,0.18,62,0.002903226,16
2796.278206,58,87,0.79,29,0.027241379,16
2796.019652,59,67,0.28,8,0.035,16
2795.94397,56,88,0.83,32,0.0259375,16
2795.94397,55,90,0.9,35,0.025714286,16
2795.879376,86,95,0.03,9,0.003333333,16
2795.775329,48,59,0.28,11,0.025454545,16
2795.460131,38,59,0.74,21,0.035238095,16
2795.366965,54,82,0.77,28,0.0275,16
2794.94618,31,89,0.16,58,0.002758621,16
2794.364563,37,57,0.72,20,0.036,16
2794.319159,57,87,0.83,30,0.027666667,16
2794.020667,35,71,0.16,36,0.004444444,16
2793.689889,63,70,0.22,7,0.031428571,16
2793.653834,56,79,0.64,23,0.027826087,16
2793.605461,58,78,0.55,20,0.0275,16
2793.42553,37,96,0.16,59,0.002711864,16
2793.276319,26,92,0.24,66,0.003636364,16
2793.0401,35,70,0.24,35,0.006857143,16
2792.305823,35,96,0.2,61,0.003278689,16
2791.776072,45,71,0.96,26,0.036923077,16
2791.689928,34,98,0.21,64,0.00328125,16
2791.659255,58,91,0.73,33,0.022121212,16
2791.559336,40,67,0.08,27,0.002962963,16
2791.127727,54,73,0.66,19,0.034736842,16
2790.799524,55,87,0.85,32,0.0265625,16
2790.479595,58,85,0.71,27,0.026296296,16
2790.479595,57,87,0.78,30,0.026,16
2790.479595,55,89,0.89,34,0.026176471,16
2790.375706,55,76,0.71,21,0.033809524,16
2789.315215,54,73,0.65,19,0.034210526,16
2789.141649,62,81,0.5,19,0.026315789,16
2789.141649,58,86,0.73,28,0.026071429,16
2789.089426,33,60,0.97,27,0.035925926,16
2789.029202,41,63,0.1,22,0.004545455,16
2788.222309,52,83,0.88,31,0.028387097,16
2788.19378,62,72,0.28,10,0.028,16
2788.035962,66,77,0.29,11,0.026363636,16
2788.035962,63,80,0.45,17,0.026470588,16
2788.035962,60,84,0.63,24,0.02625,16
2787.980613,36,98,0.14,62,0.002258065,16
2787.87895,36,99,0.15,63,0.002380952,16
2787.699387,33,55,0.82,22,0.037272727,16
2787.660893,53,91,0.99,38,0.026052632,16
2787.556966,36,58,0.74,22,0.033636364,16
2787.437698,35,72,0.13,37,0.003513514,16
2787.070616,26,92,0.22,66,0.003333333,16
2786.239948,58,75,0.55,17,0.032352941,16
2785.802773,34,52,0.72,18,0.04,16
2785.727017,40,67,0.1,27,0.003703704,16
2785.702353,67,77,0.27,10,0.027,16
2785.55762,57,86,0.81,29,0.027931034,16
2785.475326,28,90,0.17,62,0.002741935,16
2785.452764,58,70,0.41,12,0.034166667,16
2785.445981,34,97,0.2,63,0.003174603,16
2785.265004,39,91,0.09,52,0.001730769,16
2785.108084,62,69,0.23,7,0.032857143,16
2785.095412,54,89,0.92,35,0.026285714,16
2784.979861,36,99,0.17,63,0.002698413,16
2784.909508,62,80,0.48,18,0.026666667,16
2784.88991,62,63,0.03,1,0.03,16
2784.88991,61,64,0.09,3,0.03,16
2784.88991,60,65,0.15,5,0.03,16
2784.88991,59,66,0.21,7,0.03,16
2784.614177,32,55,0.9,23,0.039130435,16
2784.554389,36,97,0.14,61,0.002295082,16
2784.534401,35,51,0.65,16,0.040625,16
2784.464247,42,64,0.07,22,0.003181818,16
2784.396245,61,84,0.62,23,0.026956522,16
2784.162058,53,95,0.95,42,0.022619048,16
2784.036625,58,84,0.69,26,0.026538462,16
2784.036625,56,87,0.82,31,0.026451613,16
2783.880105,36,97,0.08,61,0.001311475,16
2783.86836,52,86,0.92,34,0.027058824,16
2783.768713,35,99,0.13,64,0.00203125,16
2783.484368,59,71,0.41,12,0.034166667,16
2783.413903,28,89,0.22,61,0.003606557,16
2783.274191,39,91,0.07,52,0.001346154,16
2783.102216,40,56,0.47,16,0.029375,16
2782.696597,85,97,0.04,12,0.003333333,16
2782.212147,60,82,0.58,22,0.026363636,16
2782.176756,57,77,0.63,20,0.0315,16
2781.614059,62,64,0.07,2,0.035,16
2781.614059,61,65,0.14,4,0.035,16
2781.614059,60,66,0.21,6,0.035,16
2781.575445,59,75,0.45,16,0.028125,16
2781.474364,56,86,0.8,30,0.026666667,16
2781.474364,54,88,0.91,34,0.026764706,16
2781.474364,54,89,0.93,35,0.026571429,16
2781.474364,53,90,0.98,37,0.026486486,16
2781.100801,36,68,0.23,32,0.0071875,16
2780.69293,27,92,0.23,65,0.003538462,16
2780.666554,58,85,0.75,27,0.027777778,16
2780.209644,25,94,0.22,69,0.003188406,16
2780.129024,40,53,0.44,13,0.033846154,16
2779.942324,56,90,0.92,34,0.027058824,16
2779.925524,39,46,0.29,7,0.041428571,16
2779.900212,54,92,0.97,38,0.025526316,16
2779.797971,46,70,0.89,24,0.037083333,16
2779.651507,57,85,0.74,28,0.026428571,16
2779.309856,53,84,0.85,31,0.027419355,16
2778.537187,55,74,0.65,19,0.034210526,16
2778.353195,33,53,0.81,20,0.0405,16
2778.345858,54,90,0.94,36,0.026111111,16
2778.262275,26,93,0.27,67,0.004029851,16
2778.260947,60,88,0.63,28,0.0225,16
2778.260947,58,90,0.72,32,0.0225,16
2778.260947,57,92,0.78,35,0.022285714,16
2778.260947,56,93,0.83,37,0.022432432,16
2778.238986,64,78,0.37,14,0.026428571,16
2778.238986,61,82,0.55,21,0.026190476,16
2777.994327,55,90,0.96,35,0.027428571,16
2777.897383,58,72,0.48,14,0.034285714,16
2777.897383,57,73,0.55,16,0.034375,16
2777.642778,39,54,0.51,15,0.034,16
2777.603803,60,73,0.38,13,0.029230769,16
2777.603803,59,74,0.44,15,0.029333333,16
2777.554518,34,98,0.17,64,0.00265625,16
2777.306252,54,95,0.91,41,0.022195122,16
2776.746468,55,72,0.59,17,0.034705882,16
2776.227077,31,56,0.99,25,0.0396,16
2776.133061,62,74,0.33,12,0.0275,16
2775.60189,44,58,0.1,14,0.007142857,16
2775.579399,55,94,0.88,39,0.022564103,16
2775.464697,53,82,0.81,29,0.027931034,16
2775.464697,51,85,0.94,34,0.027647059,16
2774.653038,38,93,0.07,55,0.001272727,16
2774.46611,55,90,0.91,35,0.026,16
2774.440216,56,80,0.66,24,0.0275,16
2774.43052,33,61,0.96,28,0.034285714,16
2774.319009,55,89,0.88,34,0.025882353,16
2773.666503,60,82,0.62,22,0.028181818,16
2773.324321,32,56,0.9,24,0.0375,16
2773.193254,65,81,0.33,16,0.020625,16
2773.080818,42,62,0.08,20,0.004,16
2772.914689,57,86,0.76,29,0.026206897,16
2772.914689,55,88,0.87,33,0.026363636,16
2772.482846,89,99,0.03,10,0.003,16
2772.480807,64,69,0.16,5,0.032,16
2772.397645,55,92,0.86,37,0.023243243,16
2772.38934,39,49,0.36,10,0.036,16
2772.310052,26,92,0.23,66,0.003484848,16
2772.231559,56,75,0.64,19,0.033684211,16
2772.061426,27,91,0.22,64,0.0034375,16
2771.963687,53,96,0.96,43,0.022325581,16
2771.907435,39,92,0.07,53,0.001320755,16
2771.8233,69,72,0.08,3,0.026666667,16
2771.4239,35,51,0.64,16,0.04,16
2771.338916,38,95,0.06,57,0.001052632,16
2771.238345,35,96,0.19,61,0.003114754,16
2770.999596,54,75,0.72,21,0.034285714,16
2770.840802,64,68,0.13,4,0.0325,16
2770.811647,26,92,0.28,66,0.004242424,16
2770.759886,34,55,0.74,21,0.035238095,16
2770.351982,36,97,0.17,61,0.002786885,16
2770.212424,34,99,0.2,65,0.003076923,16
2769.934627,27,92,0.19,65,0.002923077,16
2769.105355,37,94,0.08,57,0.001403509,16
2769.032424,54,91,0.96,37,0.025945946,16
2769.016417,58,77,0.53,19,0.027894737,16
2768.888478,61,71,0.32,10,0.032,16
2768.692516,36,53,0.63,17,0.037058824,16
2768.281634,53,85,0.88,32,0.0275,16
2768.193051,34,96,0.22,62,0.003548387,16
2768.02605,53,85,0.87,32,0.0271875,16
2767.895706,61,74,0.4,13,0.030769231,16
2767.799971,55,93,0.96,38,0.025263158,16
2767.723602,56,93,0.82,37,0.022162162,16
2767.632419,63,79,0.44,16,0.0275,16
2767.632419,61,81,0.55,20,0.0275,16
2767.632419,59,84,0.68,25,0.0272,16
2767.5101,34,53,0.72,19,0.037894737,16
2767.429588,37,99,0.14,62,0.002258065,16
2767.371477,46,55,0.07,9,0.007777778,16
2767.308061,45,71,0.97,26,0.037307692,16
2767.157041,28,86,0.26,58,0.004482759,16
2767.042638,32,55,0.91,23,0.039565217,16
2766.799289,60,73,0.41,13,0.031538462,16
2766.799289,59,75,0.5,16,0.03125,16
2766.789398,37,49,0.49,12,0.040833333,16
2766.738438,37,57,0.67,20,0.0335,16
2766.697206,38,63,0.2,25,0.008,16
2766.672322,55,92,0.99,37,0.026756757,16
2766.48281,42,47,0.18,5,0.036,16
2766.408843,65,78,0.34,13,0.026153846,16
2766.257338,35,95,0.21,60,0.0035,16
2766.14849,35,98,0.14,63,0.002222222,16
2765.982289,36,72,0.1,36,0.002777778,16
2765.970661,66,84,0.35,18,0.019444444,16
2765.147891,41,88,0.09,47,0.001914894,16
2765.099612,35,98,0.19,63,0.003015873,16
2765.095133,54,96,0.93,42,0.022142857,16
2764.978521,62,84,0.59,22,0.026818182,16
2764.959977,51,79,0.95,28,0.033928571,16
2764.802672,55,70,0.45,15,0.03,16
2764.802672,54,71,0.51,17,0.03,16
2764.762843,40,64,0.11,24,0.004583333,16
2764.761024,34,75,0.15,41,0.003658537,16
2764.53629,33,99,0.2,66,0.003030303,16
2764.037204,33,54,0.85,21,0.04047619,16
2763.915439,63,72,0.28,9,0.031111111,16
2763.618828,56,88,0.84,32,0.02625,16
2763.553708,54,84,0.82,30,0.027333333,16
2763.553708,52,86,0.93,34,0.027352941,16
2763.553708,51,87,0.99,36,0.0275,16
2763.346752,69,75,0.16,6,0.026666667,16
2763.259083,57,91,0.77,34,0.022647059,16
2763.241463,35,99,0.16,64,0.0025,16
2763.068007,61,73,0.38,12,0.031666667,16
2763.068007,59,75,0.51,16,0.031875,16
2763.068007,57,77,0.64,20,0.032,16
2762.73316,36,97,0.18,61,0.00295082,16
2762.687118,65,85,0.39,20,0.0195,16
2762.521684,62,80,0.49,18,0.027222222,16
2762.506673,35,95,0.18,60,0.003,16
2762.366373,56,73,0.58,17,0.034117647,16
2762.340799,38,69,0.11,31,0.003548387,16
2762.318096,39,92,0.08,53,0.001509434,16
2762.264759,34,74,0.16,40,0.004,16
2762.227625,57,76,0.6,19,0.031578947,16
2762.222583,33,55,0.81,22,0.036818182,16
2761.934106,64,72,0.22,8,0.0275,16
2761.831664,57,71,0.48,14,0.034285714,16
2761.805629,54,81,0.76,27,0.028148148,16
2761.763533,54,76,0.74,22,0.033636364,16
2761.763533,53,77,0.81,24,0.03375,16
2761.763533,52,78,0.88,26,0.033846154,16
2761.763533,51,80,0.97,29,0.033448276,16
2761.612449,55,93,0.86,38,0.022631579,16
2761.26214,64,83,0.43,19,0.022631579,16
2761.12332,46,70,0.88,24,0.036666667,16
2761.080197,27,88,0.28,61,0.004590164,16
2761.021432,51,85,0.95,34,0.027941176,16
2761.000188,29,87,0.18,58,0.003103448,16
2760.811881,58,67,0.27,9,0.03,16
2760.740393,27,89,0.25,62,0.004032258,16
2760.653545,60,75,0.46,15,0.030666667,16
2760.255786,35,71,0.26,36,0.007222222,16
2760.239296,51,86,0.96,35,0.027428571,16
2759.736151,36,98,0.12,62,0.001935484,16
2759.334789,36,95,0.16,59,0.002711864,16
2759.172822,57,72,0.51,15,0.034,16
2758.965758,58,84,0.73,26,0.028076923,16
2758.791008,36,68,0.22,32,0.006875,16
2758.725034,28,89,0.21,61,0.003442623,16
2758.63871,53,76,0.78,23,0.033913043,16
2758.451269,52,86,0.94,34,0.027647059,16
2758.445309,35,97,0.09,62,0.001451613,16
2758.091231,60,82,0.6,22,0.027272727,16
2757.954863,57,69,0.42,12,0.035,16
2757.954863,56,70,0.49,14,0.035,16
2757.877804,59,72,0.43,13,0.033076923,16
2757.743727,58,88,0.81,30,0.027,16
2757.455574,32,57,0.91,25,0.0364,16
2757.438472,56,89,0.9,33,0.027272727,16
2757.39743,36,57,0.76,21,0.036190476,16
2757.261373,34,59,0.86,25,0.0344,16
2757.214266,29,86,0.22,57,0.003859649,16
2757.1988,68,74,0.16,6,0.026666667,16
2757.1988,65,77,0.32,12,0.026666667,16
2757.075325,34,58,0.88,24,0.036666667,16
2756.965857,52,87,0.94,35,0.026857143,16
2756.396217,53,83,0.83,30,0.027666667,16
2756.305297,61,76,0.41,15,0.027333333,16
2756.255593,54,95,0.92,41,0.022439024,16
2756.255593,53,96,0.97,43,0.02255814,16
2755.915409,53,82,0.82,29,0.028275862,16
2755.865301,41,64,0.08,23,0.003478261,16
2755.751432,31,87,0.16,56,0.002857143,16
2755.720374,38,91,0.11,53,0.002075472,16
2755.687973,63,82,0.39,19,0.020526316,16
2755.585331,38,55,0.58,17,0.034117647,16
2755.403503,61,72,0.35,11,0.031818182,16
2755.274162,33,56,0.82,23,0.035652174,16
2755.161005,29,87,0.2,58,0.003448276,16
2755.035955,62,86,0.53,24,0.022083333,16
2754.974327,59,84,0.69,25,0.0276,16
2754.658421,55,81,0.72,26,0.027692308,16
2754.399364,25,95,0.27,70,0.003857143,16
2753.270424,57,91,0.76,34,0.022352941,16
2753.156157,28,89,0.2,61,0.003278689,16
2753.055719,63,71,0.25,8,0.03125,16
2753.055719,60,74,0.44,14,0.031428571,16
2752.776585,57,86,0.77,29,0.026551724,16
2752.67603,57,78,0.59,21,0.028095238,16
2752.454092,58,89,0.71,31,0.022903226,16
2752.38931,59,83,0.66,24,0.0275,16
2752.317137,38,92,0.09,54,0.001666667,16
2752.271564,27,91,0.24,64,0.00375,16
2751.615733,52,85,0.92,33,0.027878788,16
2751.61553,55,71,0.56,16,0.035,16
2751.40109,57,77,0.57,20,0.0285,16
2751.360475,59,89,0.67,30,0.022333333,16
2750.314024,28,90,0.19,62,0.003064516,16
2749.796588,57,90,0.76,33,0.023030303,16
2749.796588,56,91,0.81,35,0.023142857,16
2749.796588,56,92,0.82,36,0.022777778,16
2749.796588,55,93,0.87,38,0.022894737,16
2749.570095,42,86,0.08,44,0.001818182,16
2749.416855,52,87,0.95,35,0.027142857,16
2748.870627,64,77,0.36,13,0.027692308,16
2748.417742,38,67,0.1,29,0.003448276,16
2747.826574,60,84,0.66,24,0.0275,16
2747.68479,33,99,0.21,66,0.003181818,16
2747.000931,36,99,0.16,63,0.002539683,16
2746.986395,60,76,0.44,16,0.0275,16
2746.956523,35,59,0.81,24,0.03375,16
2746.697358,54,94,0.91,40,0.02275,16
2746.582386,51,87,0.98,36,0.027222222,16
2746.505466,55,83,0.76,28,0.027142857,16
2746.505466,53,86,0.89,33,0.026969697,16
2746.385531,71,74,0.08,3,0.026666667,16
2746.385531,68,77,0.24,9,0.026666667,16
2746.279415,57,68,0.33,11,0.03,16
2745.93322,56,90,0.87,34,0.025588235,16
2745.93322,56,91,0.89,35,0.025428571,16
2745.93322,55,92,0.94,37,0.025405405,16
2745.93322,54,93,0.99,39,0.025384615,16
2745.813019,58,75,0.54,17,0.031764706,16
2745.776547,34,52,0.73,18,0.040555556,16
2745.776547,32,55,0.93,23,0.040434783,16
2745.686949,58,71,0.44,13,0.033846154,16
2745.686949,52,77,0.85,25,0.034,16
2745.460519,38,94,0.08,56,0.001428571,16
2745.457195,37,97,0.1,60,0.001666667,16
2745.077903,56,94,0.82,38,0.021578947,16
2745.068856,61,82,0.57,21,0.027142857,16
2745.046259,34,75,0.12,41,0.002926829,16
2744.938481,27,90,0.25,63,0.003968254,16
2744.922256,28,87,0.18,59,0.003050847,16
2744.828851,54,82,0.78,28,0.027857143,16
2744.295727,62,71,0.29,9,0.032222222,16
2743.796932,32,56,0.95,24,0.039583333,16
2743.734192,24,96,0.26,72,0.003611111,16
2743.429605,36,96,0.18,60,0.003,16
2743.298609,58,77,0.59,19,0.031052632,16
2743.072642,28,89,0.23,61,0.003770492,16
2743.049173,34,73,0.28,39,0.007179487,16
2742.993621,35,96,0.18,61,0.00295082,16
2742.806883,39,63,0.19,24,0.007916667,16
2742.790326,55,80,0.7,25,0.028,16
2742.579435,53,97,0.98,44,0.022272727,16
2742.143483,54,83,0.8,29,0.027586207,16
2742.143483,52,85,0.91,33,0.027575758,16
2742.143483,51,86,0.97,35,0.027714286,16
2742.011339,52,84,0.89,32,0.0278125,16
2741.917843,37,52,0.55,15,0.036666667,16
2741.842486,51,86,0.98,35,0.028,16
2741.835136,52,75,0.8,23,0.034782609,16
2741.835136,51,76,0.87,25,0.0348,16
2741.835136,50,77,0.94,27,0.034814815,16
2741.625191,57,90,0.88,33,0.026666667,16
2741.154298,35,96,0.17,61,0.002786885,16
2740.423431,40,47,0.26,7,0.037142857,16
2740.367163,58,88,0.8,30,0.026666667,16
2740.155735,39,62,0.18,23,0.007826087,16
2740.023473,53,98,0.98,45,0.021777778,16
2739.771762,62,82,0.52,20,0.026,16
2739.771762,59,85,0.68,26,0.026153846,16
2739.769771,57,93,0.77,36,0.021388889,16
2739.3286,36,72,0.11,36,0.003055556,16
2739.324935,37,97,0.07,60,0.001166667,16
2739.203335,37,69,0.15,32,0.0046875,16
2739.137242,67,77,0.21,10,0.021,16
2739.100044,37,57,0.76,20,0.038,16
2739.001444,34,73,0.2,39,0.005128205,16
2738.922035,36,98,0.17,62,0.002741935,16
2738.868966,64,80,0.44,16,0.0275,16
2738.750784,53,83,0.84,30,0.028,16
2738.727641,38,54,0.58,16,0.03625,16
2738.671568,28,88,0.18,60,0.003,16
2738.667979,68,75,0.19,7,0.027142857,16
2738.357336,58,76,0.51,18,0.028333333,16
2737.809479,59,86,0.74,27,0.027407407,16
2737.590371,65,79,0.38,14,0.027142857,16
2737.590371,63,81,0.49,18,0.027222222,16
2737.507423,39,91,0.08,52,0.001538462,16
2737.502909,38,47,0.37,9,0.041111111,16
2736.906403,55,88,0.88,33,0.026666667,16
2736.869728,69,73,0.11,4,0.0275,16
2736.869728,66,77,0.3,11,0.027272727,16
2736.842096,54,92,0.98,38,0.025789474,16
2736.595893,64,70,0.17,6,0.028333333,16
2736.562944,34,54,0.71,20,0.0355,16
2736.485905,64,78,0.38,14,0.027142857,16
2736.34499,63,73,0.28,10,0.028,16
2736.255697,40,67,0.09,27,0.003333333,16
2736.244514,53,84,0.86,31,0.027741935,16
2735.81115,54,89,0.98,35,0.028,16
2735.779213,40,46,0.24,6,0.04,16
2735.721908,37,96,0.08,59,0.001355932,16
2735.71652,36,99,0.13,63,0.002063492,16
2735.590928,34,75,0.13,41,0.003170732,16
2735.560662,36,50,0.57,14,0.040714286,16
2735.531559,54,72,0.63,18,0.035,16
2735.531559,53,73,0.7,20,0.035,16
2735.531559,52,74,0.77,22,0.035,16
2735.433074,60,70,0.34,10,0.034,16
2735.378413,56,92,0.81,36,0.0225,16
2734.706927,41,52,0.37,11,0.033636364,16
2734.427573,60,85,0.67,25,0.0268,16
2734.386014,55,87,0.86,32,0.026875,16
2734.214463,57,85,0.79,28,0.028214286,16
2733.829584,39,89,0.11,50,0.0022,16
2733.808411,56,91,0.93,35,0.026571429,16
2733.750658,26,91,0.29,65,0.004461538,16
2733.567375,39,48,0.33,9,0.036666667,16
2733.265034,31,87,0.17,56,0.003035714,16
2733.225869,63,81,0.47,18,0.026111111,16
2733.225869,59,86,0.7,27,0.025925926,16
2733.225869,58,88,0.77,30,0.025666667,16
2732.943154,32,57,0.93,25,0.0372,16
2732.784581,61,73,0.34,12,0.028333333,16
2732.655747,57,87,0.81,30,0.027,16
2732.443333,36,51,0.59,15,0.039333333,16
2732.308243,33,54,0.84,21,0.04,16
2732.266946,35,98,0.15,63,0.002380952,16
2732.205032,35,73,0.17,38,0.004473684,16
2731.352737,37,70,0.13,33,0.003939394,16
2731.199543,34,59,0.87,25,0.0348,16
2730.896557,55,94,0.87,39,0.022307692,16
2730.682235,34,53,0.75,19,0.039473684,16
2730.647306,60,83,0.61,23,0.026521739,16
2730.627584,42,63,0.07,21,0.003333333,16
2730.575779,35,71,0.18,36,0.005,16
2730.436788,34,98,0.2,64,0.003125,16
2730.228676,40,53,0.5,13,0.038461538,16
2730.19175,61,87,0.58,26,0.022307692,16
2730.143018,41,62,0.15,21,0.007142857,16
2730.082457,37,61,0.84,24,0.035,16
2730.047081,62,72,0.32,10,0.032,16
2729.365133,35,52,0.64,17,0.037647059,16
2729.335081,28,89,0.19,61,0.003114754,16
2729.264608,36,70,0.24,34,0.007058824,16
2729.209294,29,85,0.17,56,0.003035714,16
2729.12459,42,65,0.07,23,0.003043478,16
2728.96735,44,59,0.06,15,0.004,16
2728.919014,27,92,0.25,65,0.003846154,16
2728.642496,36,95,0.15,59,0.002542373,16
2728.536781,44,61,0.06,17,0.003529412,16
2728.422353,62,83,0.56,21,0.026666667,16
2728.207739,38,66,0.21,28,0.0075,16
2728.145368,52,84,0.9,32,0.028125,16
2727.970974,41,88,0.08,47,0.001702128,16
2727.914826,59,73,0.45,14,0.032142857,16
2727.87013,43,64,0.06,21,0.002857143,16
2727.727054,54,90,0.95,36,0.026388889,16
2727.555264,40,61,0.16,21,0.007619048,16
2727.505193,60,83,0.64,23,0.027826087,16
2727.371649,35,70,0.25,35,0.007142857,16
2727.370921,39,67,0.11,28,0.003928571,16
2727.290498,35,99,0.15,64,0.00234375,16
2727.222881,62,79,0.47,17,0.027647059,16
2727.222881,57,85,0.77,28,0.0275,16
2727.035726,59,83,0.67,24,0.027916667,16
2726.872605,61,67,0.2,6,0.033333333,16
2726.561499,64,81,0.46,17,0.027058824,16
2726.54615,38,69,0.1,31,0.003225806,16
2726.387,52,84,0.91,32,0.0284375,16
2726.267315,34,60,0.88,26,0.033846154,16
2726.257191,28,88,0.23,60,0.003833333,16
2726.231226,37,55,0.62,18,0.034444444,16
2726.229485,35,53,0.69,18,0.038333333,16
2726.071271,57,90,0.84,33,0.025454545,16
2725.985149,57,81,0.65,24,0.027083333,16
2725.831255,54,82,0.79,28,0.028214286,16
2725.831255,53,83,0.85,30,0.028333333,16
2725.78481,27,90,0.24,63,0.003809524,16
2725.620331,63,72,0.25,9,0.027777778,16
2725.380675,57,89,0.87,32,0.0271875,16
2725.369462,64,80,0.34,16,0.02125,16
2725.336297,44,49,0.17,5,0.034,16
2725.205535,38,67,0.13,29,0.004482759,16
2725.188661,62,72,0.31,10,0.031,16
2725.169249,34,74,0.19,40,0.00475,16
2725.004455,59,84,0.66,25,0.0264,16
2724.757469,35,58,0.79,23,0.034347826,16
2724.578896,34,74,0.18,40,0.0045,16
2724.536919,36,95,0.1,59,0.001694915,16
2724.452251,68,77,0.19,9,0.021111111,16
2724.452251,64,81,0.36,17,0.021176471,16
2724.414608,61,86,0.57,25,0.0228,16
2724.414608,59,89,0.68,30,0.022666667,16
2724.380339,40,63,0.16,23,0.006956522,16
2724.358242,41,55,0.41,14,0.029285714,16
2723.814761,56,86,0.84,30,0.028,16
2723.814761,54,89,0.97,35,0.027714286,16
2723.671185,37,99,0.13,62,0.002096774,16
2722.859323,65,78,0.28,13,0.021538462,16
2722.688964,41,61,0.15,20,0.0075,16
2722.657036,64,80,0.43,16,0.026875,16
2722.21115,55,82,0.74,27,0.027407407,16
2722.030647,58,68,0.35,10,0.035,16
2722.030647,53,74,0.73,21,0.034761905,16
2721.958,27,92,0.24,65,0.003692308,16
2721.915707,56,79,0.65,23,0.02826087,16
2721.913047,35,97,0.19,62,0.003064516,16
2721.783226,60,87,0.62,27,0.022962963,16
2721.772782,33,55,0.86,22,0.039090909,16
2721.585506,59,86,0.73,27,0.027037037,16
2720.65278,59,78,0.52,19,0.027368421,16
2720.349673,61,80,0.53,19,0.027894737,16
2719.443234,57,91,0.9,34,0.026470588,16
2719.423717,66,79,0.35,13,0.026923077,16
2719.423717,63,82,0.51,19,0.026842105,16
2719.423717,61,85,0.64,24,0.026666667,16
2719.423717,59,87,0.75,28,0.026785714,16
2719.09379,27,91,0.26,64,0.0040625,16
2718.867439,35,73,0.11,38,0.002894737,16
2718.758769,36,49,0.54,13,0.041538462,16
2718.452561,51,85,0.96,34,0.028235294,16
2718.418796,41,63,0.09,22,0.004090909,16
2718.378317,56,87,0.84,31,0.027096774,16
2718.197963,48,53,0.04,5,0.008,16
2718.051586,56,69,0.39,13,0.03,16
2718.00277,31,78,0.17,47,0.003617021,16
2717.950848,55,87,0.9,32,0.028125,16
2717.813286,68,75,0.15,7,0.021428571,16
2717.465984,33,99,0.18,66,0.002727273,16
2717.320953,28,88,0.22,60,0.003666667,16
2716.924281,66,75,0.24,9,0.026666667,16
2716.885902,57,79,0.61,22,0.027727273,16
2716.881473,41,87,0.09,46,0.001956522,16
2716.782287,37,71,0.11,34,0.003235294,16
2716.649757,42,65,0.06,23,0.002608696,16
2716.373461,55,91,0.98,36,0.027222222,16
2716.36743,58,84,0.72,26,0.027692308,16
2716.36743,55,88,0.91,33,0.027575758,16
2716.254311,56,82,0.71,26,0.027307692,16
2716.218088,34,99,0.15,65,0.002307692,16
2715.946592,36,56,0.7,20,0.035,16
2715.906782,32,87,0.14,55,0.002545455,16
2715.776301,38,56,0.67,18,0.037222222,16
2715.447299,54,88,0.96,34,0.028235294,16
2715.256808,28,86,0.24,58,0.004137931,16
2714.892434,66,78,0.32,12,0.026666667,16
2714.847897,60,74,0.4,14,0.028571429,16
2714.735681,57,91,0.78,34,0.022941176,16
2714.653895,37,97,0.09,60,0.0015,16
2714.584322,41,46,0.18,5,0.036,16
2714.414988,56,78,0.63,22,0.028636364,16
2713.97513,60,75,0.42,15,0.028,16
2713.958461,64,76,0.34,12,0.028333333,16
2713.873769,41,51,0.38,10,0.038,16
2713.670221,37,96,0.17,59,0.002881356,16
2713.493635,61,75,0.39,14,0.027857143,16
2713.466191,58,79,0.58,21,0.027619048,16
2712.913262,54,95,0.93,41,0.022682927,16
2712.885728,56,79,0.72,23,0.031304348,16
2712.882873,55,82,0.75,27,0.027777778,16
2712.851715,29,85,0.18,56,0.003214286,16
2712.765695,39,65,0.19,26,0.007307692,16
2712.739689,84,98,0.05,14,0.003571429,16
2712.339655,67,76,0.25,9,0.027777778,16
2712.339655,62,82,0.55,20,0.0275,16
2712.24425,55,80,0.71,25,0.0284,16
2712.220455,24,95,0.26,71,0.003661972,16
2712.15325,51,85,0.97,34,0.028529412,16
2712.09125,58,86,0.77,28,0.0275,16
2712.040514,27,91,0.2,64,0.003125,16
2711.928113,35,73,0.12,38,0.003157895,16
2711.903946,36,59,0.82,23,0.035652174,16
2711.87335,58,70,0.4,12,0.033333333,16
2711.668009,63,83,0.53,20,0.0265,16
2711.538316,57,88,0.84,31,0.027096774,16
2711.287807,66,76,0.27,10,0.027,16
2711.287807,60,83,0.62,23,0.026956522,16
2711.190069,37,56,0.65,19,0.034210526,16
2710.962609,53,94,0.96,41,0.023414634,16
2710.900506,66,78,0.33,12,0.0275,16
2710.603914,31,78,0.18,47,0.003829787,16
2710.572695,34,98,0.16,64,0.0025,16
2710.106939,54,97,0.93,43,0.021627907,16
2710.010168,28,88,0.24,60,0.004,16
2709.827535,33,98,0.21,65,0.003230769,16
2709.638878,36,96,0.19,60,0.003166667,16
2709.404324,36,64,0.97,28,0.034642857,16
2709.38867,34,73,0.27,39,0.006923077,16
2709.376894,60,85,0.65,25,0.026,16
2709.213805,63,82,0.5,19,0.026315789,16
2708.978401,27,89,0.24,62,0.003870968,16
2708.955548,38,65,0.2,27,0.007407407,16
2708.86392,26,89,0.3,63,0.004761905,16
2708.762632,26,94,0.22,68,0.003235294,16
2708.672789,51,75,0.72,24,0.03,16
2708.54996,85,96,0.04,11,0.003636364,16
2708.222654,37,66,0.22,29,0.007586207,16
2708.013824,62,88,0.54,26,0.020769231,16
2707.876076,64,81,0.45,17,0.026470588,16
2707.837428,61,81,0.53,20,0.0265,16
2707.837428,59,83,0.64,24,0.026666667,16
2707.786573,31,89,0.14,58,0.002413793,16
2707.501608,41,51,0.39,10,0.039,16
2707.084962,37,50,0.49,13,0.037692308,16
2706.555073,60,76,0.45,16,0.028125,16
2706.533237,47,60,0.43,13,0.033076923,16
2706.401847,40,54,0.51,14,0.036428571,16
2706.241745,39,58,0.67,19,0.035263158,16
2706.208465,35,98,0.17,63,0.002698413,16
2706.071068,37,95,0.17,58,0.002931034,16
2706.030735,62,85,0.46,23,0.02,16
2706.030735,61,86,0.5,25,0.02,16
2706.030485,28,88,0.21,60,0.0035,16
2705.958025,56,87,0.86,31,0.027741935,16
2705.958025,55,88,0.92,33,0.027878788,16
2705.958025,54,90,0.99,36,0.0275,16
2705.879933,31,58,0.99,27,0.036666667,16
2705.717263,56,80,0.68,24,0.028333333,16
2705.670742,64,82,0.46,18,0.025555556,16
2705.573486,59,73,0.47,14,0.033571429,16
2705.572524,34,54,0.75,20,0.0375,16
2705.51619,33,74,0.17,41,0.004146341,16
2705.342865,61,80,0.51,19,0.026842105,16
2705.342865,59,82,0.62,23,0.026956522,16
2705.342865,57,84,0.73,27,0.027037037,16
2705.308358,31,88,0.17,57,0.002982456,16
2705.118392,36,92,0.17,56,0.003035714,16
2704.72349,57,88,0.85,31,0.027419355,16
2704.475151,34,72,0.28,38,0.007368421,16
2704.12043,34,55,0.77,21,0.036666667,16
2704.071002,31,89,0.18,58,0.003103448,16
2704.006929,40,64,0.12,24,0.005,16
2703.995752,38,95,0.05,57,0.000877193,16
2703.961808,69,79,0.2,10,0.02,16
2703.795578,35,97,0.15,62,0.002419355,16
2703.793505,56,90,0.93,34,0.027352941,16
2703.540724,58,90,0.84,32,0.02625,16
2703.534293,37,67,0.12,30,0.004,16
2703.416619,38,92,0.08,54,0.001481481,16
2703.409843,38,93,0.08,55,0.001454545,16
2703.303448,28,89,0.24,61,0.003934426,16
2703.27423,33,96,0.51,63,0.008095238,16
2703.261043,58,87,0.8,29,0.027586207,16
2703.242374,54,83,0.81,29,0.027931034,16
2703.242374,53,84,0.87,31,0.028064516,16
2702.968056,42,51,0.33,9,0.036666667,16
2702.375798,32,98,0.52,66,0.007878788,16
2702.29826,54,94,0.92,40,0.023,16
2702.29826,53,96,0.98,43,0.022790698,16
2702.287104,64,78,0.39,14,0.027857143,16
2702.26827,64,79,0.41,15,0.027333333,16
2702.227347,61,83,0.61,22,0.027727273,16
2701.94594,35,74,0.1,39,0.002564103,16
2701.70098,56,77,0.68,21,0.032380952,16
2701.653034,52,79,0.92,27,0.034074074,16
2701.560961,35,58,0.83,23,0.036086957,16
2701.539769,43,59,0.12,16,0.0075,16
2701.429993,40,52,0.46,12,0.038333333,16
2701.262895,48,55,0.03,7,0.004285714,16
2701.010477,91,94,0.01,3,0.003333333,16
2700.617803,29,86,0.17,57,0.002982456,16
2700.390405,34,99,0.16,65,0.002461538,16
2700.366569,23,98,0.27,75,0.0036,16
2700.106749,52,83,0.89,31,0.028709677,16
2700.106749,51,84,0.95,33,0.028787879,16
2699.903124,44,65,0.68,21,0.032380952,16
2699.571258,27,88,0.2,61,0.003278689,16
2699.317031,57,87,0.67,30,0.022333333,16
2698.766823,40,64,0.09,24,0.00375,16
2698.186776,64,75,0.31,11,0.028181818,16
2698.129193,35,72,0.26,37,0.007027027,16
2698.128836,52,63,0.27,11,0.024545455,16
2698.076037,59,87,0.74,28,0.026428571,16
2697.882203,35,53,0.65,18,0.036111111,16
2697.81967,39,67,0.1,28,0.003571429,16
2697.728324,37,50,0.5,13,0.038461538,16
2697.652421,55,79,0.76,24,0.031666667,16
2697.581788,61,84,0.61,23,0.026521739,16
2697.080887,55,81,0.73,26,0.028076923,16
2697.078784,64,82,0.37,18,0.020555556,16
2697.053439,57,87,0.8,30,0.026666667,16
2696.927742,39,52,0.46,13,0.035384615,16
2696.857684,36,98,0.11,62,0.001774194,16
2696.613524,35,99,0.14,64,0.0021875,16
2696.447682,36,69,0.17,33,0.005151515,16
2696.408262,64,79,0.42,15,0.028,16
2696.388516,39,65,0.18,26,0.006923077,16
2696.372969,52,80,0.94,28,0.033571429,16
2696.282955,34,73,0.19,39,0.004871795,16
2696.258929,56,81,0.69,25,0.0276,16
2696.222471,70,78,0.16,8,0.02,16
2696.10351,31,99,0.57,68,0.008382353,16
2695.809354,58,89,0.82,31,0.026451613,16
2695.792623,59,85,0.57,26,0.021923077,16
2695.788915,36,71,0.11,35,0.003142857,16
2695.774363,57,76,0.62,19,0.032631579,16
2695.72237,59,91,0.67,32,0.0209375,16
2695.528782,43,63,0.07,20,0.0035,16
2695.511046,54,96,0.94,42,0.022380952,16
2695.511046,53,97,0.99,44,0.0225,16
2695.391124,56,77,0.67,21,0.031904762,16
2695.389723,86,98,0.04,12,0.003333333,16
2695.384539,63,82,0.49,19,0.025789474,16
2695.264806,36,95,0.19,59,0.003220339,16
2695.100358,35,55,0.69,20,0.0345,16
2695.031112,58,73,0.51,15,0.034,16
2695.031112,57,74,0.58,17,0.034117647,16
2694.871708,54,81,0.77,27,0.028518519,16
2694.871708,53,82,0.83,29,0.02862069,16
2694.837207,90,93,0.01,3,0.003333333,16
2694.486764,59,77,0.51,18,0.028333333,16
2694.42607,53,78,0.85,25,0.034,16
2694.270504,38,65,0.11,27,0.004074074,16
2694.143421,55,91,0.93,36,0.025833333,16
2694.111483,29,87,0.21,58,0.00362069,16
2693.963429,54,78,0.79,24,0.032916667,16
2693.90479,65,80,0.4,15,0.026666667,16
2693.858033,35,98,0.13,63,0.002063492,16
2693.603194,61,85,0.51,24,0.02125,16
2693.5527,63,79,0.43,16,0.026875,16
2693.549282,27,89,0.28,62,0.004516129,16
2693.49678,61,83,0.48,22,0.021818182,16
2693.457398,55,91,0.99,36,0.0275,16
2693.418589,55,79,0.77,24,0.032083333,16
2693.418589,53,81,0.9,28,0.032142857,16
2693.364906,56,89,0.86,33,0.026060606,16
2693.324322,63,71,0.23,8,0.02875,16
2693.288323,56,86,0.83,30,0.027666667,16
2693.222899,58,92,0.72,34,0.021176471,16
2693.175056,65,80,0.32,15,0.021333333,16
2693.133418,40,65,0.08,25,0.0032,16
2692.739086,54,89,0.96,35,0.027428571,16
2692.570809,28,85,0.18,57,0.003157895,16
2692.441097,33,97,0.2,64,0.003125,16
2692.335591,58,76,0.52,18,0.028888889,16
2692.326636,33,56,0.85,23,0.036956522,16
2692.3111,63,84,0.48,21,0.022857143,16
2692.269267,34,75,0.14,41,0.003414634,16
2691.915991,51,64,0.32,13,0.024615385,16
2691.851504,59,76,0.48,17,0.028235294,16
2691.803734,38,55,0.61,17,0.035882353,16
2691.729703,67,78,0.23,11,0.020909091,16
2691.643153,39,50,0.4,11,0.036363636,16
2691.589643,51,86,0.99,35,0.028285714,16
2691.337488,61,74,0.37,13,0.028461538,16
2691.318224,29,81,0.18,52,0.003461538,16
2691.167978,32,58,0.97,26,0.037307692,16
2691.126659,56,95,0.82,39,0.021025641,16
2690.926819,37,63,0.9,26,0.034615385,16
2690.837919,58,85,0.76,27,0.028148148,16
2690.776287,34,99,0.17,65,0.002615385,16
2690.702731,37,96,0.09,59,0.001525424,16
2690.672345,49,57,0.21,8,0.02625,16
2690.661999,53,96,0.99,43,0.023023256,16
2690.639486,52,85,0.93,33,0.028181818,16
2690.621378,38,49,0.41,11,0.037272727,16
2690.607155,60,79,0.54,19,0.028421053,16
2690.430442,87,96,0.03,9,0.003333333,16
2690.42624,34,99,0.19,65,0.002923077,16
2690.246162,27,91,0.19,64,0.00296875,16
2690.120523,61,82,0.58,21,0.027619048,16
2690.052973,36,59,0.85,23,0.036956522,16
2689.865717,58,78,0.56,20,0.028,16
2689.838722,54,95,0.94,41,0.022926829,16
2689.709628,58,90,0.73,32,0.0228125,16
2689.69461,61,81,0.45,20,0.0225,16
2689.590658,63,80,0.47,17,0.027647059,16
2689.571909,61,83,0.6,22,0.027272727,16
2689.37897,61,82,0.56,21,0.026666667,16
2689.37897,58,86,0.74,28,0.026428571,16
2689.187152,31,87,0.15,56,0.002678571,16
2689.167584,62,81,0.51,19,0.026842105,16
2689.166598,56,78,0.7,22,0.031818182,16
2689.166598,54,80,0.83,26,0.031923077,16
2689.166598,52,82,0.96,30,0.032,16
2689.031811,38,62,0.83,24,0.034583333,16
2689.001646,68,80,0.24,12,0.02,16
2688.835368,40,66,0.09,26,0.003461538,16
2688.512369,30,84,0.16,54,0.002962963,16
2688.297124,35,59,0.82,24,0.034166667,16
2687.93888,58,84,0.71,26,0.027307692,16
2687.888541,35,54,0.68,19,0.035789474,16
2687.791854,34,93,0.46,59,0.00779661,16
2687.785953,36,52,0.57,16,0.035625,16
2687.723184,53,93,0.96,40,0.024,16
2687.714649,67,77,0.26,10,0.026,16
2687.704796,45,62,0.56,17,0.032941176,16
2687.625819,61,89,0.58,28,0.020714286,16
2687.625819,59,92,0.68,33,0.020606061,16
2687.591549,53,80,0.88,27,0.032592593,16
2687.494546,58,77,0.54,19,0.028421053,16
2687.211626,39,68,0.1,29,0.003448276,16
2687.12853,38,54,0.54,16,0.03375,16
2686.911816,56,88,0.89,32,0.0278125,16
2686.814194,54,77,0.78,23,0.033913043,16
2686.711176,25,95,0.25,70,0.003571429,16
2686.558576,63,69,0.2,6,0.033333333,16
2686.548795,28,86,0.27,58,0.004655172,16
2686.462633,62,81,0.52,19,0.027368421,16
2686.462633,62,82,0.54,20,0.027,16
2686.462633,60,84,0.65,24,0.027083333,16
2686.462633,58,87,0.78,29,0.026896552,16
2686.340673,68,76,0.22,8,0.0275,16
2685.949711,60,81,0.59,21,0.028095238,16
2685.949711,57,85,0.78,28,0.027857143,16
2685.589978,27,88,0.23,61,0.003770492,16
2685.306656,33,56,0.8,23,0.034782609,16
2685.146296,30,84,0.18,54,0.003333333,16
2685.095644,36,94,0.17,58,0.002931034,16
2684.786035,56,87,0.87,31,0.028064516,16
2684.773874,33,99,0.17,66,0.002575758,16
2684.73462,52,86,0.95,34,0.027941176,16
2684.676815,33,96,0.52,63,0.008253968,16
2684.527152,27,90,0.27,63,0.004285714,16
2684.291031,34,58,0.84,24,0.035,16
2684.108672,64,70,0.19,6,0.031666667,16
2684.096408,55,83,0.77,28,0.0275,16
2684.068238,40,55,0.44,15,0.029333333,16
2683.522217,38,92,0.1,54,0.001851852,16
2683.318918,28,88,0.26,60,0.004333333,16
2683.21698,34,54,0.78,20,0.039,16
2683.007388,65,70,0.14,5,0.028,16
2682.830265,59,75,0.46,16,0.02875,16
2682.710936,37,71,0.12,34,0.003529412,16
2682.658715,46,62,0.41,16,0.025625,16
2682.606177,24,97,0.26,73,0.003561644,16
2682.517486,26,94,0.24,68,0.003529412,16
2682.28269,59,82,0.64,23,0.027826087,16
2682.191292,56,88,0.88,32,0.0275,16
2682.175505,37,69,0.16,32,0.005,16
2682.164497,62,84,0.46,22,0.020909091,16
2682.14338,57,78,0.6,21,0.028571429,16
2682.14338,56,79,0.66,23,0.028695652,16
2682.099627,60,83,0.51,23,0.022173913,16
2681.892992,62,73,0.31,11,0.028181818,16
2681.77629,37,91,0.16,54,0.002962963,16
2681.636803,63,84,0.55,21,0.026190476,16
2681.636803,61,86,0.66,25,0.0264,16
2681.628953,39,90,0.1,51,0.001960784,16
2681.592286,38,92,0.15,54,0.002777778,16
2681.570875,35,97,0.16,62,0.002580645,16
2681.531725,58,85,0.73,27,0.027037037,16
2681.50225,63,68,0.17,5,0.034,16
2681.41135,37,93,0.1,56,0.001785714,16
2681.378065,65,77,0.27,12,0.0225,16
2681.378065,63,79,0.36,16,0.0225,16
2681.30992,27,89,0.21,62,0.003387097,16
2681.241444,35,97,0.2,62,0.003225806,16
2681.208795,34,97,0.21,63,0.003333333,16
2681.148059,42,65,0.76,23,0.033043478,16
2680.956768,44,64,0.66,20,0.033,16
2680.956768,42,67,0.82,25,0.0328,16
2680.956768,41,68,0.89,27,0.032962963,16
2680.940484,56,93,0.84,37,0.022702703,16
2680.908881,33,77,0.22,44,0.005,16
2680.794976,37,68,0.21,31,0.006774194,16
2680.758685,27,91,0.25,64,0.00390625,16
2680.525895,55,96,0.87,41,0.021219512,16
2680.372806,67,74,0.19,7,0.027142857,16
2680.329819,39,68,0.09,29,0.003103448,16
2680.127011,67,81,0.28,14,0.02,16
2680.127011,66,82,0.32,16,0.02,16
2680.127011,65,83,0.36,18,0.02,16
2679.852821,26,94,0.25,68,0.003676471,16
2679.636454,59,82,0.65,23,0.02826087,16
2679.602639,43,63,0.06,20,0.003,16
2679.587096,52,80,0.93,28,0.033214286,16
2679.45141,31,88,0.15,57,0.002631579,16
2679.145099,44,49,0.18,5,0.036,16
2679.05429,39,64,0.11,25,0.0044,16
2678.959596,56,94,0.83,38,0.021842105,16
2678.852778,59,84,0.67,25,0.0268,16
2678.697209,60,87,0.54,27,0.02,16
2678.661009,47,69,0.8,22,0.036363636,16
2678.636413,38,54,0.55,16,0.034375,16
2678.615923,45,61,0.47,16,0.029375,16
2678.601947,62,73,0.34,11,0.030909091,16
2678.254334,39,68,0.11,29,0.003793103,16
2678.175828,47,56,0.04,9,0.004444444,16
2678.174156,58,73,0.5,15,0.033333333,16
2678.174156,53,79,0.86,26,0.033076923,16
2678.146325,62,84,0.58,22,0.026363636,16
2678.011188,64,79,0.33,15,0.022,16
2678.011188,62,81,0.42,19,0.022105263,16
2677.971644,65,76,0.3,11,0.027272727,16
2677.971644,63,78,0.41,15,0.027333333,16
2677.863541,55,77,0.74,22,0.033636364,16
2677.79533,26,91,0.3,65,0.004615385,16
2677.653286,32,77,0.15,45,0.003333333,16
2677.551298,53,85,0.89,32,0.0278125,16
2677.436254,26,89,0.29,63,0.004603175,16
2677.409526,36,54,0.62,18,0.034444444,16
2677.409499,39,54,0.54,15,0.036,16
2677.379279,36,99,0.12,63,0.001904762,16
2677.064489,56,89,0.91,33,0.027575758,16
2676.881528,87,95,0.03,8,0.00375,16
2676.742322,57,80,0.63,23,0.027391304,16
2676.738405,27,90,0.23,63,0.003650794,16
2676.732008,65,75,0.28,10,0.028,16
2676.562956,64,77,0.35,13,0.026923077,16
2676.562956,62,79,0.46,17,0.027058824,16
2676.5495,59,88,0.67,29,0.023103448,16
2676.5495,58,89,0.72,31,0.023225806,16
2676.386413,60,86,0.69,26,0.026538462,16
2676.264339,56,80,0.67,24,0.027916667,16
2676.234846,42,58,0.13,16,0.008125,16
2676.225457,47,60,0.34,13,0.026153846,16
2676.078175,36,55,0.67,19,0.035263158,16
2675.984357,57,90,0.77,33,0.023333333,16
2675.861944,37,96,0.1,59,0.001694915,16
2675.860684,54,74,0.67,20,0.0335,16
2675.754715,70,75,0.13,5,0.026,16
2675.687017,53,88,0.99,35,0.028285714,16
2675.564676,55,88,0.9,33,0.027272727,16
2675.42309,37,68,0.15,31,0.00483871,16
2675.387988,55,92,0.87,37,0.023513514,16
2675.387988,54,94,0.93,40,0.02325,16
2675.351854,59,77,0.5,18,0.027777778,16
2675.343605,88,97,0.03,9,0.003333333,16
2675.277861,32,87,0.13,55,0.002363636,16
2675.125104,40,68,0.08,28,0.002857143,16
2675.120291,54,79,0.81,25,0.0324,16
2675.078861,54,90,0.98,36,0.027222222,16
2675.045217,64,79,0.4,15,0.026666667,16
2675.045217,59,85,0.69,26,0.026538462,16
2674.903314,62,83,0.57,21,0.027142857,16
2674.903314,60,86,0.7,26,0.026923077,16
2674.850561,25,94,0.23,69,0.003333333,16
2674.844947,37,95,0.07,58,0.001206897,16
2674.836526,35,60,0.89,25,0.0356,16
2674.827829,36,69,0.13,33,0.003939394,16
2674.801495,56,81,0.7,25,0.028,16
2674.801495,55,82,0.76,27,0.028148148,16
2674.551823,61,81,0.54,20,0.027,16
2674.378147,36,96,0.09,60,0.0015,16
2674.346114,36,97,0.15,61,0.002459016,16
2674.319675,60,72,0.39,12,0.0325,16
2674.318776,53,88,0.96,35,0.027428571,16
2674.285374,59,74,0.48,15,0.032,16
2674.285374,57,76,0.61,19,0.032105263,16
2674.285374,55,78,0.74,23,0.032173913,16
2674.158779,26,93,0.26,67,0.003880597,16
2674.103177,60,81,0.58,21,0.027619048,16
2674.096178,57,85,0.75,28,0.026785714,16
2674.084707,39,63,0.18,24,0.0075,16
2674.03454,41,67,0.85,26,0.032692308,16
2674.026328,33,99,0.23,66,0.003484848,16
2673.974912,33,97,0.23,64,0.00359375,16
2673.863543,27,90,0.22,63,0.003492063,16
2673.837883,59,85,0.71,26,0.027307692,16
2673.796802,35,54,0.67,19,0.035263158,16
2673.635227,59,72,0.44,13,0.033846154,16
2673.628256,61,85,0.63,24,0.02625,16
2673.628256,58,89,0.81,31,0.026129032,16
2673.572292,57,80,0.64,23,0.027826087,16
2673.545515,40,52,0.41,12,0.034166667,16
2673.545515,39,53,0.48,14,0.034285714,16
2673.475433,31,99,0.59,68,0.008676471,16
2673.37563,62,83,0.43,21,0.02047619,16
2673.346915,69,73,0.09,4,0.0225,16
2673.346915,67,75,0.18,8,0.0225,16
2673.191298,59,87,0.6,28,0.021428571,16
2673.101959,59,87,0.76,28,0.027142857,16
2673.067238,56,77,0.69,21,0.032857143,16
2673.056108,50,56,0.02,6,0.003333333,16
2672.830169,47,59,0.04,12,0.003333333,16
2672.785874,35,57,0.78,22,0.035454545,16
2672.782731,36,57,0.72,21,0.034285714,16
2672.701432,62,70,0.26,8,0.0325,16
2672.507627,62,78,0.45,16,0.028125,16
2672.417052,57,74,0.57,17,0.033529412,16
2672.183671,63,77,0.39,14,0.027857143,16
2672.183671,60,80,0.56,20,0.028,16
2672.183671,57,84,0.75,27,0.027777778,16
2672.125682,89,95,0.02,6,0.003333333,16
2672.019103,47,57,0.04,10,0.004,16
2671.947707,36,67,0.23,31,0.007419355,16
2671.837702,67,78,0.29,11,0.026363636,16
2671.837702,64,82,0.47,18,0.026111111,16
2671.776336,30,84,0.17,54,0.003148148,16
2671.7671,34,99,0.14,65,0.002153846,16
2671.683329,51,56,0.13,5,0.026,16
2671.674403,57,79,0.62,22,0.028181818,16
2671.058177,32,84,0.16,52,0.003076923,16
2671.052607,27,89,0.2,62,0.003225806,16
2670.452891,46,59,0.05,13,0.003846154,16
2670.427537,59,81,0.62,22,0.028181818,16
2670.376285,24,97,0.25,73,0.003424658,16
2670.217641,44,68,0.67,24,0.027916667,16
2670.149493,56,85,0.82,29,0.028275862,16
2670.149493,55,86,0.88,31,0.028387097,16
2669.992892,38,66,0.2,28,0.007142857,16
2669.992014,36,70,0.12,34,0.003529412,16
2669.927971,36,65,0.99,29,0.034137931,16
2669.819188,35,67,0.25,32,0.0078125,16
2669.699581,54,84,0.83,30,0.027666667,16
2669.569356,36,57,0.8,21,0.038095238,16
2669.396451,58,86,0.62,28,0.022142857,16
2669.327073,34,56,0.76,22,0.034545455,16
2669.026313,37,66,0.21,29,0.007241379,16
2668.989389,41,66,0.07,25,0.0028,16
2668.885406,65,81,0.41,16,0.025625,16
2668.821443,67,79,0.32,12,0.026666667,16
2668.818883,39,48,0.34,9,0.037777778,16
2668.483551,35,99,0.2,64,0.003125,16
2668.381371,37,55,0.65,18,0.036111111,16
2668.33242,60,82,0.61,22,0.027727273,16
2668.33242,57,86,0.8,29,0.027586207,16
2668.07497,56,91,0.82,35,0.023428571,16
2667.895983,56,91,0.94,35,0.026857143,16
2667.821723,56,92,0.83,36,0.023055556,16
2667.821723,55,94,0.89,39,0.022820513,16
2667.78809,58,85,0.74,27,0.027407407,16
2667.78809,56,88,0.87,32,0.0271875,16
2667.78809,55,89,0.93,34,0.027352941,16
2667.755951,25,91,0.32,66,0.004848485,16
2667.548161,45,63,0.59,18,0.032777778,16
2667.514728,37,51,0.51,14,0.036428571,16
2667.358673,40,90,0.08,50,0.0016,16
2667.258357,55,93,0.88,38,0.023157895,16
2666.926857,34,56,0.81,22,0.036818182,16
2666.885026,41,54,0.38,13,0.029230769,16
2666.750258,63,76,0.37,13,0.028461538,16
2666.687143,54,87,0.9,33,0.027272727,16
2666.658312,37,57,0.68,20,0.034,16
2666.590576,29,87,0.17,58,0.002931034,16
2666.578997,45,72,0.97,27,0.035925926,16
2666.297,58,89,0.66,31,0.021290323,16
2666.274334,39,47,0.32,8,0.04,16
2666.224831,66,73,0.2,7,0.028571429,16
2666.201916,34,71,0.28,37,0.007567568,16
2666.071722,61,85,0.56,24,0.023333333,16
2666.066423,46,63,0.55,17,0.032352941,16
2666.012812,59,76,0.53,17,0.031176471,16
2665.770747,35,95,0.17,60,0.002833333,16
2665.725187,41,66,0.09,25,0.0036,16
2665.558365,41,48,0.25,7,0.035714286,16
2665.512626,58,87,0.75,29,0.025862069,16
2665.512626,57,89,0.82,32,0.025625,16
2665.44367,56,76,0.67,20,0.0335,16
2665.41327,38,88,0.11,50,0.0022,16
2665.397516,65,79,0.3,14,0.021428571,16
2665.381131,37,94,0.14,57,0.00245614,16
2665.025659,23,98,0.28,75,0.003733333,16
2665.012217,35,72,0.19,37,0.005135135,16
2664.825948,56,92,0.91,36,0.025277778,16
2664.674487,59,80,0.6,21,0.028571429,16
2664.665595,40,67,0.9,27,0.033333333,16
2664.606634,57,86,0.79,29,0.027241379,16
2664.576643,51,78,0.91,27,0.033703704,16
2664.24877,64,81,0.44,17,0.025882353,16
2664.24877,59,87,0.72,28,0.025714286,16
2664.236993,59,73,0.46,14,0.032857143,16
2664.2031,38,66,0.11,28,0.003928571,16
2664.188963,33,97,0.22,64,0.0034375,16
2664.142403,63,83,0.42,20,0.021,16
2664.103627,40,90,0.07,50,0.0014,16
2663.800146,53,98,0.99,45,0.022,16
2663.789856,41,66,0.83,25,0.0332,16
2663.71878,60,86,0.55,26,0.021153846,16
2663.716668,59,85,0.72,26,0.027692308,16
2663.548985,35,99,0.11,64,0.00171875,16
2663.45163,35,61,0.96,26,0.036923077,16
2663.443936,57,87,0.79,30,0.026333333,16
2663.427367,38,50,0.43,12,0.035833333,16
2663.352479,25,95,0.26,70,0.003714286,16
2662.821781,35,71,0.19,36,0.005277778,16
2662.62444,36,58,0.75,22,0.034090909,16
2662.441276,39,56,0.5,17,0.029411765,16
2662.335252,32,97,0.55,65,0.008461538,16
2662.003811,53,95,0.96,42,0.022857143,16
2661.985242,37,97,0.06,60,0.001,16
2661.974702,42,60,0.14,18,0.007777778,16
2661.675539,63,81,0.48,18,0.026666667,16
2661.605795,57,88,0.86,31,0.027741935,16
2661.590635,53,95,0.97,42,0.023095238,16
2661.531292,37,97,0.12,60,0.002,16
2661.514434,26,90,0.28,64,0.004375,16
2661.435197,51,66,0.42,15,0.028,16
2661.428169,35,53,0.67,18,0.037222222,16
2661.371056,34,73,0.15,39,0.003846154,16
2661.272474,37,64,0.92,27,0.034074074,16
2661.203001,38,66,0.15,28,0.005357143,16
2661.148448,63,83,0.52,20,0.026,16
2660.98532,58,76,0.57,18,0.031666667,16
2660.977277,25,94,0.24,69,0.003478261,16
2660.961731,46,60,0.05,14,0.003571429,16
2660.958107,56,90,0.81,34,0.023823529,16
2660.920101,33,96,0.5,63,0.007936508,16
2660.904636,27,87,0.25,60,0.004166667,16
2660.788493,53,92,0.96,39,0.024615385,16
2660.690246,39,67,0.09,28,0.003214286,16
2660.516166,38,61,0.8,23,0.034782609,16
2660.355758,39,64,0.18,25,0.0072,16
2660.348137,55,77,0.72,22,0.032727273,16
2660.333862,34,54,0.77,20,0.0385,16
2660.261195,36,96,0.15,60,0.0025,16
2660.231278,26,94,0.26,68,0.003823529,16
2660.099617,26,92,0.26,66,0.003939394,16
2660.058538,61,72,0.36,11,0.032727273,16
2659.776044,27,89,0.22,62,0.003548387,16
2659.764207,62,69,0.24,7,0.034285714,16
2659.75726,55,90,0.95,35,0.027142857,16
2659.56386,46,60,0.37,14,0.026428571,16
2659.554142,35,99,0.12,64,0.001875,16
2659.454524,36,51,0.57,15,0.038,16
2659.442144,38,57,0.68,19,0.035789474,16
2659.393353,39,67,0.08,28,0.002857143,16
2659.312567,57,90,0.87,33,0.026363636,16
2659.31162,32,97,0.53,65,0.008153846,16
2659.202511,38,56,0.6,18,0.033333333,16
2659.034178,27,88,0.26,61,0.004262295,16
2658.967153,47,66,0.61,19,0.032105263,16
2658.711591,41,67,0.07,26,0.002692308,16
2658.224919,57,71,0.47,14,0.033571429,16
2658.224919,56,72,0.54,16,0.03375,16
2658.145917,53,75,0.74,22,0.033636364,16
2658.013055,55,89,0.92,34,0.027058824,16
2657.986665,60,72,0.4,12,0.033333333,16
2657.977995,31,99,0.58,68,0.008529412,16
2657.977554,62,81,0.53,19,0.027894737,16
2657.343375,56,87,0.85,31,0.027419355,16
2657.131533,32,78,0.27,46,0.005869565,16
2657.114641,57,85,0.64,28,0.022857143,16
2657.035906,26,94,0.23,68,0.003382353,16
2656.908736,44,60,0.07,16,0.004375,16
2656.853198,66,76,0.22,10,0.022,16
2656.853198,66,77,0.24,11,0.021818182,16
2656.707267,38,95,0.08,57,0.001403509,16
2656.643318,44,62,0.06,18,0.003333333,16
2656.492911,58,74,0.53,16,0.033125,16
2656.418857,41,51,0.34,10,0.034,16
2656.356868,61,89,0.59,28,0.021071429,16
2656.271799,32,97,0.54,65,0.008307692,16
2656.240803,40,68,0.92,28,0.032857143,16
2656.233024,36,69,0.24,33,0.007272727,16
2656.181743,25,95,0.24,70,0.003428571,16
2655.914764,26,93,0.23,67,0.003432836,16
2655.609045,29,84,0.22,55,0.004,16
2655.435188,57,75,0.6,18,0.033333333,16
2655.31599,39,65,0.13,26,0.005,16
2655.155581,43,62,0.07,19,0.003684211,16
2655.153739,29,83,0.19,54,0.003518519,16
2655.125161,34,72,0.27,38,0.007105263,16
2654.889656,38,54,0.61,16,0.038125,16
2654.823107,27,88,0.19,61,0.003114754,16
2654.585404,26,90,0.27,64,0.00421875,16
2654.259036,54,82,0.8,28,0.028571429,16
2653.886053,38,60,0.77,22,0.035,16
2653.884961,29,86,0.18,57,0.003157895,16
2653.838759,59,84,0.56,25,0.0224,16
2653.758104,63,84,0.42,21,0.02,16
2653.719614,25,93,0.3,68,0.004411765,16
2653.680332,45,58,0.06,13,0.004615385,16
2653.607918,54,86,0.9,32,0.028125,16
2653.246072,39,64,0.09,25,0.0036,16
2653.065726,36,59,0.86,23,0.037391304,16
2653.049853,63,81,0.5,18,0.027777778,16
2652.952433,59,88,0.77,29,0.026551724,16
2652.755061,33,95,0.53,62,0.008548387,16
2652.617122,31,57,0.98,26,0.037692308,16
2652.097291,57,86,0.65,29,0.022413793,16
2652.073171,38,94,0.06,56,0.001071429,16
2652.032833,27,88,0.22,61,0.003606557,16
2652.025796,36,99,0.08,63,0.001269841,16
2651.946211,62,82,0.43,20,0.0215,16
2651.852434,52,90,0.93,38,0.024473684,16
2651.821187,37,64,0.93,27,0.034444444,16
2651.793892,25,93,0.27,68,0.003970588,16
2651.78735,25,94,0.25,69,0.003623188,16
2651.547138,58,86,0.75,28,0.026785714,16
2651.532292,55,81,0.74,26,0.028461538,16
2651.500027,39,89,0.1,50,0.002,16
2651.317216,69,77,0.21,8,0.02625,16
2651.234158,54,79,0.8,25,0.032,16
2651.18987,43,67,0.77,24,0.032083333,16
2651.155095,55,80,0.72,25,0.0288,16
2651.021223,41,60,0.15,19,0.007894737,16
2651.006653,63,86,0.49,23,0.021304348,16
2650.881724,43,50,0.27,7,0.038571429,16
2650.824884,52,77,0.84,25,0.0336,16
2650.768371,25,94,0.26,69,0.003768116,16
2650.680394,59,89,0.78,30,0.026,16
2650.579716,59,93,0.7,34,0.020588235,16
2650.484492,40,70,0.1,30,0.003333333,16
2650.426277,56,88,0.86,32,0.026875,16
2650.426277,54,91,0.99,37,0.026756757,16
2650.345323,34,99,0.21,65,0.003230769,16
2650.28357,64,67,0.1,3,0.033333333,16
2650.28357,61,70,0.3,9,0.033333333,16
2650.206424,29,86,0.16,57,0.002807018,16
2650.134135,33,62,0.97,29,0.033448276,16
2650.119376,33,57,0.84,24,0.035,16
2650.105141,28,86,0.19,58,0.003275862,16
2650.101796,26,92,0.29,66,0.004393939,16
2650.061929,26,90,0.3,64,0.0046875,16
2650.051321,47,60,0.04,13,0.003076923,16
2649.907928,50,79,0.98,29,0.033793103,16
2649.888079,57,96,0.81,39,0.020769231,16
2649.888079,55,98,0.9,43,0.020930233,16
2649.789135,33,99,0.19,66,0.002878788,16
2649.610601,61,71,0.33,10,0.033,16
2649.303079,42,60,0.09,18,0.005,16
2649.291654,32,57,0.92,25,0.0368,16
2649.137516,62,84,0.52,22,0.023636364,16
2649.137516,61,85,0.57,24,0.02375,16
2649.1128,36,79,0.12,43,0.002790698,16
2649.092227,65,80,0.36,15,0.024,16
2649.091833,26,92,0.27,66,0.004090909,16
2649.091692,56,98,0.87,42,0.020714286,16
2649.086695,61,82,0.59,21,0.028095238,16
2649.086695,59,84,0.7,25,0.028,16
2648.827292,27,91,0.21,64,0.00328125,16
2648.791491,39,72,0.1,33,0.003030303,16
2648.748455,33,85,0.14,52,0.002692308,16
2648.731816,64,81,0.41,17,0.024117647,16
2648.515478,57,96,0.8,39,0.020512821,16
2648.141437,66,79,0.31,13,0.023846154,16
2648.097075,36,94,0.16,58,0.002758621,16
2648.039285,36,52,0.58,16,0.03625,16
2648.032537,55,96,0.88,41,0.021463415,16
2648.02078,40,61,0.17,21,0.008095238,16
2647.998762,58,74,0.52,16,0.0325,16
2647.998762,56,76,0.65,20,0.0325,16
2647.998762,53,80,0.87,27,0.032222222,16
2647.998762,52,81,0.94,29,0.032413793,16
2647.997566,39,65,0.14,26,0.005384615,16
2647.97266,26,95,0.23,69,0.003333333,16
2647.95457,33,59,0.94,26,0.036153846,16
2647.874829,34,98,0.19,64,0.00296875,16
2647.706255,40,53,0.48,13,0.036923077,16
2647.583508,70,74,0.11,4,0.0275,16
2647.248075,38,53,0.58,15,0.038666667,16
2647.127513,61,84,0.5,23,0.02173913,16
2647.078446,46,61,0.39,15,0.026,16
2646.938993,63,83,0.47,20,0.0235,16
2646.85958,37,62,0.86,25,0.0344,16
2646.758364,57,77,0.58,20,0.029,16
2646.728202,37,53,0.54,16,0.03375,16
2646.558089,63,82,0.52,19,0.027368421,16
2646.558089,61,84,0.63,23,0.027391304,16
2646.53963,61,85,0.65,24,0.027083333,16
2646.482226,58,93,0.74,35,0.021142857,16
2646.482226,56,95,0.83,39,0.021282051,16
2646.429828,57,75,0.59,18,0.032777778,16
2646.366341,57,93,0.76,36,0.021111111,16
2646.305522,66,83,0.36,17,0.021176471,16
2646.157513,33,73,0.3,40,0.0075,16
2646.153981,49,64,0.48,15,0.032,16
2646.123966,39,55,0.53,16,0.033125,16
2646.042475,43,64,0.05,21,0.002380952,16
2645.934801,66,79,0.34,13,0.026153846,16
2645.881908,53,90,0.99,37,0.026756757,16
2645.636234,43,73,0.74,30,0.024666667,16
2645.511008,33,76,0.25,43,0.005813953,16
2645.507471,37,95,0.13,58,0.002241379,16
2645.262243,35,96,0.16,61,0.002622951,16
2645.235812,25,95,0.28,70,0.004,16
2645.177495,34,60,0.89,26,0.034230769,16
2645.081226,59,74,0.49,15,0.032666667,16
2644.754977,39,65,0.1,26,0.003846154,16
2644.730274,63,82,0.41,19,0.021578947,16
2644.550421,58,94,0.76,36,0.021111111,16
2644.526124,34,99,0.18,65,0.002769231,16
2644.434616,54,83,0.82,29,0.028275862,16
2644.317315,61,66,0.17,5,0.034,16
2644.239435,36,70,0.17,34,0.005,16
2644.165836,55,86,0.87,31,0.028064516,16
2644.165836,55,87,0.89,32,0.0278125,16
2644.165836,54,87,0.93,33,0.028181818,16
2644.165836,54,88,0.95,34,0.027941176,16
2643.911406,41,51,0.35,10,0.035,16
2643.901597,40,89,0.1,49,0.002040816,16
2643.781631,33,55,0.87,22,0.039545455,16
2643.520811,43,66,0.75,23,0.032608696,16
2643.512517,55,95,0.99,40,0.02475,16
2643.504675,45,62,0.45,17,0.026470588,16
2643.038432,35,94,0.2,59,0.003389831,16
2642.962011,38,58,0.71,20,0.0355,16
2642.889831,36,98,0.15,62,0.002419355,16
2642.853371,60,86,0.56,26,0.021538462,16
2642.420019,34,97,0.18,63,0.002857143,16
2642.33556,70,75,0.12,5,0.024,16
2642.278757,37,93,0.16,56,0.002857143,16
2642.268598,38,67,0.11,29,0.003793103,16
2642.259998,47,67,0.63,20,0.0315,16
2642.166009,47,61,0.46,14,0.032857143,16
2642.140887,55,97,0.89,42,0.021190476,16
2642.072446,33,76,0.21,43,0.004883721,16
2642.051937,42,68,0.84,26,0.032307692,16
2641.846638,64,83,0.38,19,0.02,16
2641.830438,27,90,0.26,63,0.004126984,16
2641.65416,58,94,0.74,36,0.020555556,16
2641.62744,29,86,0.23,57,0.004035088,16
2641.560016,38,62,0.2,24,0.008333333,16
2641.347441,59,91,0.68,32,0.02125,16
2641.199428,43,48,0.19,5,0.038,16
2641.075281,36,52,0.59,16,0.036875,16
2640.993741,41,48,0.24,7,0.034285714,16
2640.919679,38,66,0.19,28,0.006785714,16
2640.825013,60,87,0.63,27,0.023333333,16
2640.714548,26,93,0.21,67,0.003134328,16
2640.358253,66,79,0.27,13,0.020769231,16
2640.139979,42,44,0.08,2,0.04,16
2640.139979,41,45,0.16,4,0.04,16
2640.07273,56,93,0.95,37,0.025675676,16
2639.954988,36,56,0.73,20,0.0365,16
2639.928037,45,69,0.76,24,0.031666667,16
2639.737881,26,95,0.24,69,0.003478261,16
2639.542735,39,66,0.13,27,0.004814815,16
2639.453127,34,97,0.22,63,0.003492063,16
2639.431655,35,96,0.21,61,0.003442623,16
2639.365466,37,55,0.69,18,0.038333333,16
2639.199819,56,88,0.72,32,0.0225,16
2639.156613,39,59,0.7,20,0.035,16
2639.043141,43,69,0.73,26,0.028076923,16
2639.00174,40,89,0.08,49,0.001632653,16
2638.927015,25,96,0.27,71,0.003802817,16
2638.878181,34,72,0.21,38,0.005526316,16
2638.862893,33,99,0.16,66,0.002424242,16
2638.817436,63,79,0.45,16,0.028125,16
2638.804025,43,59,0.11,16,0.006875,16
2638.742004,33,96,0.49,63,0.007777778,16
2638.714738,46,57,0.05,11,0.004545455,16
2638.694714,35,74,0.11,39,0.002820513,16
2638.691198,58,83,0.7,25,0.028,16
2638.517179,31,88,0.18,57,0.003157895,16
2638.488559,31,89,0.19,58,0.003275862,16
2638.371193,56,85,0.81,29,0.027931034,16
2638.1883,39,69,0.99,30,0.033,16
2637.992605,29,85,0.23,56,0.004107143,16
2637.920673,53,89,0.98,36,0.027222222,16
2637.880563,24,97,0.27,73,0.00369863,16
2637.562554,52,89,0.98,37,0.026486486,16
2637.454906,56,96,0.84,40,0.021,16
2637.424952,56,92,0.95,36,0.026388889,16
2637.36941,39,64,0.1,25,0.004,16
2637.26276,33,96,0.53,63,0.008412698,16
2637.15033,67,77,0.22,10,0.022,16
2637.078768,35,73,0.18,38,0.004736842,16
2636.877173,59,85,0.7,26,0.026923077,16
2636.688119,44,63,0.05,19,0.002631579,16
2636.573924,82,99,0.06,17,0.003529412,16
2636.539174,33,56,0.83,23,0.036086957,16
2636.528402,60,91,0.64,31,0.020645161,16
2636.526215,35,66,0.45,31,0.014516129,16
2636.456303,58,92,0.73,34,0.021470588,16
2636.209995,43,71,0.9,28,0.032142857,16
2636.198857,42,65,0.67,23,0.029130435,16
2636.136046,53,88,0.97,35,0.027714286,16
2636.101192,64,83,0.39,19,0.020526316,16
2636.019486,30,81,0.14,51,0.002745098,16
2635.908754,57,86,0.66,29,0.022758621,16
2635.692568,58,93,0.75,35,0.021428571,16
2635.681867,66,80,0.29,14,0.020714286,16
2635.559894,28,87,0.24,59,0.004067797,16
2635.394286,39,60,0.73,21,0.034761905,16
2635.375448,58,88,0.71,30,0.023666667,16
2635.35756,39,55,0.48,16,0.03,16
2635.301222,32,87,0.15,55,0.002727273,16
2635.194125,47,61,0.36,14,0.025714286,16
2635.143404,60,83,0.63,23,0.027391304,16
2635.143404,58,86,0.76,28,0.027142857,16
2635.143404,57,87,0.82,30,0.027333333,16
2635.143404,56,89,0.89,33,0.026969697,16
2635.071274,54,93,0.92,39,0.023589744,16
2634.761798,69,75,0.13,6,0.021666667,16
2634.614184,38,62,0.82,24,0.034166667,16
2634.614184,37,63,0.89,26,0.034230769,16
2634.567997,46,60,0.04,14,0.002857143,16
2634.471573,28,85,0.26,57,0.004561404,16
2634.452813,37,68,0.23,31,0.007419355,16
2634.39853,60,84,0.67,24,0.027916667,16
2634.39853,56,89,0.92,33,0.027878788,16
2633.912067,40,89,0.09,49,0.001836735,16
2633.831596,46,58,0.05,12,0.004166667,16
2633.726309,60,91,0.65,31,0.020967742,16
2633.69974,53,87,0.95,34,0.027941176,16
2633.666811,61,86,0.52,25,0.0208,16
2633.402175,61,88,0.58,27,0.021481481,16
2633.368139,56,97,0.86,41,0.02097561,16
2633.36468,39,71,0.1,32,0.003125,16
2633.187931,60,86,0.61,26,0.023461538,16
2633.187931,59,87,0.66,28,0.023571429,16
2633.004051,61,79,0.51,18,0.028333333,16
2633.004051,58,82,0.68,24,0.028333333,16
2633.004051,57,83,0.74,26,0.028461538,16
2633.004051,57,84,0.76,27,0.028148148,16
2632.939143,47,63,0.4,16,0.025,16
2632.725724,33,73,0.31,40,0.00775,16
2632.703311,62,79,0.39,17,0.022941176,16
2632.683884,36,69,0.18,33,0.005454545,16
2632.573462,45,56,0.09,11,0.008181818,16
2632.473196,27,89,0.26,62,0.004193548,16
2632.382706,36,93,0.16,57,0.002807018,16
2632.349185,60,83,0.52,23,0.022608696,16
2632.203369,65,81,0.42,16,0.02625,16
2632.107472,36,72,0.12,36,0.003333333,16
2632.044934,42,70,0.79,28,0.028214286,16
2632.025482,57,95,0.8,38,0.021052632,16
2631.984099,29,85,0.19,56,0.003392857,16
2631.924214,43,65,0.72,22,0.032727273,16
2631.857383,25,92,0.28,67,0.004179104,16
2631.656837,62,86,0.61,24,0.025416667,16
2631.571469,42,75,0.81,33,0.024545455,16
2631.037928,67,79,0.28,12,0.023333333,16
2631.037928,64,82,0.42,18,0.023333333,16
2631.037928,62,85,0.53,23,0.023043478,16
2631.037928,61,86,0.58,25,0.0232,16
2630.94725,37,62,0.87,25,0.0348,16
