% profit,ema1,ema2,threshold,diff,thresh / diff,ID
4165.910821,59,66,0.24,7,0.034285714,42
4164.762516,62,75,0.38,13,0.029230769,42
4158.123862,63,74,0.32,11,0.029090909,42
4107.416394,67,68,0.03,1,0.03,42
4107.416394,66,69,0.09,3,0.03,42
4107.416394,65,70,0.15,5,0.03,42
4105.036966,58,67,0.31,9,0.034444444,42
4082.377301,59,77,0.54,18,0.03,42
4082.377301,58,78,0.6,20,0.03,42
4071.038489,57,68,0.38,11,0.034545455,42
4057.247579,64,71,0.21,7,0.03,42
4057.247579,63,72,0.27,9,0.03,42
4044.161503,61,63,0.07,2,0.035,42
4044.161503,60,64,0.14,4,0.035,42
4041.670518,54,72,0.61,18,0.033888889,42
4041.670518,53,73,0.68,20,0.034,42
4039.957916,57,79,0.66,22,0.03,42
4026.931168,56,80,0.72,24,0.03,42
4018.198198,62,73,0.33,11,0.03,42
4017.910111,49,77,0.96,28,0.034285714,42
4011.520626,56,71,0.49,15,0.032666667,42
4005.445979,58,69,0.36,11,0.032727273,42
3998.60045,59,70,0.35,11,0.031818182,42
3998.481975,52,74,0.75,22,0.034090909,42
3997.288324,50,76,0.89,26,0.034230769,42
3979.24919,57,69,0.4,12,0.033333333,42
3977.378118,55,72,0.56,17,0.032941176,42
3967.160382,58,68,0.34,10,0.034,42
3962.370796,60,67,0.23,7,0.032857143,42
3958.484111,51,75,0.82,24,0.034166667,42
3950.880296,56,69,0.45,13,0.034615385,42
3950.880296,55,70,0.52,15,0.034666667,42
3946.890643,51,74,0.8,23,0.034782609,42
3943.770718,51,76,0.84,25,0.0336,42
3935.190401,62,66,0.13,4,0.0325,42
3935.190401,60,68,0.26,8,0.0325,42
3932.207154,57,72,0.48,15,0.032,42
3931.575234,62,67,0.16,5,0.032,42
3924.802121,57,70,0.43,13,0.033076923,42
3924.802121,51,77,0.86,26,0.033076923,42
3924.777575,53,72,0.66,19,0.034736842,42
3924.777575,52,73,0.73,21,0.034761905,42
3924.204173,50,77,0.91,27,0.033703704,42
3923.378027,60,66,0.2,6,0.033333333,42
3921.566538,55,73,0.59,18,0.032777778,42
3921.566538,52,76,0.79,24,0.032916667,42
3921.532582,54,73,0.63,19,0.033157895,42
3921.532582,53,74,0.7,21,0.033333333,42
3921.298808,60,69,0.29,9,0.032222222,42
3919.22277,54,74,0.65,20,0.0325,42
3915.134804,54,73,0.64,19,0.033684211,42
3911.257595,61,74,0.39,13,0.03,42
3907.197981,56,72,0.52,16,0.0325,42
3900.558251,58,71,0.42,13,0.032307692,42
3900.035323,58,70,0.39,12,0.0325,42
3899.727214,56,71,0.5,15,0.033333333,42
3899.727214,55,72,0.57,17,0.033529412,42
3898.311992,56,70,0.47,14,0.033571429,42
3898.311992,55,71,0.54,16,0.03375,42
3896.478045,59,67,0.27,8,0.03375,42
3896.478045,52,75,0.77,23,0.033478261,42
3892.19068,53,75,0.72,22,0.032727273,42
3891.631022,54,71,0.59,17,0.034705882,42
3886.264755,53,77,0.77,24,0.032083333,42
3883.055051,50,78,0.93,28,0.033214286,42
3882.240547,49,78,0.98,29,0.033793103,42
3876.499807,50,76,0.9,26,0.034615385,42
3876.499807,49,77,0.97,28,0.034642857,42
3875.969117,56,73,0.55,17,0.032352941,42
3875.969117,53,76,0.75,23,0.032608696,42
3875.884827,55,74,0.61,19,0.032105263,42
3867.700248,58,69,0.37,11,0.033636364,42
3861.763474,54,75,0.68,21,0.032380952,42
3861.454805,51,78,0.89,27,0.032962963,42
3859.008596,57,72,0.49,15,0.032666667,42
3854.37391,50,80,0.98,30,0.032666667,42
3852.474682,62,65,0.1,3,0.033333333,42
3852.474682,59,68,0.3,9,0.033333333,42
3846.253205,54,74,0.66,20,0.033,42
3845.815037,60,72,0.37,12,0.030833333,42
3844.606343,51,79,0.91,28,0.0325,42
3840.15686,53,74,0.71,21,0.033809524,42
3840.009624,52,78,0.84,26,0.032307692,42
3839.199482,57,71,0.46,14,0.032857143,42
3837.398694,57,69,0.41,12,0.034166667,42
3836.774558,52,76,0.8,24,0.033333333,42
3832.296318,53,77,0.78,24,0.0325,42
3829.737778,55,73,0.6,18,0.033333333,42
3829.737778,53,76,0.76,23,0.033043478,42
3826.232432,58,71,0.43,13,0.033076923,42
3821.667665,53,75,0.73,22,0.033181818,42
3821.342944,61,67,0.2,6,0.033333333,42
3819.438767,59,76,0.51,17,0.03,42
3814.690121,58,75,0.52,17,0.030588235,42
3814.657888,59,69,0.33,10,0.033,42
3808.12675,55,74,0.62,19,0.032631579,42
3808.12675,52,77,0.82,25,0.0328,42
3805.924655,59,74,0.46,15,0.030666667,42
3801.787583,66,68,0.06,2,0.03,42
3801.787583,65,69,0.12,4,0.03,42
3801.787583,64,70,0.18,6,0.03,42
3800.840672,50,77,0.92,27,0.034074074,42
3800.840672,49,78,0.99,29,0.034137931,42
3799.87258,59,73,0.43,14,0.030714286,42
3785.290436,55,74,0.63,19,0.033157895,42
3783.778742,56,72,0.53,16,0.033125,42
3783.778742,54,75,0.69,21,0.032857143,42
3781.185366,58,70,0.4,12,0.033333333,42
3779.608666,57,77,0.61,20,0.0305,42
3779.608666,56,78,0.67,22,0.030454545,42
3773.158856,46,59,0.38,13,0.029230769,42
3772.398598,58,77,0.57,19,0.03,42
3768.50655,56,73,0.56,17,0.032941176,42
3767.740819,60,73,0.4,13,0.030769231,42
3760.041365,48,55,0.21,7,0.03,42
3760.041365,47,56,0.27,9,0.03,42
3759.516391,61,68,0.23,7,0.032857143,42
3754.95926,63,71,0.24,8,0.03,42
3754.95926,62,72,0.3,10,0.03,42
3754.95926,61,73,0.36,12,0.03,42
3746.805644,60,68,0.27,8,0.03375,42
3745.881396,51,52,0.03,1,0.03,42
3745.881396,50,53,0.09,3,0.03,42
3745.881396,49,54,0.15,5,0.03,42
3745.107087,57,72,0.5,15,0.033333333,42
3732.608249,61,66,0.17,5,0.034,42
3727.005455,57,78,0.64,21,0.03047619,42
3725.119486,50,79,0.96,29,0.033103448,42
3724.894255,57,70,0.44,13,0.033846154,42
3724.894255,57,71,0.47,14,0.033571429,42
3724.452103,52,78,0.85,26,0.032692308,42
3723.263625,59,70,0.36,11,0.032727273,42
3719.442713,60,75,0.46,15,0.030666667,42
3708.633549,52,75,0.78,23,0.033913043,42
3708.633549,51,76,0.85,25,0.034,42
3702.763588,54,75,0.7,21,0.033333333,42
3702.763588,51,79,0.93,28,0.033214286,42
3702.208891,57,71,0.48,14,0.034285714,42
3696.792683,58,70,0.41,12,0.034166667,42
3696.483196,59,69,0.34,10,0.034,42
3696.483196,53,76,0.78,23,0.033913043,42
3691.058067,56,79,0.7,23,0.030434783,42
3685.231877,51,77,0.87,26,0.033461538,42
3685.050551,60,75,0.45,15,0.03,42
3681.445251,56,72,0.55,16,0.034375,42
3681.372623,59,75,0.49,16,0.030625,42
3678.838896,52,77,0.85,25,0.034,42
3678.838896,51,78,0.92,27,0.034074074,42
3678.838896,50,79,0.99,29,0.034137931,42
3670.148613,58,69,0.38,11,0.034545455,42
3667.586014,51,78,0.91,27,0.033703704,42
3667.242941,60,67,0.24,7,0.034285714,42
3667.242941,59,68,0.31,9,0.034444444,42
3667.242941,54,74,0.68,20,0.034,42
3667.242941,53,75,0.75,22,0.034090909,42
3664.860847,59,76,0.52,17,0.030588235,42
3663.53217,58,72,0.44,14,0.031428571,42
3661.714679,56,72,0.54,16,0.03375,42
3660.105545,54,74,0.67,20,0.0335,42
3660.028293,53,76,0.77,23,0.033478261,42
3660.002892,52,77,0.84,25,0.0336,42
3651.600316,53,73,0.69,20,0.0345,42
3651.600316,52,74,0.76,22,0.034545455,42
3651.600316,51,75,0.83,24,0.034583333,42
3647.07056,50,78,0.94,28,0.033571429,42
3634.205556,56,73,0.57,17,0.033529412,42
3630.101984,55,80,0.76,25,0.0304,42
3626.60026,61,69,0.25,8,0.03125,42
3626.136214,56,74,0.57,18,0.031666667,42
3625.552261,59,71,0.38,12,0.031666667,42
3623.907549,56,71,0.51,15,0.034,42
3623.907549,55,72,0.58,17,0.034117647,42
3618.851252,50,79,0.98,29,0.033793103,42
3617.316119,56,70,0.48,14,0.034285714,42
3617.316119,55,71,0.55,16,0.034375,42
3615.793104,56,74,0.58,18,0.032222222,42
3613.284393,53,74,0.72,21,0.034285714,42
3606.669779,52,76,0.82,24,0.034166667,42
3606.669779,51,77,0.89,26,0.034230769,42
3603.719358,55,73,0.61,18,0.033888889,42
3598.53504,57,82,0.71,25,0.0284,42
3598.192849,62,68,0.19,6,0.031666667,42
3598.192849,58,73,0.47,15,0.031333333,42
3596.186909,58,76,0.55,18,0.030555556,42
3593.142717,51,79,0.92,28,0.032857143,42
3588.505361,60,70,0.32,10,0.032,42
3588.505361,58,72,0.45,14,0.032142857,42
3583.681144,57,73,0.51,16,0.031875,42
3583.681144,55,75,0.64,20,0.032,42
3579.588053,54,75,0.71,21,0.033809524,42
3578.289984,55,84,0.83,29,0.02862069,42
3578.289984,54,85,0.89,31,0.028709677,42
3578.289984,53,87,0.97,34,0.028529412,42
3576.659189,55,74,0.64,19,0.033684211,42
3570.503068,50,78,0.96,28,0.034285714,42
3569.427347,56,83,0.77,27,0.028518519,42
3569.415879,54,73,0.65,19,0.034210526,42
3568.208424,62,77,0.42,15,0.028,42
3567.728298,54,76,0.71,22,0.032272727,42
3565.252038,52,75,0.79,23,0.034347826,42
3565.252038,51,76,0.86,25,0.0344,42
3562.945645,54,72,0.62,18,0.034444444,42
3562.039774,55,76,0.66,21,0.031428571,42
3559.135329,50,79,0.97,29,0.033448276,42
3559.003045,45,60,0.44,15,0.029333333,42
3555.781827,58,81,0.65,23,0.02826087,42
3552.955865,61,70,0.28,9,0.031111111,42
3552.594814,53,75,0.74,22,0.033636364,42
3548.911376,52,77,0.83,25,0.0332,42
3546.650821,45,59,0.42,14,0.03,42
3546.644539,51,80,0.93,29,0.032068966,42
3546.500764,53,78,0.8,25,0.032,42
3544.838913,60,79,0.53,19,0.027894737,42
3544.838913,56,84,0.77,28,0.0275,42
3544.838913,55,85,0.83,30,0.027666667,42
3542.915383,54,86,0.9,32,0.028125,42
3542.915383,53,87,0.96,34,0.028235294,42
3540.389506,51,77,0.88,26,0.033846154,42
3540.389506,50,78,0.95,28,0.033928571,42
3537.362431,59,80,0.59,21,0.028095238,42
3537.362431,57,82,0.7,25,0.028,42
3537.362431,56,83,0.76,27,0.028148148,42
3537.362431,55,85,0.84,30,0.028,42
3537.012569,61,76,0.44,15,0.029333333,42
3534.101794,56,84,0.78,28,0.027857143,42
3533.882498,52,76,0.81,24,0.03375,42
3533.472271,54,77,0.73,23,0.03173913,42
3527.874521,50,77,0.93,27,0.034444444,42
3526.974647,46,58,0.36,12,0.03,42
3526.742448,60,62,0.07,2,0.035,42
3526.550729,56,83,0.78,27,0.028888889,42
3522.297672,50,80,0.99,30,0.033,42
3521.399704,53,81,0.88,28,0.031428571,42
3521.303555,52,71,0.66,19,0.034736842,42
3520.717144,62,76,0.4,14,0.028571429,42
3516.628319,51,78,0.9,27,0.033333333,42
3514.506062,53,86,0.95,33,0.028787879,42
3514.415956,54,76,0.72,22,0.032727273,42
3512.778042,52,79,0.87,27,0.032222222,42
3510.717574,59,78,0.57,19,0.03,42
3510.218566,61,77,0.46,16,0.02875,42
3506.562317,57,81,0.69,24,0.02875,42
3502.8498,58,80,0.64,22,0.029090909,42
3502.8498,57,81,0.7,24,0.029166667,42
3502.718876,60,78,0.52,18,0.028888889,42
3501.519943,54,86,0.91,32,0.0284375,42
3494.81634,58,80,0.63,22,0.028636364,42
3494.712606,58,66,0.27,8,0.03375,42
3494.22644,59,79,0.58,20,0.029,42
3491.982365,56,75,0.6,19,0.031578947,42
3491.23459,61,78,0.48,17,0.028235294,42
3489.117264,53,72,0.64,19,0.033684211,42
3487.093688,54,86,0.89,32,0.0278125,42
3485.073835,62,72,0.31,10,0.031,42
3483.224258,60,74,0.44,14,0.031428571,42
3482.632976,55,84,0.84,29,0.028965517,42
3482.632976,54,85,0.9,31,0.029032258,42
3482.632976,53,86,0.96,33,0.029090909,42
3482.607896,61,64,0.1,3,0.033333333,42
3480.538891,55,76,0.67,21,0.031904762,42
3479.74488,54,85,0.88,31,0.028387097,42
3479.331509,56,73,0.58,17,0.034117647,42
3479.331509,55,74,0.65,19,0.034210526,42
3478.178454,56,82,0.75,26,0.028846154,42
3478.178454,55,83,0.81,28,0.028928571,42
3476.447892,55,79,0.75,24,0.03125,42
3474.28822,55,84,0.82,29,0.028275862,42
3473.944425,60,77,0.5,17,0.029411765,42
3473.944425,59,78,0.56,19,0.029473684,42
3470.650348,57,83,0.71,26,0.027307692,42
3470.001956,56,77,0.67,21,0.031904762,42
3469.4875,54,84,0.9,30,0.03,42
3468.480892,53,86,0.94,33,0.028484848,42
3467.912492,48,58,0.29,10,0.029,42
3467.628787,56,82,0.76,26,0.029230769,42
3466.919395,54,84,0.87,30,0.029,42
3465.791729,58,67,0.3,9,0.033333333,42
3464.033911,55,71,0.53,16,0.033125,42
3463.07821,53,85,0.93,32,0.0290625,42
3461.340117,47,57,0.3,10,0.03,42
3460.820204,56,82,0.77,26,0.029615385,42
3460.820204,55,83,0.83,28,0.029642857,42
3457.275994,51,53,0.06,2,0.03,42
3457.275994,50,54,0.12,4,0.03,42
3457.275994,49,55,0.18,6,0.03,42
3457.275994,48,56,0.24,8,0.03,42
3456.535945,50,73,0.8,23,0.034782609,42
3455.925223,57,67,0.34,10,0.034,42
3455.416484,59,64,0.17,5,0.034,42
3454.7824,58,79,0.63,21,0.03,42
3454.267644,49,76,0.95,27,0.035185185,42
3452.548867,58,77,0.58,19,0.030526316,42
3450.649982,52,86,0.99,34,0.029117647,42
3447.017253,52,73,0.72,21,0.034285714,42
3447.017253,51,74,0.79,23,0.034347826,42
3444.727252,67,69,0.06,2,0.03,42
3444.727252,66,70,0.12,4,0.03,42
3444.727252,65,71,0.18,6,0.03,42
3444.727252,64,72,0.24,8,0.03,42
3444.727252,63,73,0.3,10,0.03,42
3444.727252,62,74,0.36,12,0.03,42
3444.727252,61,75,0.42,14,0.03,42
3444.727252,60,76,0.48,16,0.03,42
3444.595793,59,63,0.14,4,0.035,42
3444.595793,58,64,0.21,6,0.035,42
3444.595793,57,65,0.28,8,0.035,42
3444.595793,56,66,0.35,10,0.035,42
3444.018976,44,59,0.45,15,0.03,42
3443.530669,61,79,0.49,18,0.027222222,42
3443.530669,59,81,0.6,22,0.027272727,42
3440.37406,58,79,0.62,21,0.02952381,42
3440.149905,50,76,0.88,26,0.033846154,42
3439.280093,51,72,0.73,21,0.034761905,42
3438.591209,55,75,0.65,20,0.0325,42
3435.956193,63,71,0.25,8,0.03125,42
3435.443167,49,77,0.95,28,0.033928571,42
3435.211463,61,71,0.31,10,0.031,42
3434.785294,43,63,0.59,20,0.0295,42
3433.991213,62,69,0.22,7,0.031428571,42
3430.901267,58,76,0.56,18,0.031111111,42
3429.789042,55,87,0.88,32,0.0275,42
3429.2544,53,72,0.65,19,0.034210526,42
3428.053818,53,87,0.95,34,0.027941176,42
3427.939877,52,73,0.71,21,0.033809524,42
3427.939877,51,74,0.78,23,0.033913043,42
3427.472672,58,82,0.66,24,0.0275,42
3427.472672,56,85,0.79,29,0.027241379,42
3427.472672,55,86,0.85,31,0.027419355,42
3427.433607,59,73,0.45,14,0.032142857,42
3427.236248,56,74,0.59,18,0.032777778,42
3423.664278,54,88,0.94,34,0.027647059,42
3423.040758,56,76,0.64,20,0.032,42
3423.040758,55,78,0.73,23,0.03173913,42
3423.040758,54,78,0.77,24,0.032083333,42
3422.536106,58,65,0.24,7,0.034285714,42
3421.978153,61,72,0.35,11,0.031818182,42
3421.801875,60,72,0.38,12,0.031666667,42
3421.801875,59,74,0.47,15,0.031333333,42
3421.801875,56,77,0.66,21,0.031428571,42
3421.801875,54,79,0.79,25,0.0316,42
3421.596295,53,79,0.82,26,0.031538462,42
3421.108971,53,86,0.97,33,0.029393939,42
3420.68136,51,75,0.81,24,0.03375,42
3420.482576,58,75,0.54,17,0.031764706,42
3419.200735,57,74,0.54,17,0.031764706,42
3418.849986,53,73,0.67,20,0.0335,42
3418.849986,52,74,0.74,22,0.033636364,42
3418.293103,58,83,0.69,25,0.0276,42
3417.320695,57,68,0.37,11,0.033636364,42
3415.921219,53,84,0.92,31,0.029677419,42
3415.234103,55,80,0.77,25,0.0308,42
3414.201702,54,80,0.81,26,0.031153846,42
3414.016159,40,65,0.73,25,0.0292,42
3412.651987,51,72,0.74,21,0.035238095,42
3412.546358,48,57,0.26,9,0.028888889,42
3412.135837,50,73,0.81,23,0.035217391,42
3409.912023,54,81,0.83,27,0.030740741,42
3409.218915,58,75,0.53,17,0.031176471,42
3408.407613,52,80,0.89,28,0.031785714,42
3407.215915,39,67,0.81,28,0.028928571,42
3406.670769,56,78,0.68,22,0.030909091,42
3406.205161,52,81,0.91,29,0.03137931,42
3405.96047,56,68,0.41,12,0.034166667,42
3405.96047,55,69,0.48,14,0.034285714,42
3405.96047,54,70,0.55,16,0.034375,42
3405.763802,55,83,0.82,28,0.029285714,42
3405.763802,54,84,0.88,30,0.029333333,42
3405.291802,57,74,0.55,17,0.032352941,42
3405.276208,53,88,0.96,35,0.027428571,42
3405.195492,57,80,0.68,23,0.029565217,42
3405.031287,52,82,0.94,30,0.031333333,42
3404.358314,59,75,0.5,16,0.03125,42
3404.358314,56,78,0.69,22,0.031363636,42
3404.245992,59,72,0.42,13,0.032307692,42
3403.710713,56,69,0.44,13,0.033846154,42
3403.666302,57,76,0.6,19,0.031578947,42
3402.360139,64,69,0.16,5,0.032,42
3401.57986,49,75,0.9,26,0.034615385,42
3401.420776,56,81,0.74,25,0.0296,42
3400.651674,57,75,0.56,18,0.031111111,42
3400.651674,55,78,0.71,23,0.030869565,42
3399.073285,54,84,0.89,30,0.029666667,42
3397.810127,57,83,0.72,26,0.027692308,42
3394.2424,58,81,0.68,23,0.029565217,42
3394.135802,51,73,0.76,22,0.034545455,42
3394.135802,50,74,0.83,24,0.034583333,42
3393.899774,53,77,0.79,24,0.032916667,42
3393.899774,52,78,0.86,26,0.033076923,42
3393.140179,57,80,0.69,23,0.03,42
3393.140179,56,81,0.75,25,0.03,42
3393.140179,53,85,0.96,32,0.03,42
3392.439331,62,71,0.28,9,0.031111111,42
3391.74859,54,83,0.87,29,0.03,42
3390.650209,57,75,0.58,18,0.032222222,42
3390.403242,55,82,0.8,27,0.02962963,42
3389.702349,54,80,0.82,26,0.031538462,42
3389.378446,55,82,0.81,27,0.03,42
3389.232364,63,69,0.19,6,0.031666667,42
3388.541023,59,72,0.41,13,0.031538462,42
3387.979093,55,70,0.51,15,0.034,42
3387.979093,54,71,0.58,17,0.034117647,42
3387.506132,54,87,0.91,33,0.027575758,42
3387.506132,53,88,0.97,35,0.027714286,42
3385.894083,57,67,0.36,10,0.036,42
3385.251642,59,74,0.48,15,0.032,42
3385.056676,57,83,0.73,26,0.028076923,42
3384.174197,64,74,0.29,10,0.029,42
3384.174197,63,75,0.35,12,0.029166667,42
3384.047585,65,73,0.23,8,0.02875,42
3381.838122,61,71,0.32,10,0.032,42
3381.838122,58,74,0.51,16,0.031875,42
3381.226048,60,65,0.17,5,0.034,42
3381.148758,52,85,0.98,33,0.02969697,42
3379.943536,52,72,0.69,20,0.0345,42
3379.710069,53,78,0.81,25,0.0324,42
3379.431647,60,79,0.54,19,0.028421053,42
3378.807371,59,80,0.61,21,0.029047619,42
3378.807371,58,81,0.67,23,0.029130435,42
3378.708915,53,84,0.94,31,0.030322581,42
3376.852115,60,63,0.11,3,0.036666667,42
3376.852115,57,66,0.33,9,0.036666667,42
3376.852115,54,69,0.55,15,0.036666667,42
3374.151995,57,82,0.72,25,0.0288,42
3373.246738,52,81,0.92,29,0.031724138,42
3373.064435,58,72,0.46,14,0.032857143,42
3371.950601,59,82,0.63,23,0.027391304,42
3371.187068,61,70,0.29,9,0.032222222,42
3369.793097,54,72,0.6,18,0.033333333,42
3369.514029,58,66,0.29,8,0.03625,42
3369.514029,54,70,0.58,16,0.03625,42
3366.928526,57,77,0.62,20,0.031,42
3366.206191,53,85,0.95,32,0.0296875,42
3366.168494,54,79,0.78,25,0.0312,42
3366.168494,54,80,0.8,26,0.030769231,42
3365.825785,57,66,0.31,9,0.034444444,42
3365.319117,56,65,0.32,9,0.035555556,42
3363.895655,58,80,0.66,22,0.03,42
3362.012767,61,73,0.37,12,0.030833333,42
3362.012767,60,74,0.43,14,0.030714286,42
3361.619718,46,59,0.39,13,0.03,42
3360.628213,56,67,0.38,11,0.034545455,42
3360.628213,55,68,0.45,13,0.034615385,42
3360.628213,54,69,0.52,15,0.034666667,42
3360.628213,53,70,0.59,17,0.034705882,42
3359.10828,61,79,0.5,18,0.027777778,42
3358.984197,63,74,0.33,11,0.03,42
3358.984197,62,75,0.39,13,0.03,42
3358.984197,61,76,0.45,15,0.03,42
3358.984197,60,77,0.51,17,0.03,42
3358.984197,57,81,0.72,24,0.03,42
3358.984197,56,82,0.78,26,0.03,42
3358.984197,55,83,0.84,28,0.03,42
3358.687544,56,86,0.82,30,0.027333333,42
3356.886933,63,68,0.16,5,0.032,42
3356.580999,55,67,0.42,12,0.035,42
3356.580999,54,68,0.49,14,0.035,42
3356.534849,63,70,0.22,7,0.031428571,42
3355.6909,60,78,0.53,18,0.029444444,42
3355.565374,58,74,0.5,16,0.03125,42
3355.565374,56,77,0.65,21,0.030952381,42
3354.575056,57,75,0.57,18,0.031666667,42
3354.575056,55,77,0.7,22,0.031818182,42
3354.342333,57,82,0.74,25,0.0296,42
3354.01681,58,68,0.33,10,0.033,42
3353.432078,51,81,0.96,30,0.032,42
3352.424881,60,71,0.35,11,0.031818182,42
3351.321629,59,80,0.6,21,0.028571429,42
3351.321629,58,81,0.66,23,0.028695652,42
3350.173079,55,85,0.85,30,0.028333333,42
3349.554053,62,76,0.41,14,0.029285714,42
3349.554053,61,77,0.47,16,0.029375,42
3349.554053,57,82,0.73,25,0.0292,42
3348.930529,55,76,0.68,21,0.032380952,42
3348.706058,55,77,0.69,22,0.031363636,42
3346.68916,52,79,0.89,27,0.032962963,42
3345.189898,51,82,0.98,31,0.031612903,42
3344.771165,67,72,0.14,5,0.028,42
3344.580101,53,80,0.86,27,0.031851852,42
3344.580101,51,82,0.99,31,0.031935484,42
3343.586019,55,69,0.51,14,0.036428571,42
3343.586019,52,72,0.73,20,0.0365,42
3343.586019,49,76,0.98,27,0.036296296,42
3341.233941,46,57,0.33,11,0.03,42
3341.039828,53,71,0.62,18,0.034444444,42
3340.221302,63,66,0.1,3,0.033333333,42
3340.221302,60,69,0.3,9,0.033333333,42
3340.221302,60,70,0.33,10,0.033,42
3340.189116,55,85,0.86,30,0.028666667,42
3340.189116,54,86,0.92,32,0.02875,42
3340.189116,53,87,0.98,34,0.028823529,42
3339.481917,57,64,0.25,7,0.035714286,42
3338.986222,55,81,0.79,26,0.030384615,42
3338.986222,54,82,0.85,28,0.030357143,42
3338.730479,54,90,0.97,36,0.026944444,42
3337.483166,42,62,0.59,20,0.0295,42
3337.055746,56,86,0.81,30,0.027,42
3336.731883,57,73,0.52,16,0.0325,42
3336.61408,54,83,0.86,29,0.029655172,42
3336.318144,51,74,0.83,23,0.036086957,42
3336.145628,55,75,0.66,20,0.033,42
3335.782138,43,61,0.55,18,0.030555556,42
3335.000302,60,73,0.41,13,0.031538462,42
3334.838174,53,85,0.94,32,0.029375,42
3333.303678,45,60,0.45,15,0.03,42
3332.811178,53,69,0.56,16,0.035,42
3332.210875,56,88,0.84,32,0.02625,42
3332.106942,52,70,0.63,18,0.035,42
3331.895157,43,62,0.57,19,0.03,42
3331.418629,56,67,0.4,11,0.036363636,42
3330.067235,51,80,0.94,29,0.032413793,42
3329.814615,56,68,0.43,12,0.035833333,42
3329.814615,56,69,0.46,13,0.035384615,42
3329.798054,63,78,0.41,15,0.027333333,42
3329.798054,61,81,0.54,20,0.027,42
3329.535042,55,70,0.53,15,0.035333333,42
3329.120052,52,73,0.76,21,0.036190476,42
3329.120052,50,75,0.91,25,0.0364,42
3329.008538,51,80,0.96,29,0.033103448,42
3328.55384,56,84,0.79,28,0.028214286,42
3326.670436,57,84,0.73,27,0.027037037,42
3326.610765,54,85,0.87,31,0.028064516,42
3326.610765,53,86,0.93,33,0.028181818,42
3325.793392,54,77,0.74,23,0.032173913,42
3325.413513,53,77,0.8,24,0.033333333,42
3325.413513,52,78,0.87,26,0.033461538,42
3325.294741,56,83,0.8,27,0.02962963,42
3325.294741,55,84,0.86,29,0.029655172,42
3325.294741,54,85,0.92,31,0.029677419,42
3325.294741,53,86,0.98,33,0.02969697,42
3325.215487,59,79,0.6,20,0.03,42
3322.920676,52,87,0.99,35,0.028285714,42
3320.948121,51,73,0.8,22,0.036363636,42
3320.707416,53,88,0.95,35,0.027142857,42
3320.362105,55,78,0.72,23,0.031304348,42
3320.362105,53,81,0.87,28,0.031071429,42
3320.358874,68,69,0.03,1,0.03,42
3320.358874,67,70,0.09,3,0.03,42
3320.358874,66,71,0.15,5,0.03,42
3320.358874,65,72,0.21,7,0.03,42
3320.358874,64,73,0.27,9,0.03,42
3319.810126,56,85,0.82,29,0.028275862,42
3319.69538,50,75,0.86,25,0.0344,42
3319.043574,54,71,0.61,17,0.035882353,42
3319.043574,50,75,0.9,25,0.036,42
3318.542185,54,76,0.73,22,0.033181818,42
3318.370368,53,86,0.99,33,0.03,42
3315.333,53,79,0.83,26,0.031923077,42
3314.610409,55,86,0.86,31,0.027741935,42
3314.610409,53,89,0.99,36,0.0275,42
3314.195086,54,89,0.95,35,0.027142857,42
3313.132627,60,81,0.57,21,0.027142857,42
3313.130159,57,85,0.76,28,0.027142857,42
3313.130159,55,88,0.89,33,0.026969697,42
3312.469789,52,85,0.99,33,0.03,42
3312.393028,54,89,0.9,35,0.025714286,42
3312.393028,53,90,0.95,37,0.025675676,42
3312.251682,79,86,0.12,7,0.017142857,42
3311.743885,54,87,0.92,33,0.027878788,42
3311.183667,59,79,0.59,20,0.0295,42
3311.183667,58,80,0.65,22,0.029545455,42
3311.183667,57,81,0.71,24,0.029583333,42
3310.45635,53,72,0.68,19,0.035789474,42
3309.114406,56,92,0.91,36,0.025277778,42
3309.114406,55,93,0.96,38,0.025263158,42
3308.584942,45,58,0.39,13,0.03,42
3307.648991,68,74,0.16,6,0.026666667,42
3307.648991,66,77,0.29,11,0.026363636,42
3307.648991,65,77,0.32,12,0.026666667,42
3307.552554,53,80,0.85,27,0.031481481,42
3307.549335,60,78,0.54,18,0.03,42
3307.22962,57,75,0.59,18,0.032777778,42
3307.22962,54,78,0.79,24,0.032916667,42
3306.683531,53,84,0.93,31,0.03,42
3306.543311,58,82,0.67,24,0.027916667,42
3305.925451,67,74,0.19,7,0.027142857,42
3305.911735,54,85,0.93,31,0.03,42
3305.125859,56,83,0.79,27,0.029259259,42
3305.125859,55,84,0.85,29,0.029310345,42
3305.125859,54,85,0.91,31,0.029354839,42
3305.125859,54,86,0.93,32,0.0290625,42
3305.125859,53,87,0.99,34,0.029117647,42
3303.907423,55,78,0.74,23,0.032173913,42
3303.68777,42,70,0.78,28,0.027857143,42
3303.620053,58,82,0.69,24,0.02875,42
3303.620053,56,85,0.83,29,0.02862069,42
3303.569867,58,83,0.67,25,0.0268,42
3303.489588,54,88,0.93,34,0.027352941,42
3301.435747,57,76,0.61,19,0.032105263,42
3300.466252,51,81,0.99,30,0.033,42
3300.371797,55,77,0.72,22,0.032727273,42
3300.283213,51,79,0.94,28,0.033571429,42
3299.342242,47,58,0.32,11,0.029090909,42
3297.971875,54,79,0.8,25,0.032,42
3297.971875,53,80,0.87,27,0.032222222,42
3297.902688,64,68,0.13,4,0.0325,42
3297.902688,62,70,0.26,8,0.0325,42
3297.489127,52,86,0.98,34,0.028823529,42
3297.028369,52,73,0.75,21,0.035714286,42
3296.724597,45,58,0.4,13,0.030769231,42
3296.014662,51,73,0.79,22,0.035909091,42
3295.596939,57,83,0.75,26,0.028846154,42
3295.596939,55,86,0.89,31,0.028709677,42
3295.533018,56,74,0.56,18,0.031111111,42
3295.346094,54,95,0.89,41,0.021707317,42
3295.066485,54,71,0.6,17,0.035294118,42
3294.620692,63,77,0.38,14,0.027142857,42
3294.552351,63,67,0.13,4,0.0325,42
3294.552351,61,69,0.26,8,0.0325,42
3294.316348,59,88,0.73,29,0.025172414,42
3294.316348,58,89,0.78,31,0.02516129,42
3292.206761,61,82,0.56,21,0.026666667,42
3292.206761,60,83,0.61,23,0.026521739,42
3292.206761,60,84,0.63,24,0.02625,42
3292.206761,59,84,0.67,25,0.0268,42
3292.206761,58,86,0.74,28,0.026428571,42
3292.206761,56,88,0.85,32,0.0265625,42
3292.206761,56,89,0.87,33,0.026363636,42
3292.206761,55,90,0.92,35,0.026285714,42
3291.648147,55,77,0.71,22,0.032272727,42
3290.77548,52,78,0.88,26,0.033846154,42
3290.77548,51,79,0.95,28,0.033928571,42
3290.77548,51,80,0.97,29,0.033448276,42
3289.285173,56,84,0.82,28,0.029285714,42
3289.151171,58,83,0.7,25,0.028,42
3289.151171,57,84,0.76,27,0.028148148,42
3289.151171,54,88,0.95,34,0.027941176,42
3288.345146,55,84,0.87,29,0.03,42
3288.036244,53,71,0.65,18,0.036111111,42
3287.23933,53,77,0.75,24,0.03125,42
3286.945392,54,86,0.88,32,0.0275,42
3286.378486,55,86,0.88,31,0.028387097,42
3285.478719,52,72,0.72,20,0.036,42
3285.173063,50,75,0.89,25,0.0356,42
3283.779166,58,89,0.79,31,0.025483871,42
3283.779166,57,90,0.84,33,0.025454545,42
3283.266254,54,87,0.96,33,0.029090909,42
3283.054504,53,88,0.98,35,0.028,42
3282.698676,50,75,0.87,25,0.0348,42
3282.698676,49,76,0.94,27,0.034814815,42
3282.064206,58,72,0.42,14,0.03,42
3282.064206,57,73,0.48,16,0.03,42
3281.502477,58,73,0.48,15,0.032,42
3281.502477,56,75,0.61,19,0.032105263,42
3281.305662,55,79,0.74,24,0.030833333,42
3280.558599,55,68,0.47,13,0.036153846,42
3280.528943,59,64,0.18,5,0.036,42
3280.421002,59,73,0.44,14,0.031428571,42
3279.948782,61,78,0.49,17,0.028823529,42
3279.237501,60,80,0.55,20,0.0275,42
3279.237501,58,83,0.68,25,0.0272,42
3279.237501,57,84,0.74,27,0.027407407,42
3279.237501,55,87,0.87,32,0.0271875,42
3279.237501,54,88,0.92,34,0.027058824,42
3279.237501,53,89,0.98,36,0.027222222,42
3279.173781,52,88,0.99,36,0.0275,42
3279.09474,57,84,0.75,27,0.027777778,42
3279.06165,61,72,0.34,11,0.030909091,42
3278.922007,56,83,0.81,27,0.03,42
3278.198919,53,71,0.64,18,0.035555556,42
3277.360698,55,90,0.9,35,0.025714286,42
3276.874725,58,73,0.49,15,0.032666667,42
3276.874725,56,76,0.65,20,0.0325,42
3276.288065,53,87,0.94,34,0.027647059,42
3276.245689,64,66,0.06,2,0.03,42
3276.245689,63,67,0.12,4,0.03,42
3276.245689,62,68,0.18,6,0.03,42
3276.245689,61,69,0.24,8,0.03,42
3276.245689,60,70,0.3,10,0.03,42
3276.076206,53,82,0.89,29,0.030689655,42
3276.018942,59,71,0.36,12,0.03,42
3275.627902,62,70,0.25,8,0.03125,42
3275.627902,56,76,0.63,20,0.0315,42
3274.310181,67,78,0.28,11,0.025454545,42
3274.161285,57,87,0.77,30,0.025666667,42
3272.895549,51,75,0.85,24,0.035416667,42
3272.886263,42,64,0.66,22,0.03,42
3271.858932,63,76,0.37,13,0.028461538,42
3271.858932,62,77,0.43,15,0.028666667,42
3271.257162,72,74,0.04,2,0.02,42
3271.257162,71,75,0.08,4,0.02,42
3271.257162,70,76,0.12,6,0.02,42
3270.778936,65,76,0.29,11,0.026363636,42
3270.778936,61,81,0.52,20,0.026,42
3270.69071,61,85,0.61,24,0.025416667,42
3270.171612,53,78,0.82,25,0.0328,42
3270.171612,51,81,0.98,30,0.032666667,42
3269.813546,55,66,0.39,11,0.035454545,42
3269.505392,50,74,0.87,24,0.03625,42
3269.425294,47,57,0.31,10,0.031,42
3269.282801,59,81,0.61,22,0.027727273,42
3269.282801,56,85,0.8,29,0.027586207,42
3268.595806,63,79,0.43,16,0.026875,42
3268.595806,63,80,0.45,17,0.026470588,42
3268.101487,63,75,0.36,12,0.03,42
3267.938531,56,89,0.84,33,0.025454545,42
3267.568446,51,81,0.97,30,0.032333333,42
3267.396516,61,69,0.27,8,0.03375,42
3266.811232,44,61,0.51,17,0.03,42
3266.327732,57,74,0.56,17,0.032941176,42
3266.130496,59,82,0.62,23,0.026956522,42
3265.951425,55,94,0.98,39,0.025128205,42
3265.721069,59,83,0.64,24,0.026666667,42
3264.973964,59,73,0.46,14,0.032857143,42
3263.671908,57,72,0.47,15,0.031333333,42
3263.310088,52,72,0.71,20,0.0355,42
3262.813583,52,78,0.8,26,0.030769231,42
3262.703281,56,87,0.83,31,0.026774194,42
3262.703281,55,89,0.9,34,0.026470588,42
3262.703281,54,90,0.96,36,0.026666667,42
3262.281987,56,84,0.8,28,0.028571429,42
3261.767403,50,75,0.88,25,0.0352,42
3261.453094,51,80,0.95,29,0.032758621,42
3261.332726,52,80,0.92,28,0.032857143,42
3261.276599,56,74,0.54,18,0.03,42
3260.584047,52,79,0.82,27,0.03037037,42
3260.435389,59,71,0.39,12,0.0325,42
3260.398543,39,67,0.98,28,0.035,42
3260.168144,49,81,0.99,32,0.0309375,42
3260.133271,48,76,0.98,28,0.035,42
3260.049807,59,84,0.65,25,0.026,42
3259.91943,53,78,0.83,25,0.0332,42
3259.826102,62,69,0.23,7,0.032857143,42
3259.826102,60,72,0.39,12,0.0325,42
3259.645554,54,77,0.76,23,0.033043478,42
3259.574929,60,71,0.36,11,0.032727273,42
3259.574929,58,74,0.52,16,0.0325,42
3259.552233,53,79,0.85,26,0.032692308,42
3258.809311,57,74,0.57,17,0.033529412,42
3258.509922,51,72,0.77,21,0.036666667,42
3258.353666,47,59,0.35,12,0.029166667,42
3257.454796,54,78,0.78,24,0.0325,42
3257.454796,52,81,0.93,29,0.032068966,42
3257.266947,52,79,0.88,27,0.032592593,42
3256.978549,50,80,0.93,30,0.031,42
3256.863271,54,91,0.97,37,0.026216216,42
3256.784187,58,72,0.43,14,0.030714286,42
3256.784187,57,73,0.49,16,0.030625,42
3256.445633,58,85,0.71,27,0.026296296,42
3256.310341,54,78,0.76,24,0.031666667,42
3255.716817,65,74,0.25,9,0.027777778,42
3255.716817,64,76,0.33,12,0.0275,42
3255.716817,62,78,0.44,16,0.0275,42
3255.51,53,78,0.84,25,0.0336,42
3255.415961,57,91,0.85,34,0.025,42
3255.308656,62,79,0.46,17,0.027058824,42
3253.696579,55,95,0.99,40,0.02475,42
3253.057458,51,74,0.82,23,0.035652174,42
3252.906155,55,76,0.69,21,0.032857143,42
3252.194546,66,72,0.18,6,0.03,42
3252.194546,65,73,0.24,8,0.03,42
3252.194546,64,74,0.3,10,0.03,42
3251.863681,54,87,0.95,33,0.028787879,42
3251.150366,55,69,0.5,14,0.035714286,42
3251.150366,54,70,0.57,16,0.035625,42
3250.822985,56,74,0.55,18,0.030555556,42
3250.808854,41,64,0.81,23,0.035217391,42
3250.790231,56,75,0.62,19,0.032631579,42
3250.790231,53,79,0.84,26,0.032307692,42
3250.790231,52,80,0.91,28,0.0325,42
3250.541969,56,75,0.64,19,0.033684211,42
3250.46884,58,84,0.7,26,0.026923077,42
3250.46884,57,85,0.75,28,0.026785714,42
3250.46884,55,88,0.88,33,0.026666667,42
3250.46884,54,89,0.94,35,0.026857143,42
3249.368291,56,74,0.6,18,0.033333333,42
3249.085804,62,80,0.47,18,0.026111111,42
3248.840591,53,72,0.67,19,0.035263158,42
3248.840591,52,73,0.74,21,0.035238095,42
3248.402215,57,87,0.82,30,0.027333333,42
3247.88356,54,86,0.95,32,0.0296875,42
3247.321836,57,76,0.59,19,0.031052632,42
3246.289545,56,75,0.63,19,0.033157895,42
3245.870287,50,81,0.95,31,0.030645161,42
3245.641021,68,77,0.23,9,0.025555556,42
3245.641021,62,84,0.56,22,0.025454545,42
3245.277655,55,75,0.62,20,0.031,42
3244.266644,53,78,0.75,25,0.03,42
3243.65951,55,74,0.59,19,0.031052632,42
3243.065815,70,96,0.44,26,0.016923077,42
3242.915316,50,76,0.93,26,0.035769231,42
3242.649508,57,73,0.53,16,0.033125,42
3242.30123,68,72,0.11,4,0.0275,42
3242.125839,53,77,0.74,24,0.030833333,42
3242.051425,49,75,0.91,26,0.035,42
3241.733543,40,65,0.88,25,0.0352,42
3241.552437,54,75,0.66,21,0.031428571,42
3241.552437,52,78,0.81,26,0.031153846,42
3241.552437,50,80,0.94,30,0.031333333,42
3241.127792,71,77,0.12,6,0.02,42
3241.127792,70,78,0.16,8,0.02,42
3241.127792,69,79,0.2,10,0.02,42
3241.127792,68,80,0.24,12,0.02,42
3240.778116,51,80,0.87,29,0.03,42
3240.778116,50,81,0.93,31,0.03,42
3240.650335,53,77,0.73,24,0.030416667,42
3240.596284,56,88,0.88,32,0.0275,42
3240.540056,54,77,0.75,23,0.032608696,42
3240.516476,59,85,0.68,26,0.026153846,42
3240.516476,56,89,0.86,33,0.026060606,42
3240.186773,57,83,0.74,26,0.028461538,42
3239.688349,53,71,0.63,18,0.035,42
3239.181437,44,60,0.49,16,0.030625,42
3239.075208,59,81,0.62,22,0.028181818,42
3239.075208,56,85,0.81,29,0.027931034,42
3239.075208,55,86,0.87,31,0.028064516,42
3238.837934,51,78,0.85,27,0.031481481,42
3238.540031,52,79,0.91,27,0.033703704,42
3238.540031,51,80,0.98,29,0.033793103,42
3238.476114,60,79,0.55,19,0.028947368,42
3238.476114,56,84,0.81,28,0.028928571,42
3238.476114,55,85,0.87,30,0.029,42
3238.347641,59,72,0.43,13,0.033076923,42
3237.663772,58,85,0.72,27,0.026666667,42
3237.663772,57,87,0.79,30,0.026333333,42
3236.891881,52,80,0.9,28,0.032142857,42
3236.380748,49,76,0.96,27,0.035555556,42
3236.326701,54,76,0.68,22,0.030909091,42
3235.904347,61,82,0.58,21,0.027619048,42
3235.491388,52,72,0.7,20,0.035,42
3235.20441,51,79,0.86,28,0.030714286,42
3233.985404,64,75,0.31,11,0.028181818,42
3233.778276,53,88,0.94,35,0.026857143,42
3233.439202,67,73,0.17,6,0.028333333,42
3232.903135,50,81,0.94,31,0.030322581,42
3232.452929,61,80,0.52,19,0.027368421,42
3232.270525,55,85,0.88,30,0.029333333,42
3232.138777,58,82,0.68,24,0.028333333,42
3232.138777,54,87,0.93,33,0.028181818,42
3232.138777,53,88,0.99,35,0.028285714,42
3232.061084,60,87,0.68,27,0.025185185,42
3231.751636,54,90,0.95,36,0.026388889,42
3231.733485,55,87,0.89,32,0.0278125,42
3231.668524,51,80,0.88,29,0.030344828,42
3231.046041,58,86,0.76,28,0.027142857,42
3230.669553,56,73,0.53,17,0.031176471,42
3230.669553,53,76,0.72,23,0.031304348,42
3230.445867,51,79,0.87,28,0.031071429,42
3229.445166,55,88,0.9,33,0.027272727,42
3229.412735,54,87,0.94,33,0.028484848,42
3229.180951,43,63,0.6,20,0.03,42
3229.007774,54,88,0.96,34,0.028235294,42
3229.007384,61,68,0.24,7,0.034285714,42
3228.906417,57,86,0.77,29,0.026551724,42
3228.200392,60,80,0.56,20,0.028,42
3227.810756,58,71,0.4,13,0.030769231,42
3227.776037,64,77,0.35,13,0.026923077,42
3227.776037,62,80,0.48,18,0.026666667,42
3226.704093,55,75,0.61,20,0.0305,42
3226.417969,53,70,0.62,17,0.036470588,42
3226.238091,60,80,0.57,20,0.0285,42
3226.203218,75,91,0.27,16,0.016875,42
3225.338039,57,70,0.45,13,0.034615385,42
3224.63842,57,85,0.77,28,0.0275,42
3223.740227,52,71,0.67,19,0.035263158,42
3223.711357,52,79,0.81,27,0.03,42
3223.480774,56,86,0.78,30,0.026,42
3223.480774,54,88,0.89,34,0.026176471,42
3223.324951,58,85,0.75,27,0.027777778,42
3223.324951,55,89,0.94,34,0.027647059,42
3222.963763,54,70,0.56,16,0.035,42
3222.786216,57,86,0.81,29,0.027931034,42
3221.952367,55,88,0.85,33,0.025757576,42
3221.933465,66,76,0.28,10,0.028,42
3221.847426,56,86,0.83,30,0.027666667,42
3220.986713,55,87,0.9,32,0.028125,42
3220.788969,59,83,0.65,24,0.027083333,42
3220.72239,61,81,0.55,20,0.0275,42
3220.553919,49,76,0.97,27,0.035925926,42
3220.072642,54,88,0.97,34,0.028529412,42
3220.000568,51,76,0.87,25,0.0348,42
3219.835145,51,73,0.77,22,0.035,42
3219.835145,50,74,0.84,24,0.035,42
3219.08172,44,62,0.53,18,0.029444444,42
3218.869626,54,89,0.96,35,0.027428571,42
3218.612954,64,78,0.39,14,0.027857143,42
3218.559857,55,86,0.84,31,0.027096774,42
3218.505441,54,87,0.9,33,0.027272727,42
3218.302891,60,69,0.28,9,0.031111111,42
3217.786011,57,73,0.54,16,0.03375,42
3217.786011,56,74,0.61,18,0.033888889,42
3217.621042,57,72,0.46,15,0.030666667,42
3217.384646,51,74,0.81,23,0.035217391,42
3216.872498,45,60,0.46,15,0.030666667,42
3216.797358,63,78,0.42,15,0.028,42
3216.797358,62,80,0.5,18,0.027777778,42
3216.797358,60,82,0.61,22,0.027727273,42
3216.797358,59,83,0.67,24,0.027916667,42
3216.797358,59,84,0.69,25,0.0276,42
3216.797358,57,86,0.8,29,0.027586207,42
3216.622376,60,66,0.21,6,0.035,42
3216.622376,59,67,0.28,8,0.035,42
3216.622376,58,68,0.35,10,0.035,42
3216.622376,57,69,0.42,12,0.035,42
3216.622376,56,70,0.49,14,0.035,42
3216.622376,55,71,0.56,16,0.035,42
3216.530202,59,65,0.21,6,0.035,42
3216.530202,58,66,0.28,8,0.035,42
3216.530202,57,67,0.35,10,0.035,42
3216.530202,56,68,0.42,12,0.035,42
3216.530202,55,69,0.49,14,0.035,42
3215.876606,54,76,0.67,22,0.030454545,42
3215.526575,53,66,0.47,13,0.036153846,42
3215.499232,54,76,0.74,22,0.033636364,42
3215.499232,54,77,0.77,23,0.033478261,42
3215.499232,53,77,0.81,24,0.03375,42
3215.199482,55,85,0.89,30,0.029666667,42
3215.027395,49,74,0.88,25,0.0352,42
3214.997969,54,86,0.94,32,0.029375,42
3214.720776,58,73,0.5,15,0.033333333,42
3214.451443,59,70,0.34,11,0.030909091,42
3213.824085,65,77,0.33,12,0.0275,42
3213.824085,63,79,0.44,16,0.0275,42
3213.824085,60,83,0.63,23,0.027391304,42
3213.569481,44,61,0.52,17,0.030588235,42
3213.327042,74,93,0.32,19,0.016842105,42
3213.109109,61,80,0.51,19,0.026842105,42
3213.070201,54,77,0.68,23,0.029565217,42
3212.877105,64,77,0.36,13,0.027692308,42
3212.860174,55,76,0.7,21,0.033333333,42
3212.860174,52,79,0.9,27,0.033333333,42
3212.358663,46,60,0.41,14,0.029285714,42
3212.19082,57,86,0.78,29,0.026896552,42
3211.721848,40,67,0.78,27,0.028888889,42
3211.679765,72,94,0.37,22,0.016818182,42
3211.647411,64,67,0.1,3,0.033333333,42
3211.250255,54,67,0.46,13,0.035384615,42
3211.112328,43,63,0.58,20,0.029,42
3211.00645,56,87,0.84,31,0.027096774,42
3210.899063,48,75,0.95,27,0.035185185,42
3210.5759,43,62,0.58,19,0.030526316,42
3210.558358,54,88,0.91,34,0.026764706,42
3210.558358,53,89,0.97,36,0.026944444,42
3210.507221,63,79,0.45,16,0.028125,42
3210.158299,56,92,0.9,36,0.025,42
3209.644923,45,61,0.47,16,0.029375,42
3209.494488,41,66,0.72,25,0.0288,42
3209.474138,54,66,0.43,12,0.035833333,42
3209.358602,50,81,0.96,31,0.030967742,42
3208.274477,44,67,0.66,23,0.028695652,42
3208.141038,62,68,0.2,6,0.033333333,42
3208.141038,58,72,0.47,14,0.033571429,42
3208.141038,55,75,0.67,20,0.0335,42
3208.102929,56,87,0.82,31,0.026451613,42
3207.642367,46,58,0.32,12,0.026666667,42
3206.942601,55,90,0.91,35,0.026,42
3206.938992,49,76,0.93,27,0.034444444,42
3205.995097,66,75,0.25,9,0.027777778,42
3205.679979,55,87,0.86,32,0.026875,42
3205.357014,57,72,0.51,15,0.034,42
3204.653305,56,88,0.86,32,0.026875,42
3204.653305,54,91,0.99,37,0.026756757,42
3204.499822,65,74,0.26,9,0.028888889,42
3204.432494,63,76,0.36,13,0.027692308,42
3204.37974,66,73,0.2,7,0.028571429,42
3204.37974,61,79,0.51,18,0.028333333,42
3204.183213,51,80,0.89,29,0.030689655,42
3203.622545,66,76,0.27,10,0.027,42
3203.587636,63,78,0.44,15,0.029333333,42
3203.292959,60,83,0.64,23,0.027826087,42
3202.925102,62,67,0.17,5,0.034,42
3202.813172,57,85,0.73,28,0.026071429,42
3202.366094,53,91,0.97,38,0.025526316,42
3201.821537,50,74,0.86,24,0.035833333,42
3201.455278,61,81,0.56,20,0.028,42
3201.006825,55,75,0.68,20,0.034,42
3200.648566,58,71,0.44,13,0.033846154,42
3200.63586,66,72,0.17,6,0.028333333,42
3200.63586,63,75,0.34,12,0.028333333,42
3199.743188,52,74,0.77,22,0.035,42
3199.72756,53,90,0.97,37,0.026216216,42
3199.528474,55,94,0.96,39,0.024615385,42
3199.036805,60,70,0.34,10,0.034,42
3198.990896,47,59,0.34,12,0.028333333,42
3198.981328,49,75,0.95,26,0.036538462,42
3198.954843,61,82,0.57,21,0.027142857,42
3198.3166,63,80,0.47,17,0.027647059,42
3198.244435,79,88,0.15,9,0.016666667,42
3198.021329,59,71,0.4,12,0.033333333,42
3197.752499,59,70,0.37,11,0.033636364,42
3197.548347,44,63,0.55,19,0.028947368,42
3197.480274,60,71,0.37,11,0.033636364,42
3197.264883,55,87,0.84,32,0.02625,42
3197.264883,54,89,0.91,35,0.026,42
3197.264883,53,90,0.96,37,0.025945946,42
3197.116033,58,81,0.64,23,0.027826087,42
3196.418019,62,78,0.45,16,0.028125,42
3196.403921,37,70,0.95,33,0.028787879,42
3195.776153,55,94,0.84,39,0.021538462,42
3195.760537,59,89,0.75,30,0.025,42
3195.760537,58,90,0.8,32,0.025,42
3195.760537,56,93,0.92,37,0.024864865,42
3195.760537,55,94,0.97,39,0.024871795,42
3195.569163,65,76,0.31,11,0.028181818,42
3195.569163,62,79,0.48,17,0.028235294,42
3194.278592,62,76,0.42,14,0.03,42
3194.278592,61,77,0.48,16,0.03,42
3194.217654,53,78,0.74,25,0.0296,42
3194.217654,52,79,0.8,27,0.02962963,42
3193.890596,62,81,0.51,19,0.026842105,42
3193.890596,60,82,0.6,22,0.027272727,42
3193.890596,58,85,0.73,27,0.027037037,42
3193.764847,59,84,0.7,25,0.028,42
3193.764847,55,89,0.95,34,0.027941176,42
3193.391453,64,77,0.37,13,0.028461538,42
3193.167864,57,68,0.39,11,0.035454545,42
3193.042588,62,79,0.47,17,0.027647059,42
3192.768769,49,75,0.94,26,0.036153846,42
3192.461288,82,85,0.05,3,0.016666667,42
3191.351639,70,98,0.47,28,0.016785714,42
3191.001001,71,95,0.41,24,0.017083333,42
3189.966064,55,90,0.94,35,0.026857143,42
3189.954084,59,66,0.25,7,0.035714286,42
3189.742594,56,94,0.93,38,0.024473684,42
3189.638232,60,82,0.59,22,0.026818182,42
3189.144383,65,76,0.3,11,0.027272727,42
3188.560668,66,74,0.22,8,0.0275,42
3188.455595,55,73,0.62,18,0.034444444,42
3188.455595,54,74,0.69,20,0.0345,42
3188.455595,53,75,0.76,22,0.034545455,42
3188.455595,52,76,0.83,24,0.034583333,42
3188.455595,51,77,0.9,26,0.034615385,42
3187.281498,58,67,0.32,9,0.035555556,42
3187.184719,65,76,0.32,11,0.029090909,42
3186.189032,50,78,0.97,28,0.034642857,42
3186.05429,56,88,0.89,32,0.0278125,42
3185.644316,49,77,0.98,28,0.035,42
3184.783855,56,92,0.92,36,0.025555556,42
3184.392437,54,91,0.98,37,0.026486486,42
3184.088063,47,83,0.83,36,0.023055556,42
3183.925115,59,84,0.66,25,0.0264,42
3183.791129,54,92,0.99,38,0.026052632,42
3183.761244,57,92,0.87,35,0.024857143,42
3183.308747,62,64,0.07,2,0.035,42
3183.308747,61,65,0.14,4,0.035,42
3183.308747,56,71,0.52,15,0.034666667,42
3183.308747,55,72,0.59,17,0.034705882,42
3183.308747,54,73,0.66,19,0.034736842,42
3183.308747,53,74,0.73,21,0.034761905,42
3183.308747,52,75,0.8,23,0.034782609,42
3183.121838,69,73,0.11,4,0.0275,42
3183.021142,38,68,0.87,30,0.029,42
3183.002752,56,91,0.91,35,0.026,42
3183.002752,55,93,0.98,38,0.025789474,42
3182.969204,40,68,0.78,28,0.027857143,42
3182.904102,65,80,0.4,15,0.026666667,42
3182.904102,63,82,0.51,19,0.026842105,42
3182.791409,62,80,0.52,18,0.028888889,42
3182.697052,58,85,0.74,27,0.027407407,42
3182.697052,55,89,0.93,34,0.027352941,42
3181.978745,58,89,0.8,31,0.025806452,42
3180.386991,55,70,0.54,15,0.036,42
3179.926983,59,81,0.63,22,0.028636364,42
3179.823777,60,82,0.62,22,0.028181818,42
3179.759787,68,73,0.14,5,0.028,42
3179.740734,56,81,0.76,25,0.0304,42
3179.207671,57,84,0.72,27,0.026666667,42
3179.207671,56,86,0.79,30,0.026333333,42
3179.207671,54,88,0.9,34,0.026470588,42
3179.033841,60,78,0.51,18,0.028333333,42
3178.734931,65,78,0.35,13,0.026923077,42
3178.734931,63,80,0.46,17,0.027058824,42
3178.645485,57,86,0.79,29,0.027241379,42
3178.208984,62,80,0.51,18,0.028333333,42
3178.15824,64,78,0.37,14,0.026428571,42
3177.930635,54,89,0.97,35,0.027714286,42
3176.918183,55,90,0.93,35,0.026571429,42
3176.819716,67,75,0.22,8,0.0275,42
3176.775494,60,82,0.58,22,0.026363636,42
3176.760308,59,82,0.61,23,0.026521739,42
3176.735639,59,83,0.68,24,0.028333333,42
3175.896074,64,79,0.4,15,0.026666667,42
3175.896074,59,85,0.69,26,0.026538462,42
3175.735244,50,76,0.92,26,0.035384615,42
3175.735244,49,77,0.99,28,0.035357143,42
3175.551476,49,80,0.72,31,0.023225806,42
3175.52637,59,87,0.74,28,0.026428571,42
3175.52637,57,90,0.87,33,0.026363636,42
3174.717137,55,89,0.91,34,0.026764706,42
3174.52347,55,71,0.57,16,0.035625,42
3174.166944,61,78,0.47,17,0.027647059,42
3173.641424,40,68,0.8,28,0.028571429,42
3173.245475,56,85,0.78,29,0.026896552,42
3173.245475,55,87,0.85,32,0.0265625,42
3173.181465,69,74,0.13,5,0.026,42
3172.956496,59,83,0.66,24,0.0275,42
3172.956496,59,84,0.68,25,0.0272,42
3172.956496,57,87,0.81,30,0.027,42
3172.914298,69,72,0.08,3,0.026666667,42
3172.820882,61,86,0.63,25,0.0252,42
3172.270227,39,67,0.96,28,0.034285714,42
3172.222006,55,92,0.98,37,0.026486486,42
3172.159657,61,70,0.3,9,0.033333333,42
3171.980125,53,89,0.95,36,0.026388889,42
3171.914491,58,82,0.71,24,0.029583333,42
3171.712749,42,63,0.64,21,0.03047619,42
3171.678593,53,68,0.53,15,0.035333333,42
3171.215603,60,81,0.56,21,0.026666667,42
3171.215603,56,86,0.8,30,0.026666667,42
3170.81772,63,78,0.4,15,0.026666667,42
3170.81772,58,84,0.69,26,0.026538462,42
3170.766076,50,79,0.67,29,0.023103448,42
3170.497072,64,77,0.38,13,0.029230769,42
3169.986649,66,79,0.34,13,0.026153846,42
3169.886254,59,82,0.65,23,0.02826087,42
3169.670471,65,78,0.34,13,0.026153846,42
3169.670471,61,83,0.57,22,0.025909091,42
3169.670471,58,86,0.73,28,0.026071429,42
3169.20984,59,80,0.58,21,0.027619048,42
3169.173599,61,85,0.67,24,0.027916667,42
3168.87164,54,72,0.63,18,0.035,42
3168.597383,66,74,0.23,8,0.02875,42
3167.967478,64,78,0.38,14,0.027142857,42
3167.967478,62,80,0.49,18,0.027222222,42
3167.967478,60,83,0.62,23,0.026956522,42
3167.967478,58,86,0.75,28,0.026785714,42
3167.757442,59,88,0.74,29,0.025517241,42
3167.757442,56,91,0.9,35,0.025714286,42
3167.757442,55,93,0.97,38,0.025526316,42
3167.264155,63,77,0.39,14,0.027857143,42
3167.189555,39,67,0.99,28,0.035357143,42
3166.878267,62,81,0.5,19,0.026315789,42
3166.606598,51,75,0.86,24,0.035833333,42
3166.591124,61,68,0.16,7,0.022857143,42
3166.363424,62,83,0.56,21,0.026666667,42
3166.363424,60,86,0.69,26,0.026538462,42
3166.363424,58,88,0.8,30,0.026666667,42
3166.301326,61,84,0.62,23,0.026956522,42
3166.301326,59,87,0.75,28,0.026785714,42
3166.245802,57,87,0.8,30,0.026666667,42
3166.157417,56,88,0.87,32,0.0271875,42
3166.072666,58,86,0.77,28,0.0275,42
3165.879221,52,74,0.79,22,0.035909091,42
3165.70892,53,90,0.99,37,0.026756757,42
3165.649456,66,75,0.26,9,0.028888889,42
3165.583595,57,83,0.76,26,0.029230769,42
3165.448058,62,84,0.61,22,0.027727273,42
3164.988785,56,72,0.37,16,0.023125,42
3164.966872,65,80,0.39,15,0.026,42
3164.966872,62,84,0.57,22,0.025909091,42
3164.966872,61,85,0.62,24,0.025833333,42
3164.966872,60,86,0.67,26,0.025769231,42
3164.966872,59,87,0.73,28,0.026071429,42
3164.966872,57,90,0.85,33,0.025757576,42
3164.365668,47,55,0.25,8,0.03125,42
3164.042661,62,79,0.45,17,0.026470588,42
3163.964946,53,73,0.7,20,0.035,42
3163.83059,43,59,0.55,16,0.034375,42
3163.762565,55,72,0.4,17,0.023529412,42
3163.762565,52,76,0.56,24,0.023333333,42
3163.721033,51,77,0.61,26,0.023461538,42
3163.664159,59,86,0.7,27,0.025925926,42
3163.664159,58,88,0.77,30,0.025666667,42
3163.664159,56,90,0.88,34,0.025882353,42
3163.664159,56,91,0.89,35,0.025428571,42
3163.664159,55,92,0.95,37,0.025675676,42
3163.645652,59,83,0.63,24,0.02625,42
3162.903647,64,74,0.28,10,0.028,42
3162.823074,61,80,0.54,19,0.028421053,42
3162.196796,38,70,0.91,32,0.0284375,42
3162.00791,44,61,0.5,17,0.029411765,42
3161.658204,64,75,0.3,11,0.027272727,42
3161.235846,52,57,0.13,5,0.026,42
3160.877084,60,85,0.65,25,0.026,42
3160.877084,55,91,0.94,36,0.026111111,42
3160.7737,50,77,0.95,27,0.035185185,42
3160.767708,60,65,0.18,5,0.036,42
3160.767708,56,69,0.47,13,0.036153846,42
3160.465422,64,81,0.46,17,0.027058824,42
3160.353786,63,82,0.5,19,0.026315789,42
3160.000995,39,69,0.79,30,0.026333333,42
3159.907194,38,68,0.88,30,0.029333333,42
3159.706891,56,80,0.74,24,0.030833333,42
3159.706891,55,81,0.8,26,0.030769231,42
3159.592582,41,66,0.7,25,0.028,42
3159.188001,43,64,0.61,21,0.029047619,42
3158.8787,44,59,0.47,15,0.031333333,42
3158.704025,55,65,0.36,10,0.036,42
3158.550053,59,85,0.7,26,0.026923077,42
3158.412312,53,89,0.96,36,0.026666667,42
3158.03367,54,72,0.64,18,0.035555556,42
3158.03367,53,73,0.71,20,0.0355,42
3157.906725,57,62,0.18,5,0.036,42
3157.724957,51,78,0.62,27,0.022962963,42
3157.165322,57,90,0.86,33,0.026060606,42
3157.165322,55,92,0.97,37,0.026216216,42
3156.93456,55,93,0.95,38,0.025,42
3156.735474,66,77,0.3,11,0.027272727,42
3156.735474,64,79,0.41,15,0.027333333,42
3156.735474,62,81,0.52,19,0.027368421,42
3156.457052,49,58,0.26,9,0.028888889,42
3156.335166,76,91,0.25,15,0.016666667,42
3156.256245,78,88,0.17,10,0.017,42
3156.229281,53,75,0.51,22,0.023181818,42
3156.191858,63,77,0.4,14,0.028571429,42
3156.185233,57,89,0.87,32,0.0271875,42
3156.185233,56,90,0.93,34,0.027352941,42
3155.817494,61,83,0.58,22,0.026363636,42
3155.765611,55,92,0.99,37,0.026756757,42
3155.687335,56,88,0.83,32,0.0259375,42
3155.670178,52,74,0.78,22,0.035454545,42
3155.639365,57,88,0.79,31,0.025483871,42
3154.545248,64,76,0.35,12,0.029166667,42
3154.545248,63,77,0.41,14,0.029285714,42
3154.545248,60,81,0.61,21,0.029047619,42
3154.012857,62,65,0.07,3,0.023333333,42
3153.922236,41,65,0.73,24,0.030416667,42
3153.572663,67,74,0.2,7,0.028571429,42
3152.844741,59,68,0.21,9,0.023333333,42
3151.333698,61,85,0.63,24,0.02625,42
3151.137859,55,88,0.87,33,0.026363636,42
3151.111195,45,62,0.49,17,0.028823529,42
3151.040307,60,86,0.66,26,0.025384615,42
3150.309085,44,60,0.48,16,0.03,42
3149.808025,56,71,0.35,15,0.023333333,42
3149.767903,57,86,0.76,29,0.026206897,42
3149.485271,60,79,0.56,19,0.029473684,42
3149.485271,59,80,0.62,21,0.02952381,42
3149.065228,55,96,0.87,41,0.021219512,42
3149.028235,57,87,0.83,30,0.027666667,42
3148.398218,64,76,0.34,12,0.028333333,42
3148.239314,72,95,0.39,23,0.016956522,42
3148.177801,56,89,0.85,33,0.025757576,42
3147.515477,55,90,0.95,35,0.027142857,42
3147.386576,55,90,0.89,35,0.025428571,42
3147.337462,45,59,0.43,14,0.030714286,42
3145.720728,55,86,0.83,31,0.026774194,42
3145.511255,39,68,0.84,29,0.028965517,42
3145.370731,55,95,0.98,40,0.0245,42
3144.759071,56,91,0.92,35,0.026285714,42
3144.759071,55,93,0.99,38,0.026052632,42
3144.330027,59,87,0.76,28,0.027142857,42
3144.096618,62,76,0.39,14,0.027857143,42
3144.01791,57,88,0.81,31,0.026129032,42
3144.010144,57,69,0.43,12,0.035833333,42
3143.400704,59,79,0.57,20,0.0285,42
3143.298502,55,86,0.9,31,0.029032258,42
3143.076462,47,83,0.82,36,0.022777778,42
3143.073944,68,76,0.22,8,0.0275,42
3143.073944,66,78,0.33,12,0.0275,42
3142.641991,58,85,0.7,27,0.025925926,42
3142.548218,61,84,0.63,23,0.027391304,42
3142.241552,70,75,0.13,5,0.026,42
3141.644995,45,62,0.48,17,0.028235294,42
3141.285991,39,66,0.96,27,0.035555556,42
3140.687923,53,67,0.5,14,0.035714286,42
3140.679106,59,78,0.55,19,0.028947368,42
3140.634607,55,87,0.91,32,0.0284375,42
3140.389212,62,83,0.57,21,0.027142857,42
3140.389212,58,88,0.81,30,0.027,42
3140.313201,51,75,0.84,24,0.035,42
3140.313201,50,76,0.91,26,0.035,42
3139.833232,60,83,0.6,23,0.026086957,42
3139.830953,40,66,0.76,26,0.029230769,42
3139.773902,63,79,0.46,16,0.02875,42
3139.714144,42,70,0.79,28,0.028214286,42
3138.97848,54,92,0.96,38,0.025263158,42
3138.710805,47,56,0.28,9,0.031111111,42
3138.706314,58,91,0.83,33,0.025151515,42
3138.706314,57,92,0.88,35,0.025142857,42
3138.706314,57,93,0.89,36,0.024722222,42
3138.706314,56,93,0.93,37,0.025135135,42
3138.706314,56,94,0.94,38,0.024736842,42
3138.706314,56,94,0.95,38,0.025,42
3138.544504,38,63,0.76,25,0.0304,42
3138.18023,63,81,0.47,18,0.026111111,42
3137.415256,66,76,0.26,10,0.026,42
3137.415256,63,79,0.42,16,0.02625,42
3136.741224,65,75,0.28,10,0.028,42
3136.646492,62,77,0.41,15,0.027333333,42
3136.370924,73,93,0.34,20,0.017,42
3136.365454,43,60,0.53,17,0.031176471,42
3135.987613,58,85,0.76,27,0.028148148,42
3135.987613,57,86,0.82,29,0.028275862,42
3135.987613,56,87,0.88,31,0.028387097,42
3135.882745,46,58,0.37,12,0.030833333,42
3135.470507,41,65,0.64,24,0.026666667,42
3135.4083,56,81,0.72,25,0.0288,42
3135.131402,64,75,0.32,11,0.029090909,42
3135.041133,55,89,0.89,34,0.026176471,42
3135.028187,60,77,0.49,17,0.028823529,42
3134.993467,54,92,0.97,38,0.025526316,42
3134.713084,59,87,0.72,28,0.025714286,42
3134.533244,58,84,0.74,26,0.028461538,42
3134.370369,57,89,0.86,32,0.026875,42
3133.942626,61,81,0.53,20,0.0265,42
3133.79881,63,74,0.31,11,0.028181818,42
3133.692053,57,91,0.86,34,0.025294118,42
3133.569229,46,61,0.43,15,0.028666667,42
3133.536339,50,72,0.78,22,0.035454545,42
3133.461663,62,81,0.53,19,0.027894737,42
3133.155856,70,73,0.08,3,0.026666667,42
3133.155856,67,76,0.24,9,0.026666667,42
3133.075279,51,76,0.89,25,0.0356,42
3133.046916,56,71,0.53,15,0.035333333,42
3133.046916,55,72,0.6,17,0.035294118,42
3132.862983,42,63,0.65,21,0.030952381,42
3132.846134,46,57,0.32,11,0.029090909,42
3132.843079,61,76,0.43,15,0.028666667,42
3132.293068,58,80,0.62,22,0.028181818,42
3132.012736,61,81,0.58,20,0.029,42
3131.569366,66,76,0.29,10,0.029,42
3131.444693,60,84,0.62,24,0.025833333,42
3131.444693,59,85,0.67,26,0.025769231,42
3131.012298,54,87,0.89,33,0.026969697,42
3130.898278,40,65,0.74,25,0.0296,42
3130.742662,58,88,0.82,30,0.027333333,42
3130.493705,41,63,0.66,22,0.03,42
3130.36446,54,73,0.67,19,0.035263158,42
3130.36446,53,74,0.74,21,0.035238095,42
3130.36446,52,75,0.81,23,0.035217391,42
3130.36446,51,76,0.88,25,0.0352,42
3130.36446,51,77,0.91,26,0.035,42
3130.36446,50,78,0.98,28,0.035,42
3130.118661,56,86,0.84,30,0.028,42
3129.856755,37,72,0.92,35,0.026285714,42
3129.729005,60,86,0.68,26,0.026153846,42
3129.032977,67,75,0.21,8,0.02625,42
3129.032977,64,79,0.39,15,0.026,42
3129.032977,63,80,0.44,17,0.025882353,42
3129.032977,62,81,0.49,19,0.025789474,42
3129.032977,58,86,0.72,28,0.025714286,42
3128.769414,66,75,0.24,9,0.026666667,42
3128.591516,56,91,0.94,35,0.026857143,42
3128.586489,60,86,0.73,26,0.028076923,42
3128.543435,55,73,0.42,18,0.023333333,42
3128.400753,57,81,0.68,24,0.028333333,42
3128.400753,56,82,0.74,26,0.028461538,42
3128.359647,61,81,0.57,20,0.0285,42
3128.359647,60,82,0.63,22,0.028636364,42
3128.359647,59,83,0.69,24,0.02875,42
3128.359647,58,85,0.77,27,0.028518519,42
3128.167844,69,76,0.18,7,0.025714286,42
3128.015108,56,70,0.5,14,0.035714286,42
3127.947522,40,65,0.89,25,0.0356,42
3127.889217,59,70,0.26,11,0.023636364,42
3127.570674,75,93,0.3,18,0.016666667,42
3127.478113,51,71,0.71,20,0.0355,42
3127.369051,57,79,0.68,22,0.030909091,42
3127.098234,45,60,0.43,15,0.028666667,42
3126.879814,66,78,0.31,12,0.025833333,42
3126.879814,63,82,0.49,19,0.025789474,42
3126.879814,62,83,0.54,21,0.025714286,42
3126.879814,61,84,0.59,23,0.025652174,42
3126.665001,54,91,0.96,37,0.025945946,42
3126.594761,50,78,0.99,28,0.035357143,42
3125.868498,60,79,0.52,19,0.027368421,42
3125.680273,58,79,0.61,21,0.029047619,42
3125.569339,61,82,0.55,21,0.026190476,42
3125.569339,57,87,0.78,30,0.026,42
3125.538966,54,91,0.95,37,0.025675676,42
3125.141234,56,93,0.94,37,0.025405405,42
3125.141234,55,94,0.99,39,0.025384615,42
3124.717122,53,83,0.91,30,0.030333333,42
3124.363966,50,77,0.94,27,0.034814815,42
3124.35973,58,83,0.71,25,0.0284,42
3124.354111,70,74,0.11,4,0.0275,42
3124.227701,57,85,0.74,28,0.026428571,42
3124.124152,67,77,0.26,10,0.026,42
3123.946502,67,78,0.29,11,0.026363636,42
3123.946502,64,81,0.45,17,0.026470588,42
3123.837038,57,84,0.77,27,0.028518519,42
3123.383428,58,82,0.7,24,0.029166667,42
3123.372083,39,69,0.85,30,0.028333333,42
3123.152093,37,70,0.96,33,0.029090909,42
3122.867913,60,76,0.49,16,0.030625,42
3122.867913,59,77,0.55,18,0.030555556,42
3122.709117,43,61,0.56,18,0.031111111,42
3122.246964,59,77,0.52,18,0.028888889,42
3122.206565,57,80,0.67,23,0.029130435,42
3121.583994,62,73,0.34,11,0.030909091,42
3121.583994,61,74,0.4,13,0.030769231,42
3120.849646,57,94,0.77,37,0.020810811,42
3120.678373,60,84,0.64,24,0.026666667,42
3120.218982,48,81,0.77,33,0.023333333,42
3120.053773,43,61,0.54,18,0.03,42
3119.996025,48,55,0.22,7,0.031428571,42
3119.716219,61,80,0.53,19,0.027894737,42
3119.716219,60,81,0.59,21,0.028095238,42
3119.22277,47,60,0.38,13,0.029230769,42
3118.242301,55,83,0.8,28,0.028571429,42
3118.108941,66,73,0.19,7,0.027142857,42
3118.074225,56,91,0.93,35,0.026571429,42
3117.906815,42,65,0.61,23,0.026521739,42
3117.699895,55,88,0.92,33,0.027878788,42
3117.178282,54,89,0.98,35,0.028,42
3117.134474,56,73,0.39,17,0.022941176,42
3117.103405,58,69,0.26,11,0.023636364,42
3116.970711,68,70,0.06,2,0.03,42
3116.970711,67,71,0.12,4,0.03,42
3116.822423,50,77,0.96,27,0.035555556,42
3116.814871,59,82,0.64,23,0.027826087,42
3116.794203,52,76,0.84,24,0.035,42
3116.724505,52,75,0.82,23,0.035652174,42
3116.482983,59,81,0.65,22,0.029545455,42
3115.912851,55,82,0.82,27,0.03037037,42
3115.475469,39,69,0.86,30,0.028666667,42
3115.402012,61,77,0.45,16,0.028125,42
3115.320303,40,74,0.91,34,0.026764706,42
3115.174766,64,73,0.26,9,0.028888889,42
3115.142407,42,62,0.62,20,0.031,42
3114.947447,46,55,0.32,9,0.035555556,42
3114.803745,45,56,0.39,11,0.035454545,42
3114.637482,60,88,0.71,28,0.025357143,42
3114.637482,59,89,0.76,30,0.025333333,42
3114.081286,42,62,0.6,20,0.03,42
3113.910886,48,54,0.19,6,0.031666667,42
3113.608862,44,61,0.49,17,0.028823529,42
3113.12472,61,75,0.43,14,0.030714286,42
3112.45541,67,77,0.21,10,0.021,42
3112.449661,58,78,0.61,20,0.0305,42
3112.380038,62,77,0.44,15,0.029333333,42
3112.380038,61,78,0.5,17,0.029411765,42
3112.359905,54,73,0.45,19,0.023684211,42
3112.256764,57,89,0.82,32,0.025625,42
3111.892275,57,91,0.87,34,0.025588235,42
3111.668593,65,75,0.29,10,0.029,42
3111.668593,63,78,0.43,15,0.028666667,42
3111.668593,62,79,0.49,17,0.028823529,42
3111.668593,61,80,0.55,19,0.028947368,42
3111.668593,58,84,0.75,26,0.028846154,42
3111.442423,56,86,0.85,30,0.028333333,42
3111.442423,56,87,0.87,31,0.028064516,42
3111.350665,57,80,0.66,23,0.028695652,42
3111.296513,67,75,0.23,8,0.02875,42
3111.187995,55,91,0.93,36,0.025833333,42
3111.185323,60,76,0.47,16,0.029375,42
3111.185323,59,77,0.53,18,0.029444444,42
3111.034752,61,82,0.6,21,0.028571429,42
3110.952228,57,88,0.8,31,0.025806452,42
3110.382545,54,89,0.93,35,0.026571429,42
3110.341352,65,72,0.2,7,0.028571429,42
3110.265404,64,82,0.37,18,0.020555556,42
3110.19641,62,82,0.52,20,0.026,42
3110.073676,57,79,0.67,22,0.030454545,42
3109.728397,14,45,0.15,31,0.00483871,42
3109.660485,60,87,0.69,27,0.025555556,42
3109.660485,58,90,0.81,32,0.0253125,42
3109.440746,59,76,0.53,17,0.031176471,42
3109.160254,38,70,0.92,32,0.02875,42
3108.779112,48,56,0.25,8,0.03125,42
3108.535745,46,60,0.4,14,0.028571429,42
3108.516881,65,79,0.39,14,0.027857143,42
3108.516881,59,86,0.75,27,0.027777778,42
3108.232356,57,85,0.79,28,0.028214286,42
3108.010177,73,94,0.35,21,0.016666667,42
3108.010177,71,96,0.42,25,0.0168,42
3107.970373,39,75,0.97,36,0.026944444,42
3107.894728,54,83,0.88,29,0.030344828,42
3107.885799,55,97,0.88,42,0.020952381,42
3107.430079,49,73,0.85,24,0.035416667,42
3106.919528,66,80,0.36,14,0.025714286,42
3106.917817,59,79,0.56,20,0.028,42
3106.91387,52,77,0.86,25,0.0344,42
3106.911105,51,83,0.88,32,0.0275,42
3106.675278,63,76,0.38,13,0.029230769,42
3106.675278,60,80,0.58,20,0.029,42
3106.675278,59,81,0.64,22,0.029090909,42
3106.672662,56,81,0.73,25,0.0292,42
3106.672662,55,82,0.79,27,0.029259259,42
3106.594158,48,59,0.32,11,0.029090909,42
3106.302918,63,66,0.07,3,0.023333333,42
3103.621721,47,63,0.45,16,0.028125,42
3103.326547,39,67,0.97,28,0.034642857,42
3103.162459,65,80,0.31,15,0.020666667,42
3103.04956,56,68,0.44,12,0.036666667,42
3102.231818,66,82,0.32,16,0.02,42
3101.856118,66,79,0.27,13,0.020769231,42
3101.081042,58,78,0.59,20,0.0295,42
3101.081042,57,79,0.65,22,0.029545455,42
3101.081042,56,80,0.71,24,0.029583333,42
3101.021206,58,84,0.73,26,0.028076923,42
3101.021206,56,87,0.86,31,0.027741935,42
3100.877721,53,85,0.97,32,0.0303125,42
3100.786136,60,85,0.69,25,0.0276,42
3100.734436,63,73,0.29,10,0.029,42
3100.727024,61,75,0.41,14,0.029285714,42
3100.723401,72,76,0.08,4,0.02,42
3100.637794,65,84,0.38,19,0.02,42
3100.637794,64,85,0.42,21,0.02,42
3100.637794,63,86,0.46,23,0.02,42
3100.196993,41,64,0.82,23,0.035652174,42
3099.525692,68,74,0.17,6,0.028333333,42
3099.525692,65,77,0.34,12,0.028333333,42
3099.525692,61,82,0.59,21,0.028095238,42
3099.525692,60,83,0.65,23,0.02826087,42
3099.525692,57,87,0.84,30,0.028,42
3099.525692,56,88,0.9,32,0.028125,42
3099.490258,53,84,0.91,31,0.029354839,42
3099.256681,56,92,0.93,36,0.025833333,42
3099.10314,42,70,0.8,28,0.028571429,42
3098.594737,55,82,0.83,27,0.030740741,42
3098.456878,45,66,0.57,21,0.027142857,42
3097.890208,50,71,0.75,21,0.035714286,42
3097.479928,58,84,0.71,26,0.027307692,42
3097.324275,59,65,0.22,6,0.036666667,42
3097.240271,39,68,0.83,29,0.02862069,42
3097.011054,54,91,0.94,37,0.025405405,42
3097.011054,53,92,0.99,39,0.025384615,42
3096.849241,56,80,0.73,24,0.030416667,42
3096.829613,58,78,0.58,20,0.029,42
3096.491436,13,44,0.32,31,0.010322581,42
3096.059838,76,89,0.22,13,0.016923077,42
3096.024099,43,62,0.56,19,0.029473684,42
3096.024099,42,63,0.62,21,0.02952381,42
3095.814821,58,91,0.72,33,0.021818182,42
3095.814821,56,94,0.82,38,0.021578947,42
3095.510937,54,76,0.5,22,0.022727273,42
3095.24369,61,86,0.64,25,0.0256,42
3095.201053,55,88,0.93,33,0.028181818,42
3095.180636,62,74,0.35,12,0.029166667,42
3095.090477,54,87,0.97,33,0.029393939,42
3094.812485,69,98,0.49,29,0.016896552,42
3094.459319,43,64,0.55,21,0.026190476,42
3094.166276,62,75,0.37,13,0.028461538,42
3094.077169,55,76,0.47,21,0.022380952,42
3093.940636,67,81,0.28,14,0.02,42
3093.899091,63,83,0.51,20,0.0255,42
3093.47913,61,79,0.52,18,0.028888889,42
3092.948139,45,66,0.58,21,0.027619048,42
3092.863701,60,81,0.58,21,0.027619048,42
3092.84388,46,60,0.37,14,0.026428571,42
3092.614919,60,69,0.21,9,0.023333333,42
3092.610703,58,89,0.81,31,0.026129032,42
3092.452868,41,67,0.68,26,0.026153846,42
3092.059017,52,55,0.08,3,0.026666667,42
3091.988544,48,62,0.36,14,0.025714286,42
3091.983675,64,78,0.4,14,0.028571429,42
3091.983675,59,84,0.71,25,0.0284,42
3091.898768,51,70,0.68,19,0.035789474,42
3091.790889,58,77,0.59,19,0.031052632,42
3090.902408,56,75,0.43,19,0.022631579,42
3089.676516,56,94,0.81,38,0.021315789,42
3089.628448,59,90,0.66,31,0.021290323,42
3089.628448,58,92,0.72,34,0.021176471,42
3089.628448,57,93,0.76,36,0.021111111,42
3089.628448,56,95,0.82,39,0.021025641,42
3089.47315,57,85,0.78,28,0.027857143,42
3088.837231,59,88,0.75,29,0.025862069,42
3088.506865,60,82,0.64,22,0.029090909,42
3088.506865,59,83,0.7,24,0.029166667,42
3088.506865,58,84,0.76,26,0.029230769,42
3088.351795,56,85,0.84,29,0.028965517,42
3087.608742,59,89,0.77,30,0.025666667,42
3087.608742,58,91,0.84,33,0.025454545,42
3087.608742,57,91,0.88,34,0.025882353,42
3087.608742,57,92,0.89,35,0.025428571,42
3087.608742,56,93,0.95,37,0.025675676,42
3087.608742,56,94,0.96,38,0.025263158,42
3087.411916,54,92,0.98,38,0.025789474,42
3087.320117,64,82,0.46,18,0.025555556,42
3087.268496,73,75,0.04,2,0.02,42
3087.202812,51,78,0.93,27,0.034444444,42
3087.069343,61,80,0.56,19,0.029473684,42
3087.069343,60,81,0.62,21,0.02952381,42
3086.766921,48,81,0.76,33,0.023030303,42
3086.61449,62,85,0.59,23,0.025652174,42
3086.59779,46,57,0.34,11,0.030909091,42
3086.241584,38,71,0.86,33,0.026060606,42
3086.164365,77,88,0.19,11,0.017272727,42
3086.090967,42,64,0.64,22,0.029090909,42
3086.090967,41,65,0.7,24,0.029166667,42
3085.529002,60,84,0.65,24,0.027083333,42
3085.409701,60,76,0.46,16,0.02875,42
3085.371484,12,49,0.38,37,0.01027027,42
3084.701809,70,99,0.48,29,0.016551724,42
3084.598238,65,81,0.41,16,0.025625,42
3084.294731,59,68,0.22,9,0.024444444,42
3084.069905,58,72,0.32,14,0.022857143,42
3083.792978,57,90,0.89,33,0.026969697,42
3083.792978,56,92,0.96,36,0.026666667,42
3083.528758,57,90,0.83,33,0.025151515,42
3083.528758,56,91,0.88,35,0.025142857,42
3083.433801,44,61,0.45,17,0.026470588,42
3083.392651,39,68,0.77,29,0.026551724,42
3083.363194,54,75,0.72,21,0.034285714,42
3083.363194,53,76,0.79,23,0.034347826,42
3083.213474,54,80,0.71,26,0.027307692,42
3083.110982,42,64,0.58,22,0.026363636,42
3083.100363,62,79,0.5,17,0.029411765,42
3082.998085,13,43,0.36,30,0.012,42
3082.983951,45,55,0.31,10,0.031,42
3082.855771,54,84,0.86,30,0.028666667,42
3082.797524,58,92,0.71,34,0.020882353,42
3082.775438,54,90,0.94,36,0.026111111,42
3082.68603,57,92,0.91,35,0.026,42
3081.959217,48,81,0.78,33,0.023636364,42
3081.939566,48,83,0.79,35,0.022571429,42
3081.452914,63,83,0.53,20,0.0265,42
3081.452914,61,85,0.64,24,0.026666667,42
3081.215003,58,84,0.72,26,0.027692308,42
3081.215003,55,88,0.91,33,0.027575758,42
3081.185994,66,78,0.25,12,0.020833333,42
3080.961808,57,74,0.38,17,0.022352941,42
3080.585155,51,54,0.08,3,0.026666667,42
3080.444059,58,89,0.82,31,0.026451613,42
3080.323059,62,78,0.46,16,0.02875,42
3079.9054,64,72,0.23,8,0.02875,42
3079.166914,71,74,0.08,3,0.026666667,42
3079.166914,68,77,0.24,9,0.026666667,42
3079.116226,57,83,0.77,26,0.029615385,42
3079.116226,56,84,0.83,28,0.029642857,42
3079.096153,58,79,0.64,21,0.03047619,42
3079.033356,51,76,0.59,25,0.0236,42
3078.781856,44,60,0.51,16,0.031875,42
3078.505537,56,89,0.9,33,0.027272727,42
3078.505537,55,90,0.96,35,0.027428571,42
3077.912238,51,58,0.18,7,0.025714286,42
3077.818013,43,65,0.63,22,0.028636364,42
3077.405311,42,57,0.47,15,0.031333333,42
3077.227227,60,87,0.7,27,0.025925926,42
3077.227227,58,90,0.82,32,0.025625,42
3077.023301,63,72,0.28,9,0.031111111,42
3076.921359,66,71,0.14,5,0.028,42
3076.748787,39,61,0.68,22,0.030909091,42
3076.291504,50,78,0.65,28,0.023214286,42
3076.197882,45,65,0.59,20,0.0295,42
3075.768057,70,97,0.45,27,0.016666667,42
3075.607732,59,67,0.19,8,0.02375,42
3075.549088,11,51,0.42,40,0.0105,42
3075.374501,43,68,0.72,25,0.0288,42
3075.291725,62,84,0.58,22,0.026363636,42
3075.291725,61,86,0.65,25,0.026,42
3074.426098,46,63,0.47,17,0.027647059,42
3074.310076,54,83,0.85,29,0.029310345,42
3074.029678,47,83,0.84,36,0.023333333,42
3073.916247,57,86,0.83,29,0.02862069,42
3073.916247,56,87,0.89,31,0.028709677,42
3073.916247,55,89,0.97,34,0.028529412,42
3073.213119,72,96,0.4,24,0.016666667,42
3073.096981,51,82,0.89,31,0.028709677,42
3073.096981,50,83,0.95,33,0.028787879,42
3072.867184,52,84,0.97,32,0.0303125,42
3072.7254,57,86,0.84,29,0.028965517,42
3072.51767,52,78,0.59,26,0.022692308,42
3072.465623,73,74,0.02,1,0.02,42
3072.465623,72,75,0.06,3,0.02,42
3072.465623,71,76,0.1,5,0.02,42
3072.465623,70,77,0.14,7,0.02,42
3072.255622,53,75,0.52,22,0.023636364,42
3072.189308,60,81,0.6,21,0.028571429,42
3071.610734,58,87,0.82,29,0.028275862,42
3071.538724,64,82,0.47,18,0.026111111,42
3071.339697,61,66,0.12,5,0.024,42
3071.339697,56,71,0.36,15,0.024,42
3071.274258,44,65,0.58,21,0.027619048,42
3071.235425,63,81,0.48,18,0.026666667,42
3071.235425,61,83,0.59,22,0.026818182,42
3071.21986,64,81,0.48,17,0.028235294,42
3071.190884,60,86,0.7,26,0.026923077,42
3071.190884,58,89,0.83,31,0.026774194,42
3071.190884,57,91,0.9,34,0.026470588,42
3071.168895,60,88,0.7,28,0.025,42
3071.168895,58,91,0.82,33,0.024848485,42
3071.116855,53,74,0.5,21,0.023809524,42
3070.905017,58,79,0.6,21,0.028571429,42
3070.823374,57,88,0.84,31,0.027096774,42
3070.724158,62,83,0.58,21,0.027619048,42
3070.634916,60,80,0.59,20,0.0295,42
3070.591765,59,82,0.68,23,0.029565217,42
3069.782073,59,88,0.76,29,0.026206897,42
3068.932297,56,87,0.85,31,0.027419355,42
3068.932297,55,89,0.92,34,0.027058824,42
3068.932297,54,90,0.98,36,0.027222222,42
3068.814062,57,70,0.31,13,0.023846154,42
3068.517126,54,83,0.89,29,0.030689655,42
3068.255445,61,85,0.65,24,0.027083333,42
3068.255445,58,89,0.84,31,0.027096774,42
3067.908212,12,49,0.37,37,0.01,42
3067.676531,58,68,0.24,10,0.024,42
3067.568688,42,64,0.59,22,0.026818182,42
3066.628453,63,83,0.52,20,0.026,42
3066.529289,54,90,0.99,36,0.0275,42
3066.369886,59,85,0.71,26,0.027307692,42
3066.123195,7,37,0.77,30,0.025666667,42
3065.973529,56,87,0.9,31,0.029032258,42
3065.92855,60,87,0.72,27,0.026666667,42
3065.804092,51,58,0.2,7,0.028571429,42
3065.703502,42,64,0.65,22,0.029545455,42
3065.415329,63,83,0.54,20,0.027,42
3065.415329,59,88,0.78,29,0.026896552,42
3065.415329,58,90,0.85,32,0.0265625,42
3065.415329,57,91,0.91,34,0.026764706,42
3065.215804,46,58,0.38,12,0.031666667,42
3065.104976,53,84,0.95,31,0.030645161,42
3064.99071,57,93,0.75,36,0.020833333,42
3064.719324,52,75,0.55,23,0.023913043,42
3064.450077,52,76,0.57,24,0.02375,42
3064.369516,44,60,0.5,16,0.03125,42
3064.152365,42,64,0.67,22,0.030454545,42
3064.048724,65,83,0.36,18,0.02,42
3064.048724,64,84,0.4,20,0.02,42
3063.90693,50,84,0.97,34,0.028529412,42
3063.860396,45,63,0.51,18,0.028333333,42
3063.683487,39,66,0.79,27,0.029259259,42
3063.6722,42,62,0.58,20,0.029,42
3063.590588,54,90,0.92,36,0.025555556,42
3063.434459,50,78,0.66,28,0.023571429,42
3063.088773,66,79,0.35,13,0.026923077,42
3063.088773,64,82,0.48,18,0.026666667,42
3063.088773,61,86,0.66,25,0.0264,42
3062.891258,44,64,0.57,20,0.0285,42
3062.846341,39,69,0.78,30,0.026,42
3062.681119,43,69,0.71,26,0.027307692,42
3062.662431,55,81,0.77,26,0.029615385,42
3062.622435,38,69,0.9,31,0.029032258,42
3062.514746,67,77,0.28,10,0.028,42
3062.514746,64,80,0.45,16,0.028125,42
3062.145941,44,60,0.43,16,0.026875,42
3061.993548,41,63,0.65,22,0.029545455,42
3061.84794,56,94,0.8,38,0.021052632,42
3061.597744,55,72,0.41,17,0.024117647,42
3061.542413,59,78,0.54,19,0.028421053,42
3061.488709,55,89,0.87,34,0.025588235,42
3061.370276,58,88,0.76,30,0.025333333,42
3061.233159,47,57,0.27,10,0.027,42
3061.095054,40,67,0.71,27,0.026296296,42
3061.079525,49,81,0.73,32,0.0228125,42
3061.06182,54,73,0.46,19,0.024210526,42
3061.06182,54,74,0.48,20,0.024,42
3060.96368,67,80,0.26,13,0.02,42
3060.96368,66,81,0.3,15,0.02,42
3060.603653,62,85,0.58,23,0.025217391,42
3060.277677,60,68,0.19,8,0.02375,42
3060.132168,39,75,0.96,36,0.026666667,42
3059.805635,54,74,0.47,20,0.0235,42
3059.407994,56,92,0.94,36,0.026111111,42
3059.401692,50,84,0.95,34,0.027941176,42
3059.270014,51,78,0.63,27,0.023333333,42
3059.270014,50,79,0.68,29,0.023448276,42
3059.233182,58,90,0.83,32,0.0259375,42
3059.151391,52,83,0.84,31,0.027096774,42
3058.919026,44,62,0.48,18,0.026666667,42
3058.366862,38,69,0.88,31,0.028387097,42
3058.354561,59,91,0.66,32,0.020625,42
3057.813165,65,80,0.42,15,0.028,42
3057.780822,62,82,0.57,20,0.0285,42
3057.731205,58,87,0.78,29,0.026896552,42
3057.731205,56,90,0.91,34,0.026764706,42
3057.418286,54,77,0.52,23,0.022608696,42
3057.288146,53,91,0.99,38,0.026052632,42
3057.26881,49,80,0.73,31,0.023548387,42
3056.349767,55,77,0.65,22,0.029545455,42
3056.27664,63,84,0.43,21,0.02047619,42
3056.066975,56,89,0.89,33,0.026969697,42
3056.066975,55,91,0.96,36,0.026666667,42
3055.62233,59,87,0.71,28,0.025357143,42
3055.580511,62,78,0.47,16,0.029375,42
3055.580511,61,79,0.53,18,0.029444444,42
3055.477743,57,79,0.64,22,0.029090909,42
3055.077145,40,73,0.89,33,0.026969697,42
3054.986683,67,78,0.3,11,0.027272727,42
3054.986683,65,80,0.41,15,0.027333333,42
3054.986683,63,82,0.52,19,0.027368421,42
3054.986683,60,86,0.71,26,0.027307692,42
3054.984645,38,67,0.98,29,0.033793103,42
3054.938481,57,85,0.82,28,0.029285714,42
3054.842726,69,75,0.17,6,0.028333333,42
3054.408653,50,85,0.95,35,0.027142857,42
3054.076845,46,56,0.31,10,0.031,42
3054.048775,54,89,0.99,35,0.028285714,42
3053.751394,60,87,0.71,27,0.026296296,42
3053.751394,59,89,0.78,30,0.026,42
3053.751394,57,91,0.89,34,0.026176471,42
3053.653242,11,51,0.41,40,0.01025,42
3053.59895,43,61,0.52,18,0.028888889,42
3053.596812,50,78,0.67,28,0.023928571,42
3053.387836,49,54,0.16,5,0.032,42
3053.303404,63,81,0.51,18,0.028333333,42
3053.063746,38,70,0.89,32,0.0278125,42
3052.95648,40,63,0.79,23,0.034347826,42
3052.885978,62,84,0.59,22,0.026818182,42
3052.787529,40,65,0.9,25,0.036,42
3052.748533,57,84,0.78,27,0.028888889,42
3052.699687,60,67,0.17,7,0.024285714,42
3051.928806,44,62,0.51,18,0.028333333,42
3051.854584,61,84,0.64,23,0.027826087,42
3051.757667,51,77,0.62,26,0.023846154,42
3051.712346,56,89,0.88,33,0.026666667,42
3051.593247,40,66,0.78,26,0.03,42
3051.532689,55,92,0.93,37,0.025135135,42
3051.106213,59,82,0.67,23,0.029130435,42
3051.106213,58,83,0.73,25,0.0292,42
3050.369474,66,78,0.34,12,0.028333333,42
3050.351425,59,88,0.77,29,0.026551724,42
3050.351425,57,90,0.88,33,0.026666667,42
3050.051917,55,91,0.95,36,0.026388889,42
3050.048816,52,53,0.03,1,0.03,42
3050.048816,51,54,0.09,3,0.03,42
3050.03437,41,62,0.72,21,0.034285714,42
3049.957262,62,82,0.54,20,0.027,42
3049.786127,53,76,0.53,23,0.023043478,42
3049.727238,54,82,0.86,28,0.030714286,42
3049.175128,57,69,0.29,12,0.024166667,42
3049.096442,63,84,0.53,21,0.025238095,42
3049.069379,62,82,0.53,20,0.0265,42
3049.069379,61,84,0.6,23,0.026086957,42
3049.069379,59,86,0.71,27,0.026296296,42
3049.069379,58,87,0.76,29,0.026206897,42
3049.069379,57,89,0.83,32,0.0259375,42
3049.069379,56,90,0.89,34,0.026176471,42
3049.058566,39,66,0.92,27,0.034074074,42
3048.997647,41,65,0.72,24,0.03,42
3048.897091,58,87,0.74,29,0.025517241,42
3048.831205,65,81,0.33,16,0.020625,42
3048.765232,46,85,0.89,39,0.022820513,42
3048.542975,53,83,0.92,30,0.030666667,42
3048.354414,49,61,0.31,12,0.025833333,42
3048.317807,43,62,0.51,19,0.026842105,42
3048.158961,49,79,0.72,30,0.024,42
3047.450565,42,62,0.64,20,0.032,42
3047.245025,53,79,0.58,26,0.022307692,42
3046.681441,65,81,0.42,16,0.02625,42
3046.459866,65,79,0.36,14,0.025714286,42
3046.394721,58,74,0.47,16,0.029375,42
3046.364032,55,71,0.39,16,0.024375,42
3046.066546,38,69,0.89,31,0.028709677,42
3045.596733,50,81,0.7,31,0.022580645,42
3045.204073,38,67,0.99,29,0.034137931,42
3045.186548,50,82,0.94,32,0.029375,42
3044.529105,56,70,0.34,14,0.024285714,42
3044.435165,47,57,0.29,10,0.029,42
3044.424154,60,75,0.47,15,0.031333333,42
3044.40482,45,59,0.38,14,0.027142857,42
3044.363557,39,64,0.9,25,0.036,42
3044.26641,58,87,0.75,29,0.025862069,42
3044.256962,43,57,0.43,14,0.030714286,42
3044.208309,55,89,0.96,34,0.028235294,42
3044.098271,57,70,0.46,13,0.035384615,42
3044.096574,51,69,0.65,18,0.036111111,42
3043.830506,65,77,0.35,12,0.029166667,42
3043.282422,71,98,0.45,27,0.016666667,42
3043.163088,59,87,0.79,28,0.028214286,42
3042.930749,53,77,0.55,24,0.022916667,42
3042.758849,39,65,0.77,26,0.029615385,42
3042.695865,55,91,0.97,36,0.026944444,42
3041.916014,57,80,0.7,23,0.030434783,42
3041.82848,56,88,0.82,32,0.025625,42
3041.714458,41,64,0.68,23,0.029565217,42
3041.66288,13,43,0.38,30,0.012666667,42
3041.473192,41,64,0.62,23,0.026956522,42
3041.37428,46,58,0.35,12,0.029166667,42
3041.322193,55,92,0.94,37,0.025405405,42
3041.322193,54,93,0.99,39,0.025384615,42
3041.110919,40,63,0.82,23,0.035652174,42
3041.046267,43,56,0.48,13,0.036923077,42
3041.023259,56,87,0.81,31,0.026129032,42
3041.023259,54,90,0.93,36,0.025833333,42
3040.912538,53,80,0.76,27,0.028148148,42
3040.813561,59,84,0.72,25,0.0288,42
3040.813561,58,85,0.78,27,0.028888889,42
3040.453232,51,76,0.83,25,0.0332,42
3040.241152,69,78,0.18,9,0.02,42
3040.241152,68,79,0.22,11,0.02,42
3040.229262,59,82,0.66,23,0.028695652,42
3040.229262,58,83,0.72,25,0.0288,42
3040.013972,47,56,0.29,9,0.032222222,42
3040.013972,45,58,0.42,13,0.032307692,42
3039.792719,57,88,0.82,31,0.026451613,42
3039.707756,57,88,0.83,31,0.026774194,42
3039.698372,68,75,0.19,7,0.027142857,42
3039.548061,47,84,0.84,37,0.022702703,42
3039.060835,58,84,0.68,26,0.026153846,42
3038.679027,57,86,0.75,29,0.025862069,42
3038.622089,55,91,0.91,36,0.025277778,42
3038.414733,48,82,0.78,34,0.022941176,42
3038.394061,48,59,0.3,11,0.027272727,42
3038.281882,67,77,0.27,10,0.027,42
3038.281882,65,79,0.38,14,0.027142857,42
3038.281882,63,81,0.49,18,0.027222222,42
3038.281882,61,83,0.6,22,0.027272727,42
3038.281882,59,86,0.73,27,0.027037037,42
3037.557221,53,74,0.51,21,0.024285714,42
3037.508849,52,75,0.56,23,0.024347826,42
3036.972317,41,64,0.66,23,0.028695652,42
3036.844045,45,59,0.44,14,0.031428571,42
3036.844045,43,61,0.57,18,0.031666667,42
3036.714519,39,67,0.82,28,0.029285714,42
3036.639852,50,76,0.94,26,0.036153846,42
3036.513107,39,62,0.7,23,0.030434783,42
3036.354294,63,82,0.54,19,0.028421053,42
3036.24131,64,79,0.43,15,0.028666667,42
3036.084016,43,63,0.57,20,0.0285,42
3036.061094,40,68,0.74,28,0.026428571,42
3035.693706,54,89,0.92,35,0.026285714,42
3035.577444,41,71,0.85,30,0.028333333,42
3035.287869,49,55,0.16,6,0.026666667,42
3035.23884,54,93,0.98,39,0.025128205,42
3034.993351,54,87,0.98,33,0.02969697,42
3034.980425,39,66,0.97,27,0.035925926,42
3034.8228,36,74,0.99,38,0.026052632,42
3034.478604,56,92,0.95,36,0.026388889,42
3034.371693,50,82,0.99,32,0.0309375,42
3033.528576,48,57,0.27,9,0.03,42
3032.8931,56,74,0.42,18,0.023333333,42
3032.364903,61,67,0.14,6,0.023333333,42
3032.364903,58,71,0.3,13,0.023076923,42
3032.364903,55,74,0.44,19,0.023157895,42
3032.166809,59,89,0.79,30,0.026333333,42
3031.720744,55,73,0.63,18,0.035,42
3031.622623,40,68,0.73,28,0.026071429,42
3031.566367,40,67,0.76,27,0.028148148,42
3031.333077,55,92,0.96,37,0.025945946,42
3031.3247,47,58,0.33,11,0.03,42
3031.274835,40,65,0.72,25,0.0288,42
3031.182452,38,70,0.84,32,0.02625,42
3030.885232,47,87,0.88,40,0.022,42
3030.790443,60,83,0.66,23,0.028695652,42
3030.768782,40,65,0.84,25,0.0336,42
3030.6348,56,75,0.57,19,0.03,42
3030.569357,49,79,0.98,30,0.032666667,42
3030.177938,45,60,0.4,15,0.026666667,42
3029.596911,57,89,0.81,32,0.0253125,42
3029.558236,57,92,0.9,35,0.025714286,42
3029.555231,37,71,0.97,34,0.028529412,42
3029.147735,56,91,0.98,35,0.028,42
3028.961691,52,76,0.77,24,0.032083333,42
3028.854456,43,59,0.56,16,0.035,42
3028.732157,56,93,0.97,37,0.026216216,42
3028.654238,60,87,0.73,27,0.027037037,42
3028.439581,56,87,0.8,31,0.025806452,42
3028.197485,58,69,0.39,11,0.035454545,42
3028.162039,58,69,0.27,11,0.024545455,42
3028.077948,40,67,0.72,27,0.026666667,42
3028.070366,57,89,0.85,32,0.0265625,42
3027.570554,60,70,0.31,10,0.031,42
3027.48786,60,85,0.7,25,0.028,42
3027.290593,40,64,0.71,24,0.029583333,42
3027.150746,68,76,0.21,8,0.02625,42
3027.150746,64,80,0.42,16,0.02625,42
3026.774285,60,73,0.36,13,0.027692308,42
3026.286105,45,58,0.38,13,0.029230769,42
3026.236315,51,79,0.64,28,0.022857143,42
3026.150199,56,76,0.59,20,0.0295,42
3026.126297,55,86,0.91,31,0.029354839,42
3025.974955,48,57,0.24,9,0.026666667,42
3025.911465,52,80,0.81,28,0.028928571,42
3025.896903,49,56,0.2,7,0.028571429,42
3025.788027,45,54,0.28,9,0.031111111,42
3025.680131,53,74,0.49,21,0.023333333,42
3025.667612,39,70,0.8,31,0.025806452,42
3025.260818,58,87,0.77,29,0.026551724,42
3025.241721,50,78,0.68,28,0.024285714,42
3024.789776,40,61,0.64,21,0.03047619,42
3024.546611,67,71,0.11,4,0.0275,42
3024.546611,65,73,0.22,8,0.0275,42
3024.348042,57,85,0.8,28,0.028571429,42
3024.348042,56,86,0.86,30,0.028666667,42
3024.348042,55,87,0.92,32,0.02875,42
3024.286013,65,79,0.37,14,0.026428571,42
3023.610708,44,65,0.59,21,0.028095238,42
3023.56711,37,72,0.98,35,0.028,42
3023.02592,45,64,0.54,19,0.028421053,42
3022.976874,52,75,0.54,23,0.023478261,42
3022.920711,56,93,0.96,37,0.025945946,42
3022.862529,43,60,0.58,17,0.034117647,42
3022.692607,47,54,0.22,7,0.031428571,42
3022.505656,46,84,0.9,38,0.023684211,42
3022.469873,60,85,0.67,25,0.0268,42
3022.448812,13,43,0.37,30,0.012333333,42
3022.174372,47,63,0.44,16,0.0275,42
3022.01485,64,80,0.43,16,0.026875,42
3021.890372,64,85,0.44,21,0.020952381,42
3021.754717,63,82,0.53,19,0.027894737,42
3021.483878,53,90,0.98,37,0.026486486,42
3021.305003,40,63,0.8,23,0.034782609,42
3021.134843,62,83,0.55,21,0.026190476,42
3021.134843,58,88,0.78,30,0.026,42
3021.113444,41,62,0.73,21,0.034761905,42
3021.003419,40,65,0.85,25,0.034,42
3020.914269,47,61,0.39,14,0.027857143,42
3020.808753,55,89,0.88,34,0.025882353,42
3020.655045,54,78,0.71,24,0.029583333,42
3020.655045,53,79,0.77,26,0.029615385,42
3020.651882,44,56,0.37,12,0.030833333,42
3020.599423,55,71,0.5,16,0.03125,42
3020.467297,46,62,0.46,16,0.02875,42
3020.424345,52,80,0.83,28,0.029642857,42
3020.424345,51,81,0.89,30,0.029666667,42
3020.264247,50,55,0.15,5,0.03,42
3020.264247,49,56,0.21,7,0.03,42
3020.176583,55,76,0.63,21,0.03,42
3020.115653,59,86,0.76,27,0.028148148,42
3019.991258,54,56,0.05,2,0.025,42
3019.991258,53,57,0.1,4,0.025,42
3019.991258,52,58,0.15,6,0.025,42
3019.752711,42,61,0.65,19,0.034210526,42
3019.491586,43,68,0.73,25,0.0292,42
3019.46379,49,79,0.71,30,0.023666667,42
3019.412136,50,85,0.97,35,0.027714286,42
3019.349866,51,80,0.9,29,0.031034483,42
3019.062942,53,78,0.77,25,0.0308,42
3019.062942,51,81,0.92,30,0.030666667,42
3018.83145,48,85,0.82,37,0.022162162,42
3018.617912,57,75,0.53,18,0.029444444,42
3018.032166,56,85,0.85,29,0.029310345,42
3017.977083,56,90,0.87,34,0.025588235,42
3017.964146,42,60,0.63,18,0.035,42
3017.9149,65,78,0.36,13,0.027692308,42
3017.747901,54,74,0.7,20,0.035,42
3017.747901,53,75,0.77,22,0.035,42
3017.334929,43,60,0.52,17,0.030588235,42
3017.265232,59,86,0.72,27,0.026666667,42
3017.241874,53,75,0.53,22,0.024090909,42
3016.724978,61,84,0.61,23,0.026521739,42
3016.691696,57,89,0.89,32,0.0278125,42
3016.691696,56,90,0.95,34,0.027941176,42
3016.608304,50,70,0.72,20,0.036,42
3016.237893,51,55,0.11,4,0.0275,42
3015.546553,45,65,0.55,20,0.0275,42
3015.288368,43,66,0.65,23,0.02826087,42
3015.167353,52,81,0.82,29,0.028275862,42
3015.167353,51,82,0.88,31,0.028387097,42
3015.167353,51,83,0.9,32,0.028125,42
3015.167353,50,83,0.94,33,0.028484848,42
3015.167353,50,84,0.96,34,0.028235294,42
3015.149172,44,58,0.49,14,0.035,42
3015.131421,60,84,0.66,24,0.0275,42
3015.131421,58,87,0.79,29,0.027241379,42
3015.082361,60,85,0.66,25,0.0264,42
3014.67544,37,73,0.99,36,0.0275,42
3014.626435,55,91,0.98,36,0.027222222,42
3014.352341,62,84,0.6,22,0.027272727,42
3014.249208,59,69,0.23,10,0.023,42
3014.20736,51,77,0.63,26,0.024230769,42
3014.045946,60,70,0.23,10,0.023,42
3013.77419,54,77,0.71,23,0.030869565,42
3013.77419,52,79,0.84,27,0.031111111,42
3013.77419,52,80,0.86,28,0.030714286,42
3013.724625,37,72,0.97,35,0.027714286,42
3013.676977,58,88,0.79,30,0.026333333,42
3013.676977,56,90,0.9,34,0.026470588,42
3013.416473,59,86,0.69,27,0.025555556,42
3013.416473,56,90,0.86,34,0.025294118,42
3013.244744,62,82,0.55,20,0.0275,42
3012.869542,54,75,0.48,21,0.022857143,42
3012.740064,59,86,0.74,27,0.027407407,42
3012.740064,56,89,0.91,33,0.027575758,42
3012.359833,49,80,0.99,31,0.031935484,42
3012.338927,56,90,0.92,34,0.027058824,42
3012.154834,38,69,0.87,31,0.028064516,42
3012.14296,42,61,0.66,19,0.034736842,42
3011.75356,50,83,0.98,33,0.02969697,42
3011.498551,51,78,0.94,27,0.034814815,42
3011.208133,39,65,0.92,26,0.035384615,42
3011.200434,56,90,0.96,34,0.028235294,42
3011.092845,64,80,0.41,16,0.025625,42
3010.519666,41,63,0.71,22,0.032272727,42
3010.408042,42,64,0.63,22,0.028636364,42
3010.316017,56,88,0.91,32,0.0284375,42
3009.987825,43,61,0.58,18,0.032222222,42
3009.775901,49,83,0.76,34,0.022352941,42
3009.446911,51,76,0.61,25,0.0244,42
3009.149033,56,88,0.92,32,0.02875,42
3008.984551,53,81,0.78,28,0.027857143,42
3008.586131,53,85,0.92,32,0.02875,42
3008.445014,41,64,0.72,23,0.031304348,42
3008.389485,51,76,0.6,25,0.024,42
3008.351524,52,84,0.86,32,0.026875,42
3008.351524,52,85,0.88,33,0.026666667,42
3008.292985,55,88,0.97,33,0.029393939,42
3008.171715,58,90,0.84,32,0.02625,42
3008.044714,51,85,0.93,34,0.027352941,42
3008.006263,69,75,0.16,6,0.026666667,42
3008.006263,66,78,0.32,12,0.026666667,42
3007.750133,52,77,0.87,25,0.0348,42
3007.509429,53,91,0.98,38,0.025789474,42
3007.190406,69,74,0.14,5,0.028,42
3007.190406,64,79,0.42,15,0.028,42
3007.080919,49,57,0.23,8,0.02875,42
3006.939249,52,75,0.71,23,0.030869565,42
3006.289321,59,87,0.77,28,0.0275,42
3006.288883,66,79,0.36,13,0.027692308,42
3006.22585,50,86,0.97,36,0.026944444,42
3006.175312,54,94,0.89,40,0.02225,42
3006.123895,55,82,0.78,27,0.028888889,42
3005.936753,55,74,0.45,19,0.023684211,42
3005.869911,55,84,0.81,29,0.027931034,42
3005.857081,59,91,0.68,32,0.02125,42
3005.675105,55,91,0.92,36,0.025555556,42
3005.61139,39,69,0.84,30,0.028,42
3004.987959,48,54,0.21,6,0.035,42
3004.987959,47,55,0.28,8,0.035,42
3004.987959,46,56,0.35,10,0.035,42
3004.987959,45,57,0.42,12,0.035,42
3004.982743,51,84,0.9,33,0.027272727,42
3004.748561,58,91,0.71,33,0.021515152,42
3004.439222,60,89,0.64,29,0.022068966,42
3004.041173,65,66,0.03,1,0.03,42
3004.041173,64,67,0.09,3,0.03,42
3004.041173,63,68,0.15,5,0.03,42
3004.041173,62,69,0.21,7,0.03,42
3004.041173,61,70,0.27,9,0.03,42
3004.041173,60,71,0.33,11,0.03,42
3004.041173,59,72,0.39,13,0.03,42
3004.041173,58,73,0.45,15,0.03,42
3004.041173,57,74,0.51,17,0.03,42
3003.768873,56,73,0.36,17,0.021176471,42
3003.494227,55,78,0.64,23,0.027826087,42
3003.415277,46,59,0.35,13,0.026923077,42
3003.34987,39,65,0.88,26,0.033846154,42
3003.274239,42,65,0.65,23,0.02826087,42
3002.907699,58,73,0.46,15,0.030666667,42
3002.907699,57,74,0.52,17,0.030588235,42
3002.871779,49,78,0.97,29,0.033448276,42
3002.723862,41,71,0.84,30,0.028,42
3002.562443,47,85,0.85,38,0.022368421,42
3002.532458,55,89,0.98,34,0.028823529,42
3002.278417,39,67,0.8,28,0.028571429,42
3002.17262,53,76,0.49,23,0.021304348,42
3002.070715,53,81,0.77,28,0.0275,42
3002.070715,52,82,0.83,30,0.027666667,42
3002.070715,51,83,0.89,32,0.0278125,42
3002.067909,78,90,0.2,12,0.016666667,42
3001.942011,44,67,0.64,23,0.027826087,42
3001.87289,54,80,0.75,26,0.028846154,42
3001.826214,40,60,0.62,20,0.031,42
3001.764378,67,73,0.16,6,0.026666667,42
3001.764378,64,76,0.32,12,0.026666667,42
3001.627188,48,81,0.79,33,0.023939394,42
3001.612467,73,96,0.38,23,0.016521739,42
3001.17203,44,66,0.65,22,0.029545455,42
3001.145971,43,62,0.55,19,0.028947368,42
3001.010891,51,82,0.94,31,0.030322581,42
3000.751801,55,76,0.48,21,0.022857143,42
3000.69105,60,85,0.64,25,0.0256,42
3000.420409,58,70,0.29,12,0.024166667,42
3000.419212,60,85,0.68,25,0.0272,42
3000.418736,51,76,0.78,25,0.0312,42
3000.288735,54,72,0.43,18,0.023888889,42
3000.206368,67,76,0.25,9,0.027777778,42
3000.206368,64,80,0.44,16,0.0275,42
