% profit,ema1,ema2,threshold,diff,thresh / diff,ID
3996.456753,58,67,0.31,9,0.034444444,38
3977.301182,55,71,0.55,16,0.034375,38
3969.489536,59,66,0.24,7,0.034285714,38
3965.447703,57,68,0.38,11,0.034545455,38
3965.447703,56,69,0.45,13,0.034615385,38
3940.916387,56,70,0.48,14,0.034285714,38
3935.922534,57,69,0.41,12,0.034166667,38
3899.177965,54,72,0.62,18,0.034444444,38
3863.93849,58,68,0.34,10,0.034,38
3804.643006,61,66,0.17,5,0.034,38
3792.997107,58,69,0.37,11,0.033636364,38
3777.173486,60,67,0.24,7,0.034285714,38
3752.134982,57,70,0.44,13,0.033846154,38
3748.613722,56,71,0.51,15,0.034,38
3729.828011,55,73,0.61,18,0.033888889,38
3679.543118,55,72,0.58,17,0.034117647,38
3679.543118,54,73,0.65,19,0.034210526,38
3639.266832,54,74,0.68,20,0.034,38
3639.266832,53,75,0.75,22,0.034090909,38
3627.948712,59,71,0.39,12,0.0325,38
3605.062425,63,75,0.34,12,0.028333333,38
3597.045551,61,68,0.23,7,0.032857143,38
3595.219217,56,68,0.42,12,0.035,38
3592.305951,61,63,0.07,2,0.035,38
3578.428729,55,76,0.69,21,0.032857143,38
3568.619188,62,76,0.4,14,0.028571429,38
3561.5264,58,71,0.43,13,0.033076923,38
3552.024686,64,73,0.26,9,0.028888889,38
3549.953791,63,67,0.13,4,0.0325,38
3549.953791,61,69,0.26,8,0.0325,38
3548.947837,60,78,0.52,18,0.028888889,38
3547.864689,61,76,0.44,15,0.029333333,38
3545.970588,60,64,0.14,4,0.035,38
3545.970588,59,65,0.21,6,0.035,38
3545.970588,58,66,0.28,8,0.035,38
3545.970588,57,67,0.35,10,0.035,38
3545.303358,57,71,0.47,14,0.033571429,38
3545.303358,54,75,0.7,21,0.033333333,38
3543.549174,60,77,0.5,17,0.029411765,38
3542.034281,55,84,0.83,29,0.02862069,38
3541.681054,60,69,0.3,9,0.033333333,38
3541.681054,55,75,0.66,20,0.033,38
3541.619951,57,72,0.5,15,0.033333333,38
3541.463222,60,68,0.27,8,0.03375,38
3540.534742,56,74,0.59,18,0.032777778,38
3536.390426,63,74,0.32,11,0.029090909,38
3534.539904,61,71,0.32,10,0.032,38
3533.911944,59,69,0.34,10,0.034,38
3531.107455,59,78,0.56,19,0.029473684,38
3530.369426,58,73,0.49,15,0.032666667,38
3529.052616,62,75,0.38,13,0.029230769,38
3529.052616,59,79,0.58,20,0.029,38
3529.052616,58,80,0.64,22,0.029090909,38
3528.254416,56,73,0.57,17,0.033529412,38
3526.812895,55,74,0.63,19,0.033157895,38
3526.805714,61,67,0.2,6,0.033333333,38
3526.642023,53,78,0.82,25,0.0328,38
3526.036667,63,66,0.1,3,0.033333333,38
3524.759356,57,81,0.7,24,0.029166667,38
3524.416891,55,69,0.49,14,0.035,38
3524.416891,54,70,0.56,16,0.035,38
3519.404831,54,77,0.75,23,0.032608696,38
3517.902125,55,70,0.52,15,0.034666667,38
3515.691404,60,71,0.36,11,0.032727273,38
3515.565409,53,76,0.77,23,0.033478261,38
3514.947724,58,72,0.46,14,0.032857143,38
3510.93021,60,78,0.51,18,0.028333333,38
3509.282171,63,69,0.19,6,0.031666667,38
3506.784836,57,81,0.69,24,0.02875,38
3506.784836,54,85,0.89,31,0.028709677,38
3506.115604,62,69,0.23,7,0.032857143,38
3503.629137,59,79,0.57,20,0.0285,38
3503.629137,58,80,0.63,22,0.028636364,38
3503.096127,61,77,0.46,16,0.02875,38
3502.517919,53,86,0.95,33,0.028787879,38
3501.4397,56,72,0.54,16,0.03375,38
3498.350087,57,73,0.53,16,0.033125,38
3495.07376,57,82,0.7,25,0.028,38
3494.837632,56,75,0.62,19,0.032631579,38
3492.094689,51,79,0.94,28,0.033571429,38
3487.415849,58,70,0.4,12,0.033333333,38
3485.540083,56,82,0.76,26,0.029230769,38
3485.540083,55,83,0.82,28,0.029285714,38
3483.757319,58,74,0.51,16,0.031875,38
3479.546755,61,77,0.45,16,0.028125,38
3475.412864,55,84,0.82,29,0.028275862,38
3475.107356,52,72,0.72,20,0.036,38
3472.953681,52,78,0.87,26,0.033461538,38
3472.479908,65,72,0.2,7,0.028571429,38
3468.626485,55,68,0.47,13,0.036153846,38
3467.425146,59,70,0.37,11,0.033636364,38
3467.04942,54,85,0.9,31,0.029032258,38
3467.04942,53,86,0.96,33,0.029090909,38
3465.490997,54,76,0.73,22,0.033181818,38
3464.081565,66,72,0.17,6,0.028333333,38
3459.712379,56,83,0.76,27,0.028148148,38
3457.036046,54,75,0.71,21,0.033809524,38
3457.029002,53,76,0.78,23,0.033913043,38
3455.754466,60,77,0.49,17,0.028823529,38
3452.640183,55,74,0.64,19,0.033684211,38
3449.638349,61,70,0.29,9,0.032222222,38
3449.638349,59,72,0.42,13,0.032307692,38
3448.581234,54,71,0.59,17,0.034705882,38
3448.581234,53,72,0.66,19,0.034736842,38
3448.260073,63,68,0.16,5,0.032,38
3440.43841,56,82,0.75,26,0.028846154,38
3437.622801,53,77,0.8,24,0.033333333,38
3437.340761,61,76,0.43,15,0.028666667,38
3429.025025,58,81,0.65,23,0.02826087,38
3429.025025,57,82,0.71,25,0.0284,38
3428.942759,58,80,0.62,22,0.028181818,38
3428.942759,57,81,0.68,24,0.028333333,38
3419.584453,54,84,0.88,30,0.029333333,38
3416.885686,64,75,0.32,11,0.029090909,38
3416.106603,53,85,0.94,32,0.029375,38
3414.890552,57,74,0.55,17,0.032352941,38
3412.680231,58,65,0.25,7,0.035714286,38
3411.743934,61,79,0.51,18,0.028333333,38
3409.74096,55,86,0.9,31,0.029032258,38
3409.643523,56,82,0.74,26,0.028461538,38
3409.643523,54,85,0.88,31,0.028387097,38
3409.643523,53,86,0.94,33,0.028484848,38
3407.589453,54,88,0.96,34,0.028235294,38
3407.231208,60,70,0.33,10,0.033,38
3406.175496,57,80,0.66,23,0.028695652,38
3406.175496,55,83,0.8,28,0.028571429,38
3404.258481,55,81,0.77,26,0.029615385,38
3404.258481,54,82,0.83,28,0.029642857,38
3404.194465,59,81,0.64,22,0.029090909,38
3399.717414,64,76,0.34,12,0.028333333,38
3399.365741,53,87,0.97,34,0.028529412,38
3398.749073,58,82,0.69,24,0.02875,38
3398.749073,57,83,0.75,26,0.028846154,38
3398.749073,56,85,0.83,29,0.02862069,38
3398.749073,55,86,0.89,31,0.028709677,38
3392.257596,59,77,0.53,18,0.029444444,38
3392.257596,58,78,0.59,20,0.0295,38
3392.257596,57,79,0.65,22,0.029545455,38
3392.257596,56,80,0.71,24,0.029583333,38
3389.945833,54,76,0.74,22,0.033636364,38
3389.739379,54,70,0.57,16,0.035625,38
3389.635243,59,78,0.55,19,0.028947368,38
3389.635243,58,79,0.61,21,0.029047619,38
3389.635243,55,83,0.81,28,0.028928571,38
3388.936496,64,74,0.28,10,0.028,38
3386.227669,56,74,0.6,18,0.033333333,38
3386.227669,55,75,0.67,20,0.0335,38
3386.186987,61,75,0.41,14,0.029285714,38
3386.186987,60,76,0.47,16,0.029375,38
3386.186987,57,80,0.67,23,0.029130435,38
3386.186987,56,81,0.73,25,0.0292,38
3386.186987,55,82,0.79,27,0.029259259,38
3386.186987,54,83,0.85,29,0.029310345,38
3386.186987,54,84,0.87,30,0.029,38
3386.123301,54,87,0.95,33,0.028787879,38
3386.090208,53,71,0.64,18,0.035555556,38
3385.308847,56,83,0.77,27,0.028518519,38
3385.001237,62,68,0.2,6,0.033333333,38
3385.001237,59,71,0.4,12,0.033333333,38
3383.886916,60,80,0.57,20,0.0285,38
3382.639061,42,64,0.72,22,0.032727273,38
3382.616904,58,71,0.44,13,0.033846154,38
3382.356764,40,66,0.86,26,0.033076923,38
3382.306166,53,72,0.67,19,0.035263158,38
3382.062741,53,84,0.91,31,0.029354839,38
3382.062741,53,85,0.93,32,0.0290625,38
3382.062741,52,86,0.99,34,0.029117647,38
3379.765391,65,74,0.26,9,0.028888889,38
3379.765391,59,81,0.63,22,0.028636364,38
3377.022738,62,76,0.39,14,0.027857143,38
3375.603659,52,79,0.89,27,0.032962963,38
3375.347471,52,84,0.95,32,0.0296875,38
3373.813338,41,65,0.79,24,0.032916667,38
3373.712256,49,77,0.99,28,0.035357143,38
3373.413587,60,81,0.59,21,0.028095238,38
3371.730893,57,84,0.78,27,0.028888889,38
3371.432476,56,85,0.84,29,0.028965517,38
3371.432476,54,88,0.98,34,0.028823529,38
3371.405567,53,73,0.69,20,0.0345,38
3370.127596,60,79,0.53,19,0.027894737,38
3370.127596,57,83,0.72,26,0.027692308,38
3369.304452,59,82,0.65,23,0.02826087,38
3369.304452,56,86,0.84,30,0.028,38
3369.304452,55,87,0.9,32,0.028125,38
3367.047705,56,87,0.87,31,0.028064516,38
3366.97551,55,86,0.88,31,0.028387097,38
3366.700964,49,76,0.97,27,0.035925926,38
3365.97119,55,82,0.78,27,0.028888889,38
3365.94652,60,80,0.58,20,0.029,38
3365.810553,66,73,0.2,7,0.028571429,38
3361.98351,51,78,0.91,27,0.033703704,38
3361.518335,67,73,0.17,6,0.028333333,38
3361.299887,57,85,0.79,28,0.028214286,38
3361.094793,59,79,0.56,20,0.028,38
3360.560564,62,78,0.46,16,0.02875,38
3360.560564,61,79,0.52,18,0.028888889,38
3360.560564,57,84,0.77,27,0.028518519,38
3360.560564,56,86,0.85,30,0.028333333,38
3360.560564,55,87,0.91,32,0.0284375,38
3360.146773,58,83,0.7,25,0.028,38
3358.214578,65,75,0.28,10,0.028,38
3357.926477,51,74,0.81,23,0.035217391,38
3357.905653,54,89,0.93,35,0.026571429,38
3357.705115,52,77,0.84,25,0.0336,38
3353.827145,58,83,0.72,25,0.0288,38
3353.106664,57,84,0.76,27,0.028148148,38
3352.440349,56,67,0.4,11,0.036363636,38
3349.021553,56,85,0.82,29,0.028275862,38
3348.072601,54,88,0.97,34,0.028529412,38
3343.889013,50,75,0.9,25,0.036,38
3342.193588,62,78,0.45,16,0.028125,38
3341.784087,63,77,0.4,14,0.028571429,38
3341.784087,58,83,0.71,25,0.0284,38
3340.531024,63,78,0.42,15,0.028,38
3340.531024,59,83,0.67,24,0.027916667,38
3340.531024,57,85,0.78,28,0.027857143,38
3339.835654,59,80,0.61,21,0.029047619,38
3339.447725,50,75,0.89,25,0.0356,38
3339.151926,55,89,0.94,34,0.027647059,38
3336.917094,61,80,0.52,19,0.027368421,38
3336.917094,59,82,0.63,23,0.027391304,38
3336.46079,58,84,0.73,26,0.028076923,38
3336.46079,55,88,0.92,33,0.027878788,38
3336.46079,54,89,0.98,35,0.028,38
3335.995194,59,80,0.59,21,0.028095238,38
3335.995194,56,84,0.78,28,0.027857143,38
3334.525875,53,83,0.89,30,0.029666667,38
3333.579239,63,78,0.41,15,0.027333333,38
3333.521629,57,85,0.76,28,0.027142857,38
3333.520389,55,88,0.93,33,0.028181818,38
3332.425771,54,83,0.84,29,0.028965517,38
3331.88786,51,76,0.86,25,0.0344,38
3331.856976,52,73,0.74,21,0.035238095,38
3330.025416,63,77,0.39,14,0.027857143,38
3328.748384,62,79,0.48,17,0.028235294,38
3328.680593,54,70,0.58,16,0.03625,38
3327.79968,61,80,0.54,19,0.028421053,38
3327.79968,60,81,0.6,21,0.028571429,38
3325.422837,60,82,0.61,22,0.027727273,38
3325.422837,58,85,0.74,27,0.027407407,38
3325.422837,57,86,0.8,29,0.027586207,38
3324.979941,55,83,0.79,28,0.028214286,38
3324.262216,55,85,0.84,30,0.028,38
3324.262216,54,86,0.89,32,0.0278125,38
3324.262216,54,86,0.9,32,0.028125,38
3324.262216,54,87,0.91,33,0.027575758,38
3324.262216,53,88,0.97,35,0.027714286,38
3323.86536,54,69,0.54,15,0.036,38
3323.661058,50,74,0.87,24,0.03625,38
3321.370476,56,87,0.86,31,0.027741935,38
3321.130005,59,82,0.66,23,0.028695652,38
3321.130005,54,89,0.99,35,0.028285714,38
3321.024554,53,85,0.92,32,0.02875,38
3320.468498,62,79,0.47,17,0.027647059,38
3319.698591,60,82,0.62,22,0.028181818,38
3315.087668,58,72,0.47,14,0.033571429,38
3314.816867,59,82,0.64,23,0.027826087,38
3314.532382,50,75,0.88,25,0.0352,38
3314.011369,62,76,0.41,14,0.029285714,38
3314.011369,58,81,0.67,23,0.029130435,38
3314.011369,57,82,0.73,25,0.0292,38
3312.439414,57,67,0.36,10,0.036,38
3312.271848,55,69,0.51,14,0.036428571,38
3310.884827,54,94,0.98,40,0.0245,38
3309.997256,55,67,0.44,12,0.036666667,38
3309.60402,59,64,0.18,5,0.036,38
3309.370968,54,85,0.87,31,0.028064516,38
3309.370968,53,86,0.93,33,0.028181818,38
3309.15267,52,73,0.76,21,0.036190476,38
3309.15267,51,74,0.83,23,0.036086957,38
3308.398518,53,87,0.96,34,0.028235294,38
3307.870801,52,86,0.98,34,0.028823529,38
3307.351125,61,80,0.53,19,0.027894737,38
3307.293611,65,77,0.33,12,0.0275,38
3306.696419,55,85,0.87,30,0.029,38
3305.75815,61,81,0.55,20,0.0275,38
3305.739207,54,88,0.95,34,0.027941176,38
3304.549833,51,72,0.76,21,0.036190476,38
3303.918829,52,71,0.69,19,0.036315789,38
3303.168452,60,81,0.58,21,0.027619048,38
3303.168452,58,83,0.69,25,0.0276,38
3303.168452,57,84,0.75,27,0.027777778,38
3303.168452,56,86,0.82,30,0.027333333,38
3303.168452,55,87,0.88,32,0.0275,38
3303.168452,54,88,0.94,34,0.027647059,38
3302.772269,58,81,0.63,23,0.027391304,38
3302.447579,52,85,0.95,33,0.028787879,38
3301.721167,55,87,0.89,32,0.0278125,38
3301.691386,56,83,0.79,27,0.029259259,38
3301.691386,54,86,0.93,32,0.0290625,38
3301.691386,53,87,0.99,34,0.029117647,38
3301.521486,53,84,0.9,31,0.029032258,38
3301.402536,56,84,0.81,28,0.028928571,38
3300.777716,59,68,0.31,9,0.034444444,38
3300.585845,59,83,0.68,24,0.028333333,38
3299.806328,54,89,0.95,35,0.027142857,38
3299.749285,55,88,0.89,33,0.026969697,38
3299.119959,53,72,0.68,19,0.035789474,38
3298.739522,49,75,0.94,26,0.036153846,38
3297.947642,50,74,0.86,24,0.035833333,38
3297.497401,52,85,0.97,33,0.029393939,38
3297.35711,58,82,0.66,24,0.0275,38
3296.587668,63,79,0.44,16,0.0275,38
3296.111964,55,82,0.82,27,0.03037037,38
3295.993436,55,89,0.93,34,0.027352941,38
3295.681305,64,76,0.32,12,0.026666667,38
3294.166342,51,73,0.79,22,0.035909091,38
3294.054869,51,74,0.82,23,0.035652174,38
3293.515856,64,78,0.39,14,0.027857143,38
3291.938535,55,84,0.84,29,0.028965517,38
3291.795828,55,88,0.87,33,0.026363636,38
3291.795828,54,90,0.94,36,0.026111111,38
3289.104299,58,81,0.64,23,0.027826087,38
3289.104299,55,85,0.83,30,0.027666667,38
3288.087163,64,77,0.36,13,0.027692308,38
3287.506951,61,82,0.57,21,0.027142857,38
3287.502481,49,74,0.91,25,0.0364,38
3287.496285,58,85,0.75,27,0.027777778,38
3287.496285,57,86,0.81,29,0.027931034,38
3286.953892,61,78,0.49,17,0.028823529,38
3286.805386,58,66,0.29,8,0.03625,38
3286.276672,51,75,0.84,24,0.035,38
3285.75607,56,84,0.77,28,0.0275,38
3283.95837,50,77,0.96,27,0.035555556,38
3283.579106,57,85,0.77,28,0.0275,38
3283.579106,54,89,0.96,35,0.027428571,38
3282.947041,60,79,0.55,19,0.028947368,38
3282.556983,56,90,0.85,34,0.025,38
3281.56625,63,76,0.36,13,0.027692308,38
3280.30751,53,71,0.65,18,0.036111111,38
3280.271343,56,88,0.87,32,0.0271875,38
3279.091198,59,84,0.68,25,0.0272,38
3278.435128,54,90,0.99,36,0.0275,38
3278.225468,66,73,0.19,7,0.027142857,38
3278.225468,59,81,0.6,22,0.027272727,38
3278.114472,53,90,0.99,37,0.026756757,38
3277.869763,63,75,0.35,12,0.029166667,38
3277.352157,60,76,0.49,16,0.030625,38
3277.120255,51,77,0.91,26,0.035,38
3276.615607,62,80,0.5,18,0.027777778,38
3276.615607,60,83,0.63,23,0.027391304,38
3276.615607,59,84,0.69,25,0.0276,38
3275.89527,61,81,0.56,20,0.028,38
3275.09397,58,84,0.72,26,0.027692308,38
3275.085825,56,86,0.83,30,0.027666667,38
3274.50514,57,83,0.74,26,0.028461538,38
3274.365945,56,83,0.75,27,0.027777778,38
3274.365945,55,84,0.81,29,0.027931034,38
3273.973405,68,73,0.14,5,0.028,38
3273.003056,52,72,0.71,20,0.0355,38
3271.78745,58,69,0.38,11,0.034545455,38
3271.222087,50,76,0.91,26,0.035,38
3271.031591,56,82,0.73,26,0.028076923,38
3270.893857,53,85,0.91,32,0.0284375,38
3270.893857,52,86,0.97,34,0.028529412,38
3270.838427,68,72,0.11,4,0.0275,38
3270.838427,66,74,0.22,8,0.0275,38
3270.838427,64,76,0.33,12,0.0275,38
3270.062268,49,76,0.96,27,0.035555556,38
3269.820635,58,83,0.67,25,0.0268,38
3269.618876,61,78,0.48,17,0.028235294,38
3269.489303,49,77,0.98,28,0.035,38
3268.868393,50,78,0.98,28,0.035,38
3268.101825,55,70,0.54,15,0.036,38
3268.101825,51,75,0.86,24,0.035833333,38
3268.101825,50,76,0.93,26,0.035769231,38
3267.659564,67,72,0.14,5,0.028,38
3266.805214,58,79,0.63,21,0.03,38
3266.143295,57,87,0.77,30,0.025666667,38
3266.023196,58,84,0.71,26,0.027307692,38
3266.006056,66,75,0.25,9,0.027777778,38
3264.84305,58,84,0.7,26,0.026923077,38
3264.190333,67,73,0.16,6,0.026666667,38
3263.951392,59,83,0.65,24,0.027083333,38
3263.477914,66,74,0.23,8,0.02875,38
3263.165424,60,65,0.18,5,0.036,38
3263.018724,59,83,0.66,24,0.0275,38
3262.49352,54,83,0.89,29,0.030689655,38
3262.418702,65,76,0.31,11,0.028181818,38
3261.619062,62,77,0.42,15,0.028,38
3261.466704,67,69,0.06,2,0.03,38
3261.466704,66,70,0.12,4,0.03,38
3261.466704,65,71,0.18,6,0.03,38
3261.466704,64,72,0.24,8,0.03,38
3259.198458,56,68,0.43,12,0.035833333,38
3258.907374,55,87,0.92,32,0.02875,38
3258.898402,59,80,0.6,21,0.028571429,38
3258.860047,52,83,0.97,31,0.031290323,38
3258.189922,54,71,0.61,17,0.035882353,38
3257.796907,60,80,0.54,20,0.027,38
3256.259168,54,73,0.68,19,0.035789474,38
3256.179417,61,78,0.47,17,0.027647059,38
3256.091463,54,84,0.85,30,0.028333333,38
3256.091463,52,87,0.99,35,0.028285714,38
3255.3085,57,80,0.69,23,0.03,38
3255.151176,53,70,0.61,17,0.035882353,38
3255.151176,51,73,0.78,22,0.035454545,38
3255.02009,53,85,0.96,32,0.03,38
3253.77372,54,89,0.97,35,0.027714286,38
3252.863716,64,75,0.3,11,0.027272727,38
3252.863716,62,77,0.41,15,0.027333333,38
3252.726089,53,86,0.92,33,0.027878788,38
3252.726089,52,87,0.98,35,0.028,38
3252.003705,43,64,0.67,21,0.031904762,38
3251.676581,52,85,0.96,33,0.029090909,38
3251.547,57,86,0.79,29,0.027241379,38
3251.547,55,88,0.9,33,0.027272727,38
3250.651104,55,90,0.95,35,0.027142857,38
3249.422597,65,76,0.3,11,0.027272727,38
3249.422597,59,84,0.67,25,0.0268,38
3249.242361,64,75,0.31,11,0.028181818,38
3248.769655,55,92,0.92,37,0.024864865,38
3248.235875,60,83,0.62,23,0.026956522,38
3248.235875,58,85,0.73,27,0.027037037,38
3248.235875,57,87,0.8,30,0.026666667,38
3248.235875,56,87,0.84,31,0.027096774,38
3248.235875,56,88,0.86,32,0.026875,38
3248.235875,55,89,0.91,34,0.026764706,38
3248.235875,55,89,0.92,34,0.027058824,38
3248.235875,54,90,0.97,36,0.026944444,38
3248.210564,54,86,0.86,32,0.026875,38
3248.210564,53,87,0.91,34,0.026764706,38
3247.829117,49,75,0.93,26,0.035769231,38
3246.761852,50,73,0.83,23,0.036086957,38
3246.420607,63,76,0.37,13,0.028461538,38
3246.420607,58,82,0.68,24,0.028333333,38
3246.030671,52,73,0.75,21,0.035714286,38
3244.902055,52,88,0.97,36,0.026944444,38
3244.718988,59,80,0.58,21,0.027619048,38
3243.834604,51,75,0.85,24,0.035416667,38
3243.712843,56,89,0.88,33,0.026666667,38
3243.214853,52,74,0.78,22,0.035454545,38
3242.216879,52,74,0.76,22,0.034545455,38
3241.414609,57,83,0.71,26,0.027307692,38
3241.290923,61,79,0.5,18,0.027777778,38
3241.290923,59,81,0.61,22,0.027727273,38
3241.100619,53,87,0.95,34,0.027941176,38
3240.892621,55,88,0.94,33,0.028484848,38
3240.872021,57,68,0.39,11,0.035454545,38
3240.799467,64,78,0.38,14,0.027142857,38
3240.308865,58,67,0.32,9,0.035555556,38
3240.069088,66,75,0.26,9,0.028888889,38
3239.951353,62,78,0.43,16,0.026875,38
3239.55551,48,75,0.98,27,0.036296296,38
3239.163098,53,75,0.76,22,0.034545455,38
3239.163098,52,76,0.83,24,0.034583333,38
3239.163098,51,77,0.9,26,0.034615385,38
3239.163098,50,78,0.97,28,0.034642857,38
3238.263011,55,69,0.5,14,0.035714286,38
3238.206107,54,85,0.86,31,0.027741935,38
3237.89149,56,84,0.8,28,0.028571429,38
3237.89149,54,87,0.94,33,0.028484848,38
3237.555961,40,66,0.87,26,0.033461538,38
3236.792865,59,77,0.55,18,0.030555556,38
3235.989735,53,87,0.92,34,0.027058824,38
3234.908162,53,87,0.93,34,0.027352941,38
3234.908162,52,88,0.99,36,0.0275,38
3234.907484,53,85,0.9,32,0.028125,38
3234.907484,52,86,0.96,34,0.028235294,38
3234.590993,60,80,0.56,20,0.028,38
3234.535044,57,83,0.73,26,0.028076923,38
3234.516513,52,87,0.97,35,0.027714286,38
3234.157291,60,82,0.6,22,0.027272727,38
3233.967245,55,83,0.83,28,0.029642857,38
3233.744046,57,69,0.43,12,0.035833333,38
3233.371145,61,79,0.48,18,0.026666667,38
3233.315151,62,81,0.51,19,0.026842105,38
3231.930126,55,71,0.57,16,0.035625,38
3231.930126,54,72,0.64,18,0.035555556,38
3231.930126,53,73,0.71,20,0.0355,38
3230.863346,62,80,0.49,18,0.027222222,38
3230.863346,57,86,0.78,29,0.026896552,38
3230.719355,52,89,0.97,37,0.026216216,38
3230.22002,62,79,0.49,17,0.028823529,38
3230.041487,63,78,0.39,15,0.026,38
3229.933767,59,83,0.69,24,0.02875,38
3229.933767,58,84,0.75,26,0.028846154,38
3229.933767,57,86,0.83,29,0.02862069,38
3229.933767,56,87,0.89,31,0.028709677,38
3229.556406,55,91,0.98,36,0.027222222,38
3226.993359,50,77,0.95,27,0.035185185,38
3226.883645,57,82,0.69,25,0.0276,38
3226.389288,65,73,0.23,8,0.02875,38
3226.37673,53,74,0.74,21,0.035238095,38
3226.37673,52,75,0.81,23,0.035217391,38
3226.37673,51,76,0.88,25,0.0352,38
3226.11727,62,64,0.07,2,0.035,38
3226.11727,61,65,0.14,4,0.035,38
3226.11727,60,66,0.21,6,0.035,38
3226.11727,59,67,0.28,8,0.035,38
3226.11727,58,68,0.35,10,0.035,38
3226.11727,57,69,0.42,12,0.035,38
3226.11727,57,70,0.45,13,0.034615385,38
3226.11727,56,70,0.49,14,0.035,38
3226.11727,56,71,0.52,15,0.034666667,38
3226.11727,55,72,0.59,17,0.034705882,38
3226.11727,54,73,0.66,19,0.034736842,38
3226.11727,53,74,0.73,21,0.034761905,38
3226.11727,52,75,0.8,23,0.034782609,38
3225.958472,55,88,0.91,33,0.027575758,38
3225.67931,62,67,0.17,5,0.034,38
3225.064952,56,89,0.89,33,0.026969697,38
3224.918969,53,87,0.94,34,0.027647059,38
3224.100542,52,91,0.99,39,0.025384615,38
3223.967976,68,73,0.13,5,0.026,38
3223.904912,57,85,0.8,28,0.028571429,38
3223.80963,42,66,0.76,24,0.031666667,38
3223.619201,56,86,0.86,30,0.028666667,38
3222.917069,45,61,0.52,16,0.0325,38
3222.799926,61,80,0.55,19,0.028947368,38
3222.543704,57,85,0.72,28,0.025714286,38
3222.514177,63,79,0.45,16,0.028125,38
3222.112668,58,78,0.61,20,0.0305,38
3222.112668,54,82,0.86,28,0.030714286,38
3221.053121,58,69,0.39,11,0.035454545,38
3220.775475,64,77,0.35,13,0.026923077,38
3220.775475,62,79,0.46,17,0.027058824,38
3220.561734,56,86,0.77,30,0.025666667,38
3219.621326,58,81,0.66,23,0.028695652,38
3219.406717,54,81,0.84,27,0.031111111,38
3219.142718,55,86,0.87,31,0.028064516,38
3218.877988,57,70,0.46,13,0.035384615,38
3218.629966,53,74,0.75,21,0.035714286,38
3217.730851,54,87,0.93,33,0.028181818,38
3217.534369,58,68,0.36,10,0.036,38
3217.405617,58,86,0.77,28,0.0275,38
3217.405617,55,90,0.96,35,0.027428571,38
3216.559571,60,81,0.57,21,0.027142857,38
3216.559571,57,85,0.75,28,0.026785714,38
3216.559571,56,86,0.81,30,0.027,38
3216.559571,55,88,0.88,33,0.026666667,38
3216.477456,54,90,0.96,36,0.026666667,38
3216.205485,54,88,0.87,34,0.025588235,38
3215.694131,57,82,0.72,25,0.0288,38
3215.683247,57,84,0.7,27,0.025925926,38
3215.370917,50,77,0.97,27,0.035925926,38
3214.66163,57,79,0.67,22,0.030454545,38
3214.66163,54,83,0.88,29,0.030344828,38
3214.66163,53,83,0.92,30,0.030666667,38
3214.266317,56,84,0.79,28,0.028214286,38
3214.266317,55,85,0.85,30,0.028333333,38
3213.890306,40,67,0.88,27,0.032592593,38
3213.890306,39,69,0.97,30,0.032333333,38
3213.399442,40,69,0.92,29,0.031724138,38
3213.380857,59,66,0.25,7,0.035714286,38
3213.351826,60,75,0.46,15,0.030666667,38
3213.213825,61,80,0.5,19,0.026315789,38
3213.213825,59,82,0.61,23,0.026521739,38
3213.213825,58,83,0.66,25,0.0264,38
3213.213825,56,86,0.79,30,0.026333333,38
3213.120313,62,77,0.43,15,0.028666667,38
3211.950207,62,73,0.34,11,0.030909091,38
3211.500936,55,70,0.53,15,0.035333333,38
3210.795312,58,64,0.22,6,0.036666667,38
3208.425766,58,82,0.67,24,0.027916667,38
3208.425766,56,85,0.8,29,0.027586207,38
3208.425766,55,86,0.86,31,0.027741935,38
3208.425766,54,87,0.92,33,0.027878788,38
3208.390238,53,89,0.97,36,0.026944444,38
3208.252759,64,74,0.29,10,0.029,38
3207.404791,55,85,0.8,30,0.026666667,38
3206.644137,56,87,0.85,31,0.027419355,38
3206.644137,54,90,0.98,36,0.027222222,38
3205.308322,59,84,0.7,25,0.028,38
3205.15978,62,72,0.31,10,0.031,38
3204.875681,61,74,0.4,13,0.030769231,38
3204.875681,56,79,0.71,23,0.030869565,38
3204.567576,56,85,0.81,29,0.027931034,38
3204.425818,59,81,0.62,22,0.028181818,38
3204.339014,56,83,0.78,27,0.028888889,38
3203.642378,57,88,0.83,31,0.026774194,38
3203.529634,55,86,0.84,31,0.027096774,38
3203.529634,54,86,0.88,32,0.0275,38
3203.529634,54,87,0.9,33,0.027272727,38
3203.280363,52,88,0.98,36,0.027222222,38
3203.018001,54,86,0.87,32,0.0271875,38
3202.949009,54,86,0.91,32,0.0284375,38
3202.630097,54,85,0.85,31,0.027419355,38
3202.591112,54,88,0.91,34,0.026764706,38
3202.18377,59,75,0.5,16,0.03125,38
3202.18377,58,76,0.56,18,0.031111111,38
3202.18377,56,78,0.69,22,0.031363636,38
3201.135029,63,79,0.46,16,0.02875,38
3200.640808,58,77,0.59,19,0.031052632,38
3200.640808,57,78,0.65,21,0.030952381,38
3200.640808,56,80,0.74,24,0.030833333,38
3200.640808,55,80,0.78,25,0.0312,38
3200.640808,55,81,0.8,26,0.030769231,38
3200.640808,53,83,0.93,30,0.031,38
3200.640808,53,84,0.95,31,0.030645161,38
3200.640808,52,84,0.99,32,0.0309375,38
3200.03687,57,85,0.74,28,0.026428571,38
3199.806022,58,83,0.65,25,0.026,38
3199.63288,63,73,0.3,10,0.03,38
3199.63288,62,74,0.36,12,0.03,38
3199.595992,52,83,0.96,31,0.030967742,38
3199.571038,60,79,0.54,19,0.028421053,38
3199.425463,65,75,0.29,10,0.029,38
3199.220217,67,74,0.19,7,0.027142857,38
3198.875218,66,76,0.27,10,0.027,38
3198.609801,53,82,0.91,29,0.03137931,38
3197.872316,57,88,0.84,31,0.027096774,38
3197.872316,56,89,0.9,33,0.027272727,38
3197.872316,55,91,0.97,36,0.026944444,38
3197.746765,59,76,0.52,17,0.030588235,38
3197.463302,56,80,0.73,24,0.030416667,38
3197.049042,59,81,0.59,22,0.026818182,38
3196.664383,63,79,0.43,16,0.026875,38
3196.664383,61,81,0.54,20,0.027,38
3196.664383,61,82,0.56,21,0.026666667,38
3196.60907,60,82,0.59,22,0.026818182,38
3196.60907,60,83,0.61,23,0.026521739,38
3196.60907,58,85,0.72,27,0.026666667,38
3196.60907,56,87,0.83,31,0.026774194,38
3196.60907,55,89,0.9,34,0.026470588,38
3196.277193,59,85,0.71,26,0.027307692,38
3195.931865,57,77,0.63,20,0.0315,38
3195.632888,55,87,0.82,32,0.025625,38
3194.065236,52,76,0.82,24,0.034166667,38
3194.065236,51,77,0.89,26,0.034230769,38
3194.065236,50,78,0.96,28,0.034285714,38
3193.587956,56,81,0.75,25,0.03,38
3193.457693,54,82,0.87,28,0.031071429,38
3193.297059,55,91,0.93,36,0.025833333,38
3192.843337,54,90,0.91,36,0.025277778,38
3192.823258,53,88,0.99,35,0.028285714,38
3192.500205,64,78,0.36,14,0.025714286,38
3192.076431,41,66,0.81,25,0.0324,38
3192.048941,39,70,0.99,31,0.031935484,38
3191.973597,61,81,0.57,20,0.0285,38
3191.973597,60,82,0.63,22,0.028636364,38
3191.600884,53,70,0.62,17,0.036470588,38
3191.397414,53,90,0.94,37,0.025405405,38
3191.232629,56,83,0.74,27,0.027407407,38
3191.161327,55,85,0.86,30,0.028666667,38
3191.161327,54,86,0.92,32,0.02875,38
3191.006634,56,81,0.72,25,0.0288,38
3190.879084,55,88,0.84,33,0.025454545,38
3190.879084,54,89,0.89,35,0.025428571,38
3190.879084,53,91,0.96,38,0.025263158,38
3190.78394,59,76,0.53,17,0.031176471,38
3190.78394,57,79,0.68,22,0.030909091,38
3190.357208,67,74,0.2,7,0.028571429,38
3190.255725,52,90,0.97,38,0.025526316,38
3190.091777,57,84,0.74,27,0.027407407,38
3190.050597,53,84,0.94,31,0.030322581,38
3189.981273,56,78,0.7,22,0.031818182,38
3189.768674,43,62,0.65,19,0.034210526,38
3189.768674,42,63,0.72,21,0.034285714,38
3188.772433,52,74,0.79,22,0.035909091,38
3188.627804,55,84,0.8,29,0.027586207,38
3188.24159,53,86,0.91,33,0.027575758,38
3186.44981,50,77,0.94,27,0.034814815,38
3185.375932,41,64,0.79,23,0.034347826,38
3185.087881,56,69,0.46,13,0.035384615,38
3183.937673,54,89,0.94,35,0.026857143,38
3183.38556,55,72,0.61,17,0.035882353,38
3182.805609,53,89,0.92,36,0.025555556,38
3182.587124,53,73,0.72,20,0.036,38
3182.587124,52,75,0.82,23,0.035652174,38
3182.447977,42,65,0.74,23,0.032173913,38
3182.447977,41,67,0.83,26,0.031923077,38
3182.140032,50,76,0.92,26,0.035384615,38
3181.830301,55,91,0.94,36,0.026111111,38
3181.546372,57,88,0.81,31,0.026129032,38
3181.503426,54,72,0.65,18,0.036111111,38
3181.244029,62,79,0.44,17,0.025882353,38
3180.586259,54,91,0.97,37,0.026216216,38
3180.537912,56,71,0.53,15,0.035333333,38
3180.537912,55,72,0.6,17,0.035294118,38
3179.922917,53,87,0.98,34,0.028823529,38
3179.831521,53,88,0.95,35,0.027142857,38
3179.510279,56,87,0.79,31,0.025483871,38
3179.356544,65,76,0.29,11,0.026363636,38
3179.356544,59,83,0.63,24,0.02625,38
3179.126139,53,73,0.7,20,0.035,38
3179.126139,52,74,0.77,22,0.035,38
3179.028187,60,84,0.64,24,0.026666667,38
3179.028187,57,88,0.82,31,0.026451613,38
3178.952254,49,71,0.85,22,0.038636364,38
3178.48345,62,80,0.51,18,0.028333333,38
3178.48345,58,85,0.76,27,0.028148148,38
3178.48345,57,86,0.82,29,0.028275862,38
3178.307654,53,89,0.95,36,0.026388889,38
3178.298397,54,84,0.89,30,0.029666667,38
3178.201643,56,87,0.88,31,0.028387097,38
3178.165238,44,61,0.58,17,0.034117647,38
3177.845694,42,63,0.71,21,0.033809524,38
3177.298668,60,74,0.44,14,0.031428571,38
3176.550832,57,77,0.62,20,0.031,38
3175.881979,55,86,0.85,31,0.027419355,38
3175.687055,63,77,0.37,14,0.026428571,38
3175.687055,60,81,0.55,21,0.026190476,38
3174.457177,62,78,0.44,16,0.0275,38
3174.268706,51,76,0.89,25,0.0356,38
3173.905712,56,90,0.88,34,0.025882353,38
3173.905712,55,92,0.94,37,0.025405405,38
3173.354639,57,84,0.72,27,0.026666667,38
3173.354639,55,87,0.85,32,0.0265625,38
3173.345072,64,77,0.37,13,0.028461538,38
3173.293814,56,84,0.76,28,0.027142857,38
3173.12434,61,80,0.51,19,0.026842105,38
3173.12434,59,83,0.64,24,0.026666667,38
3172.834569,59,83,0.62,24,0.025833333,38
3172.409829,53,83,0.84,30,0.028,38
3172.367194,58,76,0.57,18,0.031666667,38
3172.317935,42,47,0.19,5,0.038,38
3171.646504,52,81,0.92,29,0.031724138,38
3171.122175,56,70,0.5,14,0.035714286,38
3171.0359,53,88,0.96,35,0.027428571,38
3170.831745,40,68,0.9,28,0.032142857,38
3170.703187,55,85,0.82,30,0.027333333,38
3170.579498,51,76,0.87,25,0.0348,38
3170.524622,55,71,0.56,16,0.035,38
3170.524622,54,72,0.63,18,0.035,38
3169.712679,61,81,0.52,20,0.026,38
3168.880925,57,87,0.79,30,0.026333333,38
3168.564363,56,69,0.47,13,0.036153846,38
3168.311654,54,89,0.9,35,0.025714286,38
3168.311654,53,90,0.95,37,0.025675676,38
3168.311654,53,91,0.97,38,0.025526316,38
3168.168831,53,82,0.9,29,0.031034483,38
3165.667021,63,79,0.42,16,0.02625,38
3165.238182,54,84,0.86,30,0.028666667,38
3165.202169,44,62,0.59,18,0.032777778,38
3164.238176,56,88,0.85,32,0.0265625,38
3164.023951,53,89,0.93,36,0.025833333,38
3163.509932,54,88,0.88,34,0.025882353,38
3162.64184,53,88,0.98,35,0.028,38
3162.18442,56,90,0.9,34,0.026470588,38
3162.061354,56,88,0.89,32,0.0278125,38
3162.061354,55,89,0.95,34,0.027941176,38
3161.532704,63,78,0.43,15,0.028666667,38
3161.532704,58,84,0.74,26,0.028461538,38
3161.406561,40,66,0.88,26,0.033846154,38
3161.405537,52,84,0.93,32,0.0290625,38
3161.119095,61,73,0.37,12,0.030833333,38
3161.064378,60,74,0.43,14,0.030714286,38
3160.951841,53,89,0.99,36,0.0275,38
3160.903973,54,92,0.99,38,0.026052632,38
3160.838781,55,80,0.77,25,0.0308,38
3160.294201,63,71,0.25,8,0.03125,38
3159.624801,54,82,0.78,28,0.027857143,38
3159.338818,56,85,0.78,29,0.026896552,38
3157.730219,55,87,0.87,32,0.0271875,38
3157.730219,54,88,0.93,34,0.027352941,38
3157.215673,60,82,0.58,22,0.026363636,38
3157.215673,58,84,0.69,26,0.026538462,38
3157.215673,57,86,0.76,29,0.026206897,38
3156.864203,56,90,0.87,34,0.025588235,38
3156.70928,54,71,0.6,17,0.035294118,38
3156.707461,43,63,0.66,20,0.033,38
3156.660848,45,60,0.51,15,0.034,38
3155.922486,59,68,0.32,9,0.035555556,38
3154.637771,56,87,0.82,31,0.026451613,38
3154.230823,55,88,0.85,33,0.025757576,38
3153.515028,55,87,0.84,32,0.02625,38
3153.515028,54,88,0.9,34,0.026470588,38
3153.515028,54,89,0.91,35,0.026,38
3153.43512,68,74,0.16,6,0.026666667,38
3153.43512,65,77,0.32,12,0.026666667,38
3153.43512,62,80,0.48,18,0.026666667,38
3152.65836,56,79,0.72,23,0.031304348,38
3151.980266,43,62,0.64,19,0.033684211,38
3151.980266,41,65,0.8,24,0.033333333,38
3151.566527,58,82,0.64,24,0.026666667,38
3151.566527,55,86,0.82,31,0.026451613,38
3151.566527,54,87,0.88,33,0.026666667,38
3150.940055,53,90,0.97,37,0.026216216,38
3150.900152,57,87,0.84,30,0.028,38
3149.304708,57,86,0.77,29,0.026551724,38
3149.168774,52,85,0.91,33,0.027575758,38
3149.168774,51,86,0.97,35,0.027714286,38
3148.735045,56,85,0.77,29,0.026551724,38
3148.311105,62,80,0.47,18,0.026111111,38
3148.311105,58,85,0.7,27,0.025925926,38
3146.754022,55,88,0.95,33,0.028787879,38
3146.376116,53,74,0.72,21,0.034285714,38
3146.376116,52,75,0.79,23,0.034347826,38
3146.282143,60,83,0.64,23,0.027826087,38
3145.945107,56,86,0.78,30,0.026,38
3145.945107,55,87,0.83,32,0.0259375,38
3145.593727,66,75,0.24,9,0.026666667,38
3145.593727,63,78,0.4,15,0.026666667,38
3144.777395,56,89,0.92,33,0.027878788,38
3143.11852,53,90,0.96,37,0.025945946,38
3142.937843,58,82,0.65,24,0.027083333,38
3142.854252,40,69,0.91,29,0.03137931,38
3142.682708,58,77,0.58,19,0.030526316,38
3142.145096,40,67,0.87,27,0.032222222,38
3142.122708,57,87,0.83,30,0.027666667,38
3141.176245,56,85,0.76,29,0.026206897,38
3141.176245,55,86,0.81,31,0.026129032,38
3141.176245,53,89,0.94,36,0.026111111,38
3138.758538,65,77,0.31,12,0.025833333,38
3138.758538,60,83,0.59,23,0.025652174,38
3138.00355,61,74,0.36,13,0.027692308,38
3137.754694,56,89,0.91,33,0.027575758,38
3136.877298,57,83,0.7,26,0.026923077,38
3136.627378,54,81,0.83,27,0.030740741,38
3135.340316,54,73,0.67,19,0.035263158,38
3134.315492,54,87,0.89,33,0.026969697,38
3134.315492,53,88,0.94,35,0.026857143,38
3133.942823,53,82,0.89,29,0.030689655,38
3133.53339,59,85,0.7,26,0.026923077,38
3133.511814,56,88,0.84,32,0.02625,38
3133.511814,55,89,0.89,34,0.026176471,38
3133.511814,54,90,0.95,36,0.026388889,38
3133.511814,54,91,0.96,37,0.025945946,38
3133.147411,54,94,0.99,40,0.02475,38
3132.812925,55,91,0.96,36,0.026666667,38
3132.583982,53,89,0.98,36,0.027222222,38
3130.68961,58,87,0.75,29,0.025862069,38
3130.027065,65,74,0.25,9,0.027777778,38
3130.02258,67,75,0.21,8,0.02625,38
3130.02258,64,79,0.39,15,0.026,38
3130.02258,63,80,0.44,17,0.025882353,38
3129.840008,51,85,0.99,34,0.029117647,38
3127.898157,62,73,0.3,11,0.027272727,38
3127.686091,59,82,0.6,23,0.026086957,38
3127.686091,58,84,0.67,26,0.025769231,38
3127.470681,60,80,0.55,20,0.0275,38
3127.3737,60,83,0.66,23,0.028695652,38
3126.872986,54,93,0.99,39,0.025384615,38
3126.666493,58,86,0.78,28,0.027857143,38
3126.351096,56,80,0.65,24,0.027083333,38
3126.324507,62,81,0.52,19,0.027368421,38
3126.324507,61,82,0.58,21,0.027619048,38
3126.324507,58,86,0.76,28,0.027142857,38
3126.070116,62,81,0.5,19,0.026315789,38
3125.659239,59,86,0.69,27,0.025555556,38
3124.875404,57,85,0.73,28,0.026071429,38
3124.282136,58,83,0.68,25,0.0272,38
3124.282136,56,85,0.79,29,0.027241379,38
3124.282136,55,87,0.86,32,0.026875,38
3124.282136,54,88,0.92,34,0.027058824,38
3123.10298,55,81,0.71,26,0.027307692,38
3123.009019,56,80,0.66,24,0.0275,38
3123.009019,55,81,0.72,26,0.027692308,38
3122.879634,39,68,0.95,29,0.032758621,38
3122.876296,58,86,0.79,28,0.028214286,38
3122.507684,57,87,0.82,30,0.027333333,38
3122.507684,56,88,0.88,32,0.0275,38
3122.000342,55,91,0.95,36,0.026388889,38
3121.576439,54,88,0.89,34,0.026176471,38
3121.408149,57,80,0.7,23,0.030434783,38
3121.408149,56,81,0.76,25,0.0304,38
3121.408149,54,84,0.91,30,0.030333333,38
3120.808229,53,88,0.93,35,0.026571429,38
3120.808229,52,89,0.99,37,0.026756757,38
3120.806853,55,89,0.86,34,0.025294118,38
3118.606112,57,78,0.64,21,0.03047619,38
3118.606112,55,81,0.79,26,0.030384615,38
3118.606112,54,82,0.85,28,0.030357143,38
3118.329452,52,84,0.98,32,0.030625,38
3118.002157,53,92,0.98,39,0.025128205,38
3117.631976,41,68,0.85,27,0.031481481,38
3116.664431,57,84,0.71,27,0.026296296,38
3116.263485,56,79,0.7,23,0.030434783,38
3115.834773,58,86,0.75,28,0.026785714,38
3115.834773,55,90,0.93,35,0.026571429,38
3115.834773,54,91,0.99,37,0.026756757,38
3115.022573,55,90,0.97,35,0.027714286,38
3114.867919,69,72,0.08,3,0.026666667,38
3114.867919,61,81,0.53,20,0.0265,38
3114.814609,53,85,0.95,32,0.0296875,38
3114.45928,68,69,0.03,1,0.03,38
3114.45928,67,70,0.09,3,0.03,38
3114.45928,66,71,0.15,5,0.03,38
3114.45928,65,72,0.21,7,0.03,38
3114.45928,64,73,0.27,9,0.03,38
3114.45928,63,74,0.33,11,0.03,38
3114.45928,62,75,0.39,13,0.03,38
3114.45928,61,76,0.45,15,0.03,38
3114.45928,60,77,0.51,17,0.03,38
3114.45928,59,78,0.57,19,0.03,38
3114.182977,57,81,0.72,24,0.03,38
3114.182977,56,82,0.78,26,0.03,38
3114.182977,53,86,0.99,33,0.03,38
3113.756797,61,75,0.43,14,0.030714286,38
3112.955528,41,66,0.8,25,0.032,38
3112.891894,61,75,0.42,14,0.03,38
3112.856102,62,81,0.49,19,0.025789474,38
3112.856102,59,84,0.65,25,0.026,38
3112.856102,58,86,0.72,28,0.025714286,38
3111.964047,60,76,0.43,16,0.026875,38
3111.964047,58,78,0.54,20,0.027,38
3111.938587,60,80,0.53,20,0.0265,38
3111.704836,69,73,0.11,4,0.0275,38
3111.704836,67,75,0.22,8,0.0275,38
3111.126967,57,79,0.6,22,0.027272727,38
3110.407927,53,85,0.97,32,0.0303125,38
3109.7171,60,76,0.48,16,0.03,38
3109.7171,59,77,0.54,18,0.03,38
3109.7171,58,78,0.6,20,0.03,38
3109.7171,57,79,0.66,22,0.03,38
3109.7171,56,80,0.72,24,0.03,38
3109.651563,55,86,0.83,31,0.026774194,38
3108.515951,56,90,0.86,34,0.025294118,38
3108.352102,65,67,0.06,2,0.03,38
3108.352102,64,68,0.12,4,0.03,38
3108.352102,63,69,0.18,6,0.03,38
3108.352102,62,70,0.24,8,0.03,38
3108.352102,61,71,0.3,10,0.03,38
3107.932067,64,72,0.23,8,0.02875,38
3107.799517,52,83,0.98,31,0.031612903,38
3106.666152,57,89,0.81,32,0.0253125,38
3105.812872,60,72,0.36,12,0.03,38
3105.80063,43,64,0.68,21,0.032380952,38
3105.76003,57,87,0.76,30,0.025333333,38
3105.393169,59,77,0.52,18,0.028888889,38
3105.164476,52,90,0.98,38,0.025789474,38
3104.921938,51,86,0.99,35,0.028285714,38
3104.271705,53,84,0.84,31,0.027096774,38
3103.982576,54,87,0.86,33,0.026060606,38
3103.982576,52,90,0.99,38,0.026052632,38
3103.622736,50,70,0.77,20,0.0385,38
3103.4078,59,85,0.66,26,0.025384615,38
3102.140911,51,82,0.99,31,0.031935484,38
3101.945688,56,89,0.87,33,0.026363636,38
3101.575934,57,87,0.81,30,0.027,38
3101.575934,55,90,0.94,35,0.026857143,38
3100.960104,52,86,0.91,34,0.026764706,38
3100.864577,42,64,0.73,22,0.033181818,38
3099.714125,56,87,0.81,31,0.026129032,38
3099.523044,58,77,0.6,19,0.031578947,38
3099.296078,54,82,0.77,28,0.0275,38
3099.240135,40,66,0.9,26,0.034615385,38
3099.20794,54,91,0.98,37,0.026486486,38
3099.115969,58,87,0.76,29,0.026206897,38
3098.205406,51,56,0.13,5,0.026,38
3098.134344,55,82,0.81,27,0.03,38
3098.134344,54,83,0.87,29,0.03,38
3097.797569,53,79,0.84,26,0.032307692,38
3097.442195,57,86,0.75,29,0.025862069,38
3096.273622,57,89,0.8,32,0.025,38
3096.029081,67,68,0.03,1,0.03,38
3096.029081,66,69,0.09,3,0.03,38
3096.029081,65,70,0.15,5,0.03,38
3096.029081,64,71,0.21,7,0.03,38
3096.029081,63,72,0.27,9,0.03,38
3096.029081,62,73,0.33,11,0.03,38
3096.029081,61,74,0.39,13,0.03,38
3096.029081,60,75,0.45,15,0.03,38
3095.545582,62,75,0.37,13,0.028461538,38
3095.45923,58,79,0.62,21,0.02952381,38
3095.45923,57,80,0.68,23,0.029565217,38
3095.087981,38,52,0.52,14,0.037142857,38
3095.024618,63,72,0.28,9,0.031111111,38
3094.899739,56,90,0.89,34,0.026176471,38
3094.045103,54,80,0.82,26,0.031538462,38
3094.028041,54,90,0.92,36,0.025555556,38
3093.895917,42,65,0.75,23,0.032608696,38
3093.608807,57,79,0.59,22,0.026818182,38
3092.901763,64,71,0.19,7,0.027142857,38
3092.387928,58,79,0.6,21,0.028571429,38
3091.754305,56,84,0.75,28,0.026785714,38
3091.164216,61,82,0.55,21,0.026190476,38
3091.164216,60,83,0.6,23,0.026086957,38
3091.164216,58,85,0.71,27,0.026296296,38
3091.164216,57,87,0.78,30,0.026,38
3090.922404,56,86,0.8,30,0.026666667,38
3090.899589,61,74,0.38,13,0.029230769,38
3090.550434,63,80,0.45,17,0.026470588,38
3090.317989,55,83,0.84,28,0.03,38
3090.308431,57,87,0.85,30,0.028333333,38
3090.304471,60,82,0.57,22,0.025909091,38
3090.304471,58,85,0.69,27,0.025555556,38
3089.664567,54,81,0.85,27,0.031481481,38
3088.638589,58,86,0.73,28,0.026071429,38
3088.610847,57,76,0.61,19,0.032105263,38
3088.610847,55,78,0.74,23,0.032173913,38
3088.454223,56,81,0.67,25,0.0268,38
3088.454223,54,83,0.78,29,0.026896552,38
3088.114218,62,79,0.45,17,0.026470588,38
3087.717494,53,89,0.96,36,0.026666667,38
3087.537556,56,88,0.81,32,0.0253125,38
3087.537556,54,91,0.93,37,0.025135135,38
3087.099399,55,92,0.93,37,0.025135135,38
3087.099399,54,93,0.98,39,0.025128205,38
3087.094781,62,72,0.32,10,0.032,38
3086.348408,40,66,0.89,26,0.034230769,38
3086.074592,55,82,0.72,27,0.026666667,38
3085.250166,41,67,0.82,26,0.031538462,38
3084.43947,41,65,0.81,24,0.03375,38
3084.331153,55,91,0.92,36,0.025555556,38
3082.863819,53,85,0.85,32,0.0265625,38
3082.338918,54,90,0.93,36,0.025833333,38
3082.260513,55,91,0.99,36,0.0275,38
3082.242208,59,74,0.48,15,0.032,38
3082.056263,52,89,0.98,37,0.026486486,38
3082.055414,65,75,0.27,10,0.027,38
3082.055414,63,77,0.38,14,0.027142857,38
3082.055414,61,79,0.49,18,0.027222222,38
3082.055414,59,82,0.62,23,0.026956522,38
3081.680318,39,66,0.93,27,0.034444444,38
3081.555151,54,87,0.87,33,0.026363636,38
3081.555151,53,88,0.92,35,0.026285714,38
3081.056172,59,75,0.51,16,0.031875,38
3080.900972,55,90,0.98,35,0.028,38
3080.879878,65,80,0.4,15,0.026666667,38
3080.800515,66,76,0.26,10,0.026,38
3080.784659,39,68,0.96,29,0.033103448,38
3080.104535,55,85,0.81,30,0.027,38
3080.065471,39,69,0.98,30,0.032666667,38
3079.84964,62,74,0.35,12,0.029166667,38
3079.777945,64,78,0.37,14,0.026428571,38
3079.536996,57,84,0.73,27,0.027037037,38
3079.42393,54,84,0.9,30,0.03,38
3079.082951,61,83,0.59,22,0.026818182,38
3079.007731,54,81,0.82,27,0.03037037,38
3079.007731,53,82,0.88,29,0.030344828,38
3078.738676,64,77,0.34,13,0.026153846,38
3077.477218,60,75,0.44,15,0.029333333,38
3077.477218,59,76,0.5,17,0.029411765,38
3077.26133,59,84,0.66,25,0.0264,38
3077.217414,62,72,0.28,10,0.028,38
3077.217414,59,76,0.47,17,0.027647059,38
3076.826704,46,59,0.42,13,0.032307692,38
3075.902059,55,80,0.76,25,0.0304,38
3075.902059,52,84,0.97,32,0.0303125,38
3074.430821,59,73,0.42,14,0.03,38
3074.430821,58,74,0.48,16,0.03,38
3074.279614,39,51,0.44,12,0.036666667,38
3074.204257,56,88,0.83,32,0.0259375,38
3074.033608,52,82,0.95,30,0.031666667,38
3074.016325,52,82,0.93,30,0.031,38
3073.69994,61,82,0.54,21,0.025714286,38
3073.510409,69,75,0.16,6,0.026666667,38
3073.510409,63,82,0.5,19,0.026315789,38
3073.119794,39,69,0.96,30,0.032,38
3072.635487,58,75,0.54,17,0.031764706,38
3072.386444,52,85,0.9,33,0.027272727,38
3071.99546,64,79,0.41,15,0.027333333,38
3071.870295,53,84,0.85,31,0.027419355,38
3071.692054,55,90,0.9,35,0.025714286,38
3071.456808,60,73,0.41,13,0.031538462,38
3071.368946,62,70,0.26,8,0.0325,38
3071.195628,59,85,0.69,26,0.026538462,38
3070.651301,41,65,0.83,24,0.034583333,38
3070.306271,61,85,0.64,24,0.026666667,38
3070.298653,59,79,0.59,20,0.0295,38
3070.298653,58,80,0.65,22,0.029545455,38
3070.298653,57,81,0.71,24,0.029583333,38
3070.298653,56,82,0.77,26,0.029615385,38
3070.298653,54,85,0.91,31,0.029354839,38
3070.026146,53,86,0.98,33,0.02969697,38
3069.422656,55,89,0.88,34,0.025882353,38
3069.384647,55,81,0.78,26,0.03,38
3069.384647,54,82,0.84,28,0.03,38
3069.201729,55,79,0.76,24,0.031666667,38
3069.201729,53,81,0.89,28,0.031785714,38
3068.995024,54,78,0.78,24,0.0325,38
3068.525371,60,75,0.47,15,0.031333333,38
3068.124196,58,89,0.69,31,0.022258065,38
3067.804275,63,73,0.29,10,0.029,38
3067.172234,56,88,0.82,32,0.025625,38
3067.093772,64,80,0.43,16,0.026875,38
3066.589378,60,81,0.56,21,0.026666667,38
3066.555719,59,87,0.75,28,0.026785714,38
3066.555719,57,90,0.88,33,0.026666667,38
3066.486171,54,93,0.97,39,0.024871795,38
3066.100533,51,86,0.96,35,0.027428571,38
3065.813216,56,80,0.67,24,0.027916667,38
3065.400896,52,85,0.92,33,0.027878788,38
3065.400896,51,86,0.98,35,0.028,38
3065.34118,57,78,0.66,21,0.031428571,38
3065.34118,55,81,0.81,26,0.031153846,38
3065.278394,40,69,0.93,29,0.032068966,38
3064.852434,63,83,0.52,20,0.026,38
3064.641404,59,78,0.54,19,0.028421053,38
3064.065928,46,59,0.44,13,0.033846154,38
3063.790401,53,92,0.99,39,0.025384615,38
3063.775534,68,75,0.19,7,0.027142857,38
3063.542465,62,77,0.44,15,0.029333333,38
3063.542465,61,78,0.5,17,0.029411765,38
3062.665564,55,77,0.71,22,0.032272727,38
3062.665564,52,81,0.93,29,0.032068966,38
3062.017335,60,72,0.39,12,0.0325,38
3062.017335,58,74,0.52,16,0.0325,38
3061.671167,60,79,0.56,19,0.029473684,38
3061.671167,59,80,0.62,21,0.02952381,38
3061.144072,54,80,0.81,26,0.031153846,38
3061.144072,52,82,0.94,30,0.031333333,38
3060.304409,58,89,0.81,31,0.026129032,38
3060.102082,59,84,0.64,25,0.0256,38
3059.737422,56,76,0.6,20,0.03,38
3059.508165,58,78,0.58,20,0.029,38
3059.418366,51,81,0.97,30,0.032333333,38
3058.000424,53,83,0.91,30,0.030333333,38
3058.000424,53,84,0.93,31,0.03,38
3058.000424,52,85,0.99,33,0.03,38
3057.977789,52,84,0.92,32,0.02875,38
3057.705729,64,70,0.19,6,0.031666667,38
3057.705729,61,73,0.38,12,0.031666667,38
3057.559795,57,75,0.54,18,0.03,38
3057.225698,54,82,0.79,28,0.028214286,38
3057.225698,53,83,0.85,30,0.028333333,38
3056.527698,63,70,0.22,7,0.031428571,38
3056.39299,54,83,0.8,29,0.027586207,38
3056.39299,53,84,0.86,31,0.027741935,38
3055.630914,51,75,0.81,24,0.03375,38
3055.630914,50,76,0.88,26,0.033846154,38
3055.630914,49,77,0.95,28,0.033928571,38
3055.495987,56,76,0.65,20,0.0325,38
3055.357721,67,77,0.27,10,0.027,38
3055.357721,65,79,0.38,14,0.027142857,38
3055.357721,63,80,0.47,17,0.027647059,38
3055.357721,63,81,0.49,18,0.027222222,38
3055.357721,61,84,0.62,23,0.026956522,38
3055.186655,39,67,0.94,28,0.033571429,38
3054.909721,49,75,0.95,26,0.036538462,38
3054.602877,39,70,0.98,31,0.031612903,38
3054.458553,53,73,0.67,20,0.0335,38
3054.458553,52,74,0.74,22,0.033636364,38
3054.272273,56,78,0.68,22,0.030909091,38
3053.250282,50,71,0.8,21,0.038095238,38
3053.083262,40,64,0.84,24,0.035,38
3052.766127,41,67,0.84,26,0.032307692,38
3052.766127,40,68,0.91,28,0.0325,38
3052.758129,54,79,0.8,25,0.032,38
3052.745891,55,90,0.88,35,0.025142857,38
3052.240936,56,81,0.74,25,0.0296,38
3052.240936,55,82,0.8,27,0.02962963,38
3052.240419,63,82,0.51,19,0.026842105,38
3052.188046,59,76,0.51,17,0.03,38
3052.188046,54,83,0.86,29,0.029655172,38
3052.188046,53,84,0.92,31,0.029677419,38
3051.624854,60,84,0.66,24,0.0275,38
3051.624854,58,87,0.79,29,0.027241379,38
3051.045862,64,85,0.44,21,0.020952381,38
3050.582184,54,79,0.79,25,0.0316,38
3050.582184,53,80,0.86,27,0.031851852,38
3049.931864,58,86,0.74,28,0.026428571,38
3049.760605,56,90,0.92,34,0.027058824,38
3049.571009,63,75,0.36,12,0.03,38
3049.571009,62,76,0.42,14,0.03,38
3048.588743,57,76,0.57,19,0.03,38
3048.588743,56,77,0.63,21,0.03,38
3048.588743,55,78,0.69,23,0.03,38
3048.209194,51,70,0.72,19,0.037894737,38
3048.185624,53,84,0.96,31,0.030967742,38
3047.422723,53,55,0.05,2,0.025,38
3047.422723,52,56,0.1,4,0.025,38
3046.805989,54,80,0.77,26,0.029615385,38
3046.743227,44,62,0.58,18,0.032222222,38
3046.648833,55,92,0.99,37,0.026756757,38
3046.534045,54,87,0.96,33,0.029090909,38
3046.490233,45,60,0.49,15,0.032666667,38
3046.290135,65,73,0.22,8,0.0275,38
3045.733115,57,75,0.58,18,0.032222222,38
3045.642448,52,77,0.86,25,0.0344,38
3045.642448,51,78,0.93,27,0.034444444,38
3045.191341,54,83,0.79,29,0.027241379,38
3044.34356,51,87,0.99,36,0.0275,38
3044.155383,67,78,0.29,11,0.026363636,38
3044.11036,53,83,0.86,30,0.028666667,38
3043.556036,64,69,0.16,5,0.032,38
3043.554678,55,89,0.87,34,0.025588235,38
3043.288624,47,57,0.33,10,0.033,38
3042.496529,49,78,0.96,29,0.033103448,38
3042.381393,61,83,0.6,22,0.027272727,38
3042.295553,66,78,0.32,12,0.026666667,38
3042.295553,64,81,0.45,17,0.026470588,38
3042.295553,63,81,0.48,18,0.026666667,38
3042.295553,61,84,0.61,23,0.026521739,38
3042.295553,61,85,0.63,24,0.02625,38
3042.295553,59,86,0.72,27,0.026666667,38
3042.295553,59,87,0.74,28,0.026428571,38
3042.295553,57,89,0.85,32,0.0265625,38
3042.205748,55,92,0.95,37,0.025675676,38
3041.565864,53,91,0.99,38,0.026052632,38
3041.56153,63,76,0.38,13,0.029230769,38
3041.56153,58,82,0.7,24,0.029166667,38
3041.291493,57,83,0.76,26,0.029230769,38
3041.291493,56,84,0.82,28,0.029285714,38
3041.291493,55,85,0.88,30,0.029333333,38
3040.712603,57,76,0.6,19,0.031578947,38
3040.712603,55,78,0.73,23,0.03173913,38
3040.712603,55,79,0.75,24,0.03125,38
3040.712603,53,81,0.88,28,0.031428571,38
3040.692978,59,88,0.64,29,0.022068966,38
3040.457123,65,77,0.34,12,0.028333333,38
3039.879157,55,82,0.73,27,0.027037037,38
3039.805735,58,84,0.68,26,0.026153846,38
3039.805735,55,88,0.86,33,0.026060606,38
3039.784258,56,88,0.91,32,0.0284375,38
3039.348259,68,77,0.24,9,0.026666667,38
3039.077694,52,80,0.91,28,0.0325,38
3038.711049,40,68,0.89,28,0.031785714,38
3038.536851,52,84,0.96,32,0.03,38
3038.355106,56,92,0.79,36,0.021944444,38
3038.253874,57,80,0.61,23,0.026521739,38
3037.182515,40,65,0.85,25,0.034,38
3037.14576,66,77,0.3,11,0.027272727,38
3037.053665,61,72,0.31,11,0.028181818,38
3037.053665,60,74,0.39,14,0.027857143,38
3037.053665,57,77,0.56,20,0.028,38
3036.961783,56,89,0.93,33,0.028181818,38
3036.961783,55,90,0.99,35,0.028285714,38
3036.807295,59,86,0.73,27,0.027037037,38
3036.807295,57,89,0.86,32,0.026875,38
3036.337306,39,68,0.97,29,0.033448276,38
3035.902152,62,83,0.56,21,0.026666667,38
3035.878724,59,73,0.45,14,0.032142857,38
3035.878724,56,77,0.67,21,0.031904762,38
3035.290076,62,82,0.54,20,0.027,38
3035.290076,60,84,0.65,24,0.027083333,38
3035.250817,54,91,0.94,37,0.025405405,38
3034.621961,56,89,0.86,33,0.026060606,38
3034.186065,57,78,0.58,21,0.027619048,38
3033.959509,45,62,0.55,17,0.032352941,38
3033.531066,58,70,0.41,12,0.034166667,38
3032.995728,52,77,0.85,25,0.034,38
3032.842472,64,69,0.14,5,0.028,38
3032.602854,55,90,0.89,35,0.025428571,38
3032.54718,60,86,0.69,26,0.026538462,38
3032.347673,54,91,0.95,37,0.025675676,38
3032.243582,61,71,0.29,10,0.029,38
3031.744123,40,62,0.15,22,0.006818182,38
3031.607155,67,71,0.11,4,0.0275,38
3031.519577,41,66,0.82,25,0.0328,38
3031.395614,57,90,0.74,33,0.022424242,38
3031.318977,62,82,0.53,20,0.0265,38
3030.820374,55,81,0.73,26,0.028076923,38
3030.704135,42,66,0.77,24,0.032083333,38
3030.694216,57,90,0.87,33,0.026363636,38
3030.663403,56,79,0.67,23,0.029130435,38
3030.525151,68,70,0.06,2,0.03,38
3030.525151,67,71,0.12,4,0.03,38
3030.525151,66,72,0.18,6,0.03,38
3030.525151,65,73,0.24,8,0.03,38
3030.525151,64,74,0.3,10,0.03,38
3030.283429,36,54,0.67,18,0.037222222,38
3030.266517,51,55,0.13,4,0.0325,38
3030.266517,49,57,0.26,8,0.0325,38
3030.258723,50,77,0.89,27,0.032962963,38
3029.711976,41,48,0.26,7,0.037142857,38
3029.711976,39,50,0.41,11,0.037272727,38
3029.615289,51,80,0.88,29,0.030344828,38
3029.030301,56,84,0.83,28,0.029642857,38
3028.965044,46,60,0.46,14,0.032857143,38
3028.941438,47,59,0.39,12,0.0325,38
3028.548931,53,82,0.92,29,0.031724138,38
3028.423253,59,86,0.63,27,0.023333333,38
3028.422912,54,84,0.79,30,0.026333333,38
3028.375155,52,85,0.94,33,0.028484848,38
3028.226273,68,75,0.2,7,0.028571429,38
3027.98677,39,66,0.92,27,0.034074074,38
3027.636108,56,82,0.79,26,0.030384615,38
3027.179417,55,85,0.89,30,0.029666667,38
3026.990526,56,91,0.93,35,0.026571429,38
3026.821916,66,76,0.28,10,0.028,38
3026.341322,57,77,0.64,20,0.032,38
3026.306154,40,65,0.87,25,0.0348,38
3025.934124,58,88,0.68,30,0.022666667,38
3025.853318,55,93,0.99,38,0.026052632,38
3025.755139,47,58,0.37,11,0.033636364,38
3025.646762,42,64,0.75,22,0.034090909,38
3025.646762,41,65,0.82,24,0.034166667,38
3025.609872,58,86,0.71,28,0.025357143,38
3025.357445,59,75,0.45,16,0.028125,38
3024.549877,60,73,0.37,13,0.028461538,38
3024.152431,55,79,0.68,24,0.028333333,38
3023.986638,64,78,0.4,14,0.028571429,38
3022.342327,39,68,0.98,29,0.033793103,38
3022.166622,53,81,0.83,28,0.029642857,38
3022.166622,52,82,0.89,30,0.029666667,38
3021.958165,53,91,0.98,38,0.025789474,38
3021.940103,58,76,0.51,18,0.028333333,38
3021.940103,53,82,0.82,29,0.028275862,38
3021.835479,62,82,0.57,20,0.0285,38
3021.547652,43,65,0.7,22,0.031818182,38
3021.523407,39,66,0.94,27,0.034814815,38
3021.353652,53,74,0.69,21,0.032857143,38
3020.79347,52,85,0.98,33,0.02969697,38
3020.147589,44,61,0.56,17,0.032941176,38
3019.917049,54,79,0.75,25,0.03,38
3019.917049,53,80,0.81,27,0.03,38
3019.319566,39,68,0.99,29,0.034137931,38
3019.033721,39,67,0.97,28,0.034642857,38
3018.855816,54,81,0.76,27,0.028148148,38
3018.284587,40,67,0.91,27,0.033703704,38
3018.157311,59,74,0.43,15,0.028666667,38
3017.992039,52,80,0.84,28,0.03,38
3017.318413,53,81,0.82,28,0.029285714,38
3016.953157,44,63,0.61,19,0.032105263,38
3016.864754,58,76,0.5,18,0.027777778,38
3016.54547,60,77,0.52,17,0.030588235,38
3016.101089,36,66,0.25,30,0.008333333,38
3016.078662,40,65,0.86,25,0.0344,38
3015.865356,60,86,0.68,26,0.026153846,38
3015.845962,57,78,0.59,21,0.028095238,38
3015.763291,39,69,0.99,30,0.033,38
3015.593447,40,70,0.94,30,0.031333333,38
3015.148131,63,70,0.2,7,0.028571429,38
3014.773784,59,78,0.58,19,0.030526316,38
3014.773784,55,83,0.85,28,0.030357143,38
3014.538552,62,71,0.25,9,0.027777778,38
3014.421058,53,81,0.87,28,0.031071429,38
3014.41393,59,73,0.4,14,0.028571429,38
3014.276903,51,78,0.92,27,0.034074074,38
3014.276903,50,79,0.99,29,0.034137931,38
3014.015609,55,80,0.69,25,0.0276,38
3013.751641,57,71,0.48,14,0.034285714,38
3013.751641,56,72,0.55,16,0.034375,38
3013.687444,55,73,0.62,18,0.034444444,38
3013.687444,54,74,0.69,20,0.0345,38
3013.53854,52,85,0.93,33,0.028181818,38
3013.481999,51,81,0.9,30,0.03,38
3013.441078,65,79,0.39,14,0.027857143,38
3013.260156,40,67,0.89,27,0.032962963,38
3013.250958,52,86,0.93,34,0.027352941,38
3012.854092,58,88,0.8,30,0.026666667,38
3011.903531,53,83,0.87,30,0.029,38
3011.893522,55,80,0.7,25,0.028,38
3011.81043,61,73,0.34,12,0.028333333,38
3011.799332,60,79,0.52,19,0.027368421,38
3011.796343,61,72,0.35,11,0.031818182,38
3011.279248,41,68,0.86,27,0.031851852,38
3011.082735,63,83,0.53,20,0.0265,38
3010.400212,64,79,0.43,15,0.028666667,38
3010.291581,60,79,0.57,19,0.03,38
3010.291581,59,80,0.63,21,0.03,38
3010.291581,58,81,0.69,23,0.03,38
3009.988416,43,63,0.67,20,0.0335,38
3009.988416,42,65,0.76,23,0.033043478,38
3009.595107,61,83,0.57,22,0.025909091,38
3009.584149,58,79,0.64,21,0.03047619,38
3009.171508,56,90,0.91,34,0.026764706,38
3009.171508,55,92,0.98,37,0.026486486,38
3009.051655,60,83,0.65,23,0.02826087,38
3008.961264,54,80,0.83,26,0.031923077,38
3008.912443,55,80,0.74,25,0.0296,38
3008.845539,55,90,0.92,35,0.026285714,38
3008.784412,59,84,0.71,25,0.0284,38
3008.784412,58,85,0.77,27,0.028518519,38
3008.742483,41,66,0.84,25,0.0336,38
3007.866177,57,86,0.74,29,0.025517241,38
3007.814716,61,84,0.64,23,0.027826087,38
3007.798748,57,77,0.57,20,0.0285,38
3007.798748,56,79,0.65,23,0.02826087,38
3007.684013,70,73,0.08,3,0.026666667,38
3007.68243,43,62,0.63,19,0.033157895,38
3007.667656,60,85,0.67,25,0.0268,38
3007.667656,58,87,0.78,29,0.026896552,38
3007.665246,40,67,0.92,27,0.034074074,38
3007.450155,35,55,0.95,20,0.0475,38
3007.134038,57,88,0.8,31,0.025806452,38
3006.956039,58,77,0.57,19,0.03,38
3006.956039,53,83,0.9,30,0.03,38
3006.911035,69,74,0.14,5,0.028,38
3006.817458,49,79,0.97,30,0.032333333,38
3006.717723,53,86,0.97,33,0.029393939,38
3006.511403,58,80,0.66,22,0.03,38
3006.411532,52,86,0.94,34,0.027647059,38
3006.163046,65,78,0.35,13,0.026923077,38
3005.900809,55,81,0.75,26,0.028846154,38
3005.647308,54,92,0.98,38,0.025789474,38
3005.573363,51,84,0.97,33,0.029393939,38
3005.509465,51,87,0.98,36,0.027222222,38
3004.37093,64,72,0.25,8,0.03125,38
3004.192408,55,83,0.74,28,0.026428571,38
3004.137548,37,53,0.59,16,0.036875,38
3004.100263,57,91,0.74,34,0.021764706,38
3004.030282,60,80,0.59,20,0.0295,38
3003.414415,53,90,0.98,37,0.026486486,38
3003.142766,55,79,0.7,24,0.029166667,38
3002.862363,58,88,0.79,30,0.026333333,38
3002.862363,56,91,0.92,35,0.026285714,38
3002.235349,42,48,0.22,6,0.036666667,38
3001.982715,41,58,0.12,17,0.007058824,38
3001.957885,62,84,0.58,22,0.026363636,38
3001.932684,54,82,0.8,28,0.028571429,38
3001.30337,61,74,0.41,13,0.031538462,38
3001.120072,57,82,0.75,25,0.03,38
3001.088943,67,75,0.23,8,0.02875,38
3001.088943,61,82,0.6,21,0.028571429,38
3000.686804,54,80,0.76,26,0.029230769,38
3000.484767,48,73,0.96,25,0.0384,38
3000.361838,46,61,0.48,15,0.032,38
3000.123016,59,88,0.76,29,0.026206897,38
2999.651306,54,86,0.95,32,0.0296875,38
2999.577629,54,89,0.92,35,0.026285714,38
2999.535047,56,89,0.77,33,0.023333333,38
2999.535047,55,90,0.82,35,0.023428571,38
2999.535047,54,92,0.88,38,0.023157895,38
2999.469659,52,80,0.92,28,0.032857143,38
2999.217588,33,56,0.89,23,0.038695652,38
2999.153229,44,58,0.09,14,0.006428571,38
2998.557524,62,74,0.37,12,0.030833333,38
2998.372366,52,75,0.76,23,0.033043478,38
2998.170544,63,74,0.34,11,0.030909091,38
2998.170544,60,76,0.5,16,0.03125,38
2998.170544,59,77,0.56,18,0.031111111,38
2998.170544,57,80,0.71,23,0.030869565,38
2998.079248,51,85,0.97,34,0.028529412,38
2998.061578,60,85,0.58,25,0.0232,38
2997.984109,42,64,0.74,22,0.033636364,38
2997.984109,41,66,0.83,25,0.0332,38
2997.984109,40,67,0.9,27,0.033333333,38
2997.984109,40,68,0.92,28,0.032857143,38
2997.749494,64,79,0.42,15,0.028,38
2997.608471,70,75,0.13,5,0.026,38
2997.436794,64,80,0.45,16,0.028125,38
2997.436794,63,81,0.51,18,0.028333333,38
2997.436794,60,85,0.7,25,0.028,38
2997.008781,51,84,0.98,33,0.02969697,38
2996.737137,59,63,0.15,4,0.0375,38
2996.532817,54,69,0.55,15,0.036666667,38
2996.355771,59,81,0.65,22,0.029545455,38
2996.355771,58,82,0.71,24,0.029583333,38
2996.221082,53,80,0.87,27,0.032222222,38
2996.044955,56,88,0.9,32,0.028125,38
2996.044955,55,89,0.96,34,0.028235294,38
2995.751003,59,85,0.74,26,0.028461538,38
2995.119053,56,73,0.58,17,0.034117647,38
2995.119053,55,74,0.65,19,0.034210526,38
2994.877236,57,83,0.77,26,0.029615385,38
2994.760351,58,73,0.44,15,0.029333333,38
2994.397129,59,88,0.75,29,0.025862069,38
2994.397129,56,92,0.93,36,0.025833333,38
2993.963318,62,70,0.23,8,0.02875,38
2993.657048,58,89,0.68,31,0.021935484,38
2993.491436,52,84,0.9,32,0.028125,38
2993.491436,51,85,0.96,34,0.028235294,38
2992.953292,40,50,0.37,10,0.037,38
2992.883718,50,77,0.9,27,0.033333333,38
2991.720697,58,88,0.83,30,0.027666667,38
2991.562531,55,79,0.74,24,0.030833333,38
2991.559602,67,76,0.24,9,0.026666667,38
2991.338022,41,60,0.13,19,0.006842105,38
2991.108902,66,78,0.34,12,0.028333333,38
2990.821695,63,81,0.5,18,0.027777778,38
2990.221763,54,80,0.74,26,0.028461538,38
2990.060496,59,77,0.49,18,0.027222222,38
2989.818155,54,73,0.62,19,0.032631579,38
2989.591349,57,66,0.33,9,0.036666667,38
2989.590177,55,90,0.91,35,0.026,38
2989.282838,56,90,0.78,34,0.022941176,38
2989.106121,57,76,0.56,19,0.029473684,38
2989.106121,56,77,0.62,21,0.02952381,38
2988.765384,60,78,0.55,18,0.030555556,38
2988.571365,55,68,0.48,13,0.036923077,38
2988.341822,65,69,0.11,4,0.0275,38
2988.341822,63,71,0.22,8,0.0275,38
2988.341822,61,73,0.33,12,0.0275,38
2988.341822,59,75,0.44,16,0.0275,38
2988.33653,55,82,0.77,27,0.028518519,38
2988.18467,60,85,0.69,25,0.0276,38
2987.823277,58,77,0.52,19,0.027368421,38
2987.654105,53,82,0.84,29,0.028965517,38
2987.409875,53,84,0.87,31,0.028064516,38
2987.128078,59,86,0.71,27,0.026296296,38
2986.860994,61,83,0.58,22,0.026363636,38
2986.851311,46,65,0.54,19,0.028421053,38
2986.570791,60,84,0.67,24,0.027916667,38
2986.27286,55,80,0.79,25,0.0316,38
2986.27286,53,83,0.94,30,0.031333333,38
2986.256246,59,85,0.67,26,0.025769231,38
2986.256246,58,87,0.74,29,0.025517241,38
2985.849267,56,78,0.62,22,0.028181818,38
2985.759153,63,82,0.52,19,0.027368421,38
2985.51875,60,75,0.41,15,0.027333333,38
2985.487912,61,69,0.24,8,0.03,38
2985.487912,60,70,0.3,10,0.03,38
2985.096599,65,78,0.37,13,0.028461538,38
2985.096599,62,81,0.54,19,0.028421053,38
2984.956737,55,77,0.66,22,0.03,38
2984.783815,49,78,0.97,29,0.033448276,38
2984.671189,42,63,0.7,21,0.033333333,38
2984.557838,57,78,0.57,21,0.027142857,38
2984.382011,52,83,0.88,31,0.028387097,38
2983.873842,66,79,0.34,13,0.026153846,38
2983.800387,58,87,0.73,29,0.025172414,38
2983.67458,59,87,0.76,28,0.027142857,38
2983.673565,52,83,0.9,31,0.029032258,38
2983.673565,51,84,0.96,33,0.029090909,38
2983.524007,48,74,0.98,26,0.037692308,38
2983.387868,54,77,0.76,23,0.033043478,38
2983.169062,55,74,0.59,19,0.031052632,38
2983.071409,58,89,0.82,31,0.026451613,38
2983.028473,56,79,0.64,23,0.027826087,38
2983.028473,54,81,0.75,27,0.027777778,38
2983.013235,56,78,0.61,22,0.027727273,38
2983.013235,55,79,0.67,24,0.027916667,38
2982.872411,52,87,0.94,35,0.026857143,38
2982.776383,56,80,0.7,24,0.029166667,38
2982.776383,55,81,0.76,26,0.029230769,38
2982.609396,41,64,0.78,23,0.033913043,38
2982.337718,52,82,0.88,30,0.029333333,38
2982.251529,41,47,0.23,6,0.038333333,38
2982.202733,70,74,0.11,4,0.0275,38
2982.202733,68,76,0.22,8,0.0275,38
2982.02994,49,55,0.2,6,0.033333333,38
2981.583393,64,71,0.22,7,0.031428571,38
2981.583393,63,73,0.31,10,0.031,38
2981.583393,62,75,0.4,13,0.030769231,38
2980.969546,55,79,0.71,24,0.029583333,38
2980.845267,58,77,0.53,19,0.027894737,38
2980.438541,61,76,0.46,15,0.030666667,38
2980.363666,61,74,0.35,13,0.026923077,38
2980.363666,59,76,0.46,17,0.027058824,38
2980.301136,57,84,0.79,27,0.029259259,38
2980.301136,56,85,0.85,29,0.029310345,38
2980.040095,59,85,0.68,26,0.026153846,38
2979.841833,54,75,0.72,21,0.034285714,38
2979.836446,53,76,0.79,23,0.034347826,38
2979.786186,60,84,0.68,24,0.028333333,38
2978.933053,60,84,0.63,24,0.02625,38
2978.846204,56,78,0.65,22,0.029545455,38
2978.709619,42,64,0.76,22,0.034545455,38
2978.082006,51,76,0.83,25,0.0332,38
2977.900025,57,75,0.52,18,0.028888889,38
2977.86857,57,78,0.61,21,0.029047619,38
2977.671749,58,75,0.49,17,0.028823529,38
2977.671749,57,76,0.55,19,0.028947368,38
2977.498861,51,83,0.99,32,0.0309375,38
2977.002716,64,82,0.47,18,0.026111111,38
2976.916977,46,58,0.4,12,0.033333333,38
2976.763843,57,90,0.86,33,0.026060606,38
2976.343048,61,78,0.51,17,0.03,38
2976.008051,59,74,0.44,15,0.029333333,38
2975.656923,51,83,0.95,32,0.0296875,38
2975.610623,63,80,0.46,17,0.027058824,38
2975.415664,57,74,0.56,17,0.032941176,38
2975.350965,54,82,0.81,28,0.028928571,38
2975.308717,53,85,0.87,32,0.0271875,38
2975.182608,60,87,0.7,27,0.025925926,38
2975.003485,56,80,0.69,24,0.02875,38
2974.984779,53,86,0.86,33,0.026060606,38
2974.322282,66,82,0.34,16,0.02125,38
2974.305211,57,72,0.51,15,0.034,38
2973.557871,55,82,0.83,27,0.030740741,38
2973.439025,58,81,0.68,23,0.029565217,38
2973.369266,56,81,0.77,25,0.0308,38
2973.202388,59,89,0.78,30,0.026,38
2973.114051,61,84,0.63,23,0.027391304,38
2972.693194,37,52,0.72,15,0.048,38
2972.616143,56,91,0.79,35,0.022571429,38
2972.607442,58,75,0.48,17,0.028235294,38
2972.39501,56,79,0.68,23,0.029565217,38
2972.389636,54,82,0.82,28,0.029285714,38
2971.898817,52,83,0.95,31,0.030645161,38
2971.722822,65,79,0.37,14,0.026428571,38
2971.508225,40,68,0.93,28,0.033214286,38
2971.458289,54,76,0.67,22,0.030454545,38
2971.029157,58,74,0.46,16,0.02875,38
2970.848366,43,62,0.62,19,0.032631579,38
2970.636064,45,61,0.54,16,0.03375,38
2970.575597,66,79,0.35,13,0.026923077,38
2970.575597,64,81,0.46,17,0.027058824,38
2970.410782,56,78,0.63,22,0.028636364,38
2970.410782,55,79,0.69,24,0.02875,38
2970.410782,55,80,0.71,25,0.0284,38
2970.410782,54,80,0.75,26,0.028846154,38
2970.410782,54,81,0.77,27,0.028518519,38
2970.410782,53,82,0.83,29,0.02862069,38
2970.410782,52,83,0.89,31,0.028709677,38
2970.191966,55,91,0.83,36,0.023055556,38
2970.087226,61,77,0.49,16,0.030625,38
2970.020868,49,79,0.99,30,0.033,38
2969.853838,57,88,0.79,31,0.025483871,38
2969.853838,56,89,0.84,33,0.025454545,38
2969.853838,55,91,0.91,36,0.025277778,38
2969.754838,48,74,0.99,26,0.038076923,38
2969.587137,53,84,0.89,31,0.028709677,38
2969.586439,54,83,0.83,29,0.02862069,38
2969.145896,53,77,0.81,24,0.03375,38
2969.079098,67,76,0.25,9,0.027777778,38
2969.079098,62,81,0.53,19,0.027894737,38
2969.079098,61,83,0.61,22,0.027727273,38
2969.079098,59,85,0.72,26,0.027692308,38
2969.079098,58,87,0.8,29,0.027586207,38
2968.923605,57,82,0.74,25,0.0296,38
2968.923605,56,83,0.8,27,0.02962963,38
2968.923605,55,84,0.86,29,0.029655172,38
2968.923605,54,85,0.92,31,0.029677419,38
2968.649432,49,72,0.88,23,0.03826087,38
2968.570284,64,68,0.13,4,0.0325,38
2968.541103,46,59,0.45,13,0.034615385,38
2968.287647,53,82,0.86,29,0.029655172,38
2968.287647,52,83,0.92,31,0.029677419,38
2968.173637,70,78,0.17,8,0.02125,38
2967.149417,39,67,0.95,28,0.033928571,38
2966.943029,62,83,0.57,21,0.027142857,38
2966.943029,60,86,0.7,26,0.026923077,38
2966.943029,58,88,0.81,30,0.027,38
2966.943029,56,91,0.94,35,0.026857143,38
2966.429082,51,77,0.84,26,0.032307692,38
2966.260693,50,55,0.17,5,0.034,38
2966.102396,59,86,0.74,27,0.027407407,38
2966.102396,57,88,0.85,31,0.027419355,38
2966.102396,57,89,0.87,32,0.0271875,38
2966.102396,56,90,0.93,34,0.027352941,38
2966.018852,62,83,0.58,21,0.027619048,38
2965.755308,59,86,0.75,27,0.027777778,38
2965.737531,66,77,0.31,11,0.028181818,38
2965.737531,63,80,0.48,17,0.028235294,38
2965.737531,62,82,0.56,20,0.028,38
2965.736846,56,79,0.63,23,0.027391304,38
2965.462643,52,84,0.94,32,0.029375,38
2965.386276,66,71,0.14,5,0.028,38
2965.386276,63,74,0.31,11,0.028181818,38
2964.640837,57,89,0.84,32,0.02625,38
2964.437825,59,79,0.61,20,0.0305,38
2964.43412,50,82,0.96,32,0.03,38
2963.879377,56,71,0.49,15,0.032666667,38
2963.693629,59,80,0.57,21,0.027142857,38
2962.770943,55,78,0.66,23,0.028695652,38
2962.770943,54,79,0.72,25,0.0288,38
2962.635777,81,85,0.07,4,0.0175,38
2962.635777,79,87,0.14,8,0.0175,38
2962.306475,51,80,0.97,29,0.033448276,38
2962.267122,54,84,0.8,30,0.026666667,38
2962.267122,53,86,0.87,33,0.026363636,38
2962.245406,52,76,0.77,24,0.032083333,38
2961.988658,57,89,0.73,32,0.0228125,38
2961.924939,59,80,0.55,21,0.026190476,38
2961.590098,57,69,0.4,12,0.033333333,38
2961.254725,57,82,0.66,25,0.0264,38
2961.163992,47,58,0.38,11,0.034545455,38
2960.985599,60,72,0.35,12,0.029166667,38
2960.711067,61,77,0.47,16,0.029375,38
2960.711067,60,78,0.53,18,0.029444444,38
2960.56428,44,62,0.61,18,0.033888889,38
2960.56428,43,63,0.68,20,0.034,38
2960.078744,61,72,0.32,11,0.029090909,38
2960.078744,60,73,0.38,13,0.029230769,38
2960.078744,58,76,0.52,18,0.028888889,38
2960.078744,57,77,0.58,20,0.029,38
2960.078744,56,78,0.64,22,0.029090909,38
2959.981205,39,67,0.96,28,0.034285714,38
2959.827702,53,83,0.95,30,0.031666667,38
2959.81866,50,78,0.92,28,0.032857143,38
2959.314359,43,63,0.65,20,0.0325,38
2959.038565,52,79,0.9,27,0.033333333,38
2958.977445,52,70,0.68,18,0.037777778,38
2958.854204,54,80,0.86,26,0.033076923,38
2958.736067,62,84,0.57,22,0.025909091,38
2958.641666,53,78,0.83,25,0.0332,38
2958.641666,51,81,0.99,30,0.033,38
2958.428583,60,63,0.11,3,0.036666667,38
2958.187533,56,77,0.61,21,0.029047619,38
2958.187533,55,78,0.67,23,0.029130435,38
2957.955585,67,80,0.28,13,0.021538462,38
2957.741001,57,88,0.86,31,0.027741935,38
2957.66423,51,72,0.77,21,0.036666667,38
2957.529241,57,74,0.5,17,0.029411765,38
2957.430207,55,86,0.91,31,0.029354839,38
2957.333567,56,89,0.79,33,0.023939394,38
2957.164097,66,80,0.36,14,0.025714286,38
2957.011773,45,59,0.47,14,0.033571429,38
2956.92701,54,79,0.74,25,0.0296,38
2956.845676,54,81,0.79,27,0.029259259,38
2956.845676,53,82,0.85,29,0.029310345,38
2956.845676,52,83,0.91,31,0.029354839,38
2956.715126,57,89,0.88,32,0.0275,38
2956.715126,56,90,0.94,34,0.027647059,38
2956.445604,55,78,0.68,23,0.029565217,38
2956.434658,59,85,0.73,26,0.028076923,38
2956.181215,49,74,0.94,25,0.0376,38
2956.10727,46,60,0.47,14,0.033571429,38
2956.0908,56,87,0.8,31,0.025806452,38
2955.933848,56,77,0.6,21,0.028571429,38
2955.621677,54,87,0.97,33,0.029393939,38
2955.602045,66,78,0.33,12,0.0275,38
2955.399347,49,56,0.24,7,0.034285714,38
2955.201745,59,86,0.68,27,0.025185185,38
2955.085495,52,84,0.91,32,0.0284375,38
2955.058904,44,63,0.64,19,0.033684211,38
2954.70388,63,67,0.12,4,0.03,38
2954.70388,62,68,0.18,6,0.03,38
2954.587143,62,77,0.45,15,0.03,38
2954.126426,58,75,0.51,17,0.03,38
2953.921028,61,83,0.62,22,0.028181818,38
2953.886115,63,72,0.25,9,0.027777778,38
2953.770157,57,89,0.82,32,0.025625,38
2953.753284,67,75,0.2,8,0.025,38
2953.753284,66,76,0.25,10,0.025,38
2953.566211,65,82,0.44,17,0.025882353,38
2953.423869,55,77,0.64,22,0.029090909,38
2953.106658,56,75,0.56,19,0.029473684,38
2953.106658,55,76,0.62,21,0.02952381,38
2952.910806,61,77,0.48,16,0.03,38
2952.833283,59,74,0.42,15,0.028,38
2952.543641,54,84,0.82,30,0.027333333,38
2952.42674,65,78,0.36,13,0.027692308,38
2952.387662,52,86,0.92,34,0.027058824,38
2952.250996,56,91,0.95,35,0.027142857,38
2952.150131,67,77,0.28,10,0.028,38
2952.060204,56,89,0.94,33,0.028484848,38
2951.947522,42,64,0.71,22,0.032272727,38
2951.88778,58,87,0.81,29,0.027931034,38
2951.821663,58,78,0.62,20,0.031,38
2951.545396,52,89,0.96,37,0.025945946,38
2951.140141,58,83,0.73,25,0.0292,38
2951.052384,60,85,0.66,25,0.0264,38
2951.052384,58,87,0.77,29,0.026551724,38
2951.052384,55,92,0.97,37,0.026216216,38
2950.88328,51,84,0.94,33,0.028484848,38
2950.441837,52,83,0.99,31,0.031935484,38
2950.402894,60,65,0.17,5,0.034,38
2949.666022,55,84,0.85,29,0.029310345,38
2949.62824,60,73,0.43,13,0.033076923,38
2949.466188,60,85,0.68,25,0.0272,38
2949.404972,46,60,0.45,14,0.032142857,38
2949.300598,43,65,0.71,22,0.032272727,38
2949.127444,60,84,0.62,24,0.025833333,38
2948.411887,54,78,0.72,24,0.03,38
2948.411887,53,79,0.78,26,0.03,38
2948.018803,52,72,0.73,20,0.0365,38
2947.824325,53,81,0.92,28,0.032857143,38
2947.641608,56,91,0.88,35,0.025142857,38
2947.641191,41,67,0.88,26,0.033846154,38
2947.354638,44,61,0.55,17,0.032352941,38
2947.244239,56,79,0.73,23,0.03173913,38
2947.167803,50,78,0.91,28,0.0325,38
2947.167803,49,79,0.98,30,0.032666667,38
2947.005333,52,76,0.84,24,0.035,38
2946.714232,56,89,0.85,33,0.025757576,38
2946.641213,62,71,0.26,9,0.028888889,38
2946.641213,60,74,0.4,14,0.028571429,38
2946.641213,59,75,0.46,16,0.02875,38
2946.50716,57,78,0.67,21,0.031904762,38
2946.387819,59,75,0.52,16,0.0325,38
2946.383716,71,95,0.42,24,0.0175,38
2946.236893,58,75,0.5,17,0.029411765,38
2945.377541,48,57,0.31,9,0.034444444,38
2944.227252,51,73,0.81,22,0.036818182,38
2944.22529,56,86,0.87,30,0.029,38
2944.17139,61,82,0.59,21,0.028095238,38
2943.982323,62,78,0.47,16,0.029375,38
2943.982323,61,79,0.53,18,0.029444444,38
2943.980151,48,58,0.33,10,0.033,38
2943.853905,60,85,0.71,25,0.0284,38
2943.501942,56,76,0.59,20,0.0295,38
2943.439227,33,67,0.39,34,0.011470588,38
2943.30137,52,82,0.96,30,0.032,38
2942.874117,64,80,0.42,16,0.02625,38
2942.874117,60,85,0.65,25,0.026,38
2942.777743,63,70,0.23,7,0.032857143,38
2942.687179,47,59,0.4,12,0.033333333,38
