% profit,ema1,ema2,threshold,diff,thresh / diff,ID
3878.695845,43,51,0.29,8,0.03625,23
3787.960965,44,50,0.22,6,0.036666667,23
3745.987675,42,52,0.36,10,0.036,23
3717.283456,42,51,0.33,9,0.036666667,23
3712.298793,39,55,0.58,16,0.03625,23
3700.486729,42,51,0.34,9,0.037777778,23
3698.641803,45,48,0.11,3,0.036666667,23
3689.182147,57,71,0.46,14,0.032857143,23
3627.042753,40,54,0.51,14,0.036428571,23
3615.121757,47,66,0.52,19,0.027368421,23
3612.060912,39,55,0.59,16,0.036875,23
3606.525209,38,56,0.66,18,0.036666667,23
3598.191966,51,62,0.3,11,0.027272727,23
3577.084973,43,71,0.76,28,0.027142857,23
3570.141406,44,51,0.25,7,0.035714286,23
3568.423722,53,74,0.73,21,0.034761905,23
3568.423722,52,75,0.8,23,0.034782609,23
3566.272058,56,72,0.53,16,0.033125,23
3563.161089,56,71,0.51,15,0.034,23
3563.161089,52,76,0.81,24,0.03375,23
3563.054312,61,65,0.14,4,0.035,23
3563.054312,60,66,0.21,6,0.035,23
3563.054312,59,67,0.28,8,0.035,23
3562.164202,41,74,0.88,33,0.026666667,23
3551.665156,53,75,0.75,22,0.034090909,23
3551.665156,52,76,0.82,24,0.034166667,23
3543.865713,55,72,0.58,17,0.034117647,23
3541.523209,52,61,0.22,9,0.024444444,23
3537.47697,36,59,0.83,23,0.036086957,23
3537.275018,55,72,0.59,17,0.034705882,23
3536.017672,45,68,0.63,23,0.027391304,23
3535.938901,54,73,0.65,19,0.034210526,23
3535.938901,53,74,0.72,21,0.034285714,23
3535.938901,52,75,0.79,23,0.034347826,23
3535.938901,51,76,0.86,25,0.0344,23
3532.026328,51,77,0.89,26,0.034230769,23
3531.803076,42,72,0.81,30,0.027,23
3531.209567,59,73,0.44,14,0.031428571,23
3530.725745,42,50,0.31,8,0.03875,23
3530.04687,55,73,0.6,18,0.033333333,23
3528.521061,58,69,0.38,11,0.034545455,23
3527.951762,58,68,0.35,10,0.035,23
3527.951762,57,69,0.42,12,0.035,23
3527.951762,56,70,0.49,14,0.035,23
3526.500932,50,78,0.96,28,0.034285714,23
3525.729675,37,58,0.75,21,0.035714286,23
3524.616469,57,70,0.45,13,0.034615385,23
3524.047783,54,73,0.66,19,0.034736842,23
3520.87319,62,70,0.25,8,0.03125,23
3518.281273,56,71,0.52,15,0.034666667,23
3509.006703,62,64,0.07,2,0.035,23
3508.864804,58,69,0.37,11,0.033636364,23
3508.864804,54,74,0.67,20,0.0335,23
3505.689138,54,73,0.64,19,0.033684211,23
3503.204562,61,66,0.17,5,0.034,23
3501.993707,53,78,0.81,25,0.0324,23
3501.468166,55,76,0.68,21,0.032380952,23
3501.144699,52,79,0.88,27,0.032592593,23
3499.224933,60,67,0.24,7,0.034285714,23
3499.224933,59,68,0.31,9,0.034444444,23
3496.736632,41,55,0.5,14,0.035714286,23
3495.990384,63,68,0.16,5,0.032,23
3495.990384,56,76,0.64,20,0.032,23
3495.990384,55,77,0.7,22,0.031818182,23
3495.990384,54,78,0.77,24,0.032083333,23
3495.740885,53,74,0.71,21,0.033809524,23
3495.55177,46,71,0.59,25,0.0236,23
3494.731656,59,70,0.36,11,0.032727273,23
3494.497667,54,72,0.62,18,0.034444444,23
3492.551416,53,75,0.74,22,0.033636364,23
3492.395135,51,77,0.88,26,0.033846154,23
3492.395135,50,78,0.95,28,0.033928571,23
3491.870629,58,73,0.48,15,0.032,23
3490.863424,55,75,0.65,20,0.0325,23
3488.487841,49,64,0.41,15,0.027333333,23
3488.347548,51,79,0.95,28,0.033928571,23
3488.189168,37,57,0.74,20,0.037,23
3488.169124,57,73,0.52,16,0.0325,23
3488.169124,56,75,0.61,19,0.032105263,23
3488.169124,54,77,0.74,23,0.032173913,23
3487.645599,59,71,0.39,12,0.0325,23
3487.323374,54,76,0.72,22,0.032727273,23
3487.255199,40,57,0.6,17,0.035294118,23
3485.193949,41,54,0.45,13,0.034615385,23
3480.8447,61,70,0.29,9,0.032222222,23
3480.8447,59,72,0.42,13,0.032307692,23
3480.8447,57,74,0.55,17,0.032352941,23
3480.684414,41,54,0.47,13,0.036153846,23
3479.63561,52,75,0.78,23,0.033913043,23
3479.63561,51,76,0.85,25,0.034,23
3479.533976,53,79,0.84,26,0.032307692,23
3478.163187,57,75,0.57,18,0.031666667,23
3475.819855,45,69,0.65,24,0.027083333,23
3473.426351,45,50,0.18,5,0.036,23
3473.382587,60,71,0.35,11,0.031818182,23
3473.056381,63,67,0.13,4,0.0325,23
3473.056381,61,69,0.26,8,0.0325,23
3472.735467,61,68,0.23,7,0.032857143,23
3472.735467,56,74,0.59,18,0.032777778,23
3472.211708,57,70,0.44,13,0.033846154,23
3469.843206,35,60,0.91,25,0.0364,23
3468.928109,46,48,0.07,2,0.035,23
3463.744081,39,56,0.61,17,0.035882353,23
3461.484985,62,69,0.22,7,0.031428571,23
3460.274342,50,77,0.93,27,0.034444444,23
3459.335774,44,70,0.71,26,0.027307692,23
3455.11589,60,70,0.32,10,0.032,23
3451.878251,58,71,0.43,13,0.033076923,23
3451.878251,53,77,0.79,24,0.032916667,23
3450.082622,54,77,0.75,23,0.032608696,23
3449.445365,51,80,0.95,29,0.032758621,23
3448.759031,52,78,0.88,26,0.033846154,23
3447.982959,46,71,0.6,25,0.024,23
3447.876132,45,46,0.04,1,0.04,23
3443.808874,40,56,0.57,16,0.035625,23
3443.209155,52,79,0.9,27,0.033333333,23
3442.890921,51,80,0.97,29,0.033448276,23
3442.25159,39,57,0.61,18,0.033888889,23
3441.389582,40,55,0.54,15,0.036,23
3436.656889,43,53,0.36,10,0.036,23
3436.457276,58,72,0.46,14,0.032857143,23
3434.034952,53,78,0.82,25,0.0328,23
3432.741929,35,62,0.96,27,0.035555556,23
3431.371097,50,65,0.36,15,0.024,23
3431.319513,56,73,0.57,17,0.033529412,23
3429.284307,50,63,0.36,13,0.027692308,23
3428.664594,52,80,0.91,28,0.0325,23
3428.600404,39,58,0.68,19,0.035789474,23
3425.936612,52,79,0.89,27,0.032962963,23
3425.766478,52,78,0.87,26,0.033461538,23
3425.766478,51,79,0.94,28,0.033571429,23
3425.61993,54,76,0.73,22,0.033181818,23
3425.61993,53,77,0.8,24,0.033333333,23
3425.61993,51,80,0.96,29,0.033103448,23
3424.313294,38,59,0.76,21,0.036190476,23
3420.974129,56,75,0.62,19,0.032631579,23
3420.578561,51,81,0.98,30,0.032666667,23
3420.214862,40,76,0.95,36,0.026388889,23
3417.523293,46,67,0.58,21,0.027619048,23
3416.55151,44,53,0.32,9,0.035555556,23
3415.190217,52,78,0.86,26,0.033076923,23
3413.000479,55,75,0.66,20,0.033,23
3412.914635,45,72,0.64,27,0.023703704,23
3412.471498,41,56,0.53,15,0.035333333,23
3412.234457,55,74,0.64,19,0.033684211,23
3412.088472,51,79,0.93,28,0.033214286,23
3412.018903,48,66,0.49,18,0.027222222,23
3410.760064,41,55,0.51,14,0.036428571,23
3410.521206,40,57,0.61,17,0.035882353,23
3408.305289,38,57,0.71,19,0.037368421,23
3407.843514,41,74,0.89,33,0.026969697,23
3407.291317,40,55,0.55,15,0.036666667,23
3406.266846,42,72,0.82,30,0.027333333,23
3406.209916,51,62,0.27,11,0.024545455,23
3405.236018,39,57,0.65,18,0.036111111,23
3405.051585,38,57,0.69,19,0.036315789,23
3403.181121,58,72,0.45,14,0.032142857,23
3402.866482,56,74,0.58,18,0.032222222,23
3399.155362,44,74,0.71,30,0.023666667,23
3396.498204,37,63,0.9,26,0.034615385,23
3396.381102,43,48,0.2,5,0.04,23
3395.738017,44,47,0.12,3,0.04,23
3394.480205,39,56,0.63,17,0.037058824,23
3394.311577,42,52,0.37,10,0.037,23
3394.069558,39,58,0.67,19,0.035263158,23
3392.501403,60,69,0.3,9,0.033333333,23
3392.501403,57,72,0.5,15,0.033333333,23
3392.1156,45,49,0.14,4,0.035,23
3390.39193,38,58,0.68,20,0.034,23
3389.32471,44,74,0.72,30,0.024,23
3386.812258,48,66,0.44,18,0.024444444,23
3386.717101,44,54,0.35,10,0.035,23
3385.241771,44,52,0.29,8,0.03625,23
3382.184277,42,53,0.4,11,0.036363636,23
3380.970594,44,50,0.21,6,0.035,23
3380.001102,40,55,0.52,15,0.034666667,23
3378.466253,41,53,0.44,12,0.036666667,23
3377.935414,40,56,0.58,16,0.03625,23
3377.215084,37,59,0.78,22,0.035454545,23
3376.997992,35,62,0.98,27,0.036296296,23
3376.770968,43,54,0.39,11,0.035454545,23
3374.994477,43,74,0.82,31,0.026451613,23
3374.138814,42,73,0.83,31,0.026774194,23
3373.746465,45,53,0.26,8,0.0325,23
3373.665999,55,57,0.05,2,0.025,23
3373.665999,54,58,0.1,4,0.025,23
3372.840461,39,56,0.62,17,0.036470588,23
3372.72788,43,73,0.74,30,0.024666667,23
3372.089208,42,56,0.49,14,0.035,23
3371.933664,51,63,0.29,12,0.024166667,23
3371.419133,48,67,0.51,19,0.026842105,23
3370.723579,42,55,0.46,13,0.035384615,23
3368.082334,43,55,0.42,12,0.035,23
3367.750391,43,74,0.81,31,0.026129032,23
3365.582965,37,59,0.79,22,0.035909091,23
3365.288608,35,62,0.97,27,0.035925926,23
3364.895555,42,54,0.43,12,0.035833333,23
3361.416431,36,60,0.86,24,0.035833333,23
3359.887751,45,72,0.66,27,0.024444444,23
3357.826853,47,51,0.13,4,0.0325,23
3356.121933,44,73,0.76,29,0.026206897,23
3354.498918,43,75,0.78,32,0.024375,23
3353.267938,49,64,0.37,15,0.024666667,23
3352.593588,38,57,0.68,19,0.035789474,23
3352.309291,41,51,0.39,10,0.039,23
3351.694449,35,61,0.94,26,0.036153846,23
3350.911053,43,51,0.3,8,0.0375,23
3348.089488,41,73,0.87,32,0.0271875,23
3347.768934,52,62,0.27,10,0.027,23
3347.498324,40,74,0.92,34,0.027058824,23
3345.756041,36,59,0.84,23,0.036521739,23
3345.748648,39,56,0.59,17,0.034705882,23
3345.450642,46,70,0.59,24,0.024583333,23
3343.532963,36,64,0.98,28,0.035,23
3343.310317,41,57,0.56,16,0.035,23
3342.231798,44,72,0.69,28,0.024642857,23
3341.856064,42,76,0.89,34,0.026176471,23
3340.599774,54,75,0.69,21,0.032857143,23
3340.599774,53,76,0.76,23,0.033043478,23
3340.073695,47,67,0.5,20,0.025,23
3339.337642,38,62,0.83,24,0.034583333,23
3338.849346,56,73,0.56,17,0.032941176,23
3338.370651,44,54,0.33,10,0.033,23
3338.352577,36,60,0.87,24,0.03625,23
3337.382509,36,61,0.84,25,0.0336,23
3336.718517,37,58,0.76,21,0.036190476,23
3336.020271,41,53,0.45,12,0.0375,23
3334.346454,52,76,0.83,24,0.034583333,23
3333.966738,39,59,0.71,20,0.0355,23
3333.674894,39,60,0.73,21,0.034761905,23
3333.53604,45,71,0.64,26,0.024615385,23
3331.28681,41,56,0.54,15,0.036,23
3330.648726,60,80,0.55,20,0.0275,23
3330.300667,49,66,0.41,17,0.024117647,23
3329.445146,37,59,0.8,22,0.036363636,23
3328.485184,40,58,0.63,18,0.035,23
3328.360375,52,77,0.84,25,0.0336,23
3328.360375,51,78,0.91,27,0.033703704,23
3327.974174,40,77,0.98,37,0.026486486,23
3327.700466,58,83,0.67,25,0.0268,23
3326.760527,41,52,0.42,11,0.038181818,23
3326.431772,44,69,0.69,25,0.0276,23
3326.005645,44,71,0.73,27,0.027037037,23
3324.81258,40,54,0.53,14,0.037857143,23
3324.010584,45,72,0.65,27,0.024074074,23
3322.617925,60,81,0.56,21,0.026666667,23
3322.456591,61,67,0.2,6,0.033333333,23
3322.456591,58,70,0.4,12,0.033333333,23
3322.073489,50,64,0.34,14,0.024285714,23
3322.033888,36,64,0.99,28,0.035357143,23
3321.646232,45,71,0.69,26,0.026538462,23
3321.277519,44,73,0.71,29,0.024482759,23
3320.902371,50,79,0.98,29,0.033793103,23
3320.485348,54,69,0.53,15,0.035333333,23
3320.485348,53,70,0.6,17,0.035294118,23
3319.322519,46,68,0.6,22,0.027272727,23
3318.251127,47,50,0.1,3,0.033333333,23
3318.172529,33,54,0.85,21,0.04047619,23
3318.089502,41,75,0.91,34,0.026764706,23
3317.053793,39,61,0.77,22,0.035,23
3317.013194,57,85,0.75,28,0.026785714,23
3316.85017,49,65,0.39,16,0.024375,23
3316.569085,37,49,0.47,12,0.039166667,23
3316.569085,34,53,0.74,19,0.038947368,23
3316.494637,48,63,0.42,15,0.028,23
3316.412396,54,74,0.69,20,0.0345,23
3316.412396,53,75,0.76,22,0.034545455,23
3315.901737,55,74,0.63,19,0.033157895,23
3314.970435,38,61,0.8,23,0.034782609,23
3314.837568,39,59,0.7,20,0.035,23
3313.795009,56,84,0.78,28,0.027857143,23
3313.387607,50,79,0.99,29,0.034137931,23
3313.150402,45,70,0.61,25,0.0244,23
3312.482112,48,65,0.47,17,0.027647059,23
3312.480345,50,63,0.32,13,0.024615385,23
3312.393573,55,88,0.87,33,0.026363636,23
3311.478559,40,75,0.94,35,0.026857143,23
3309.149404,40,48,0.3,8,0.0375,23
3308.775967,45,71,0.7,26,0.026923077,23
3308.48554,56,86,0.8,30,0.026666667,23
3308.454233,56,86,0.81,30,0.027,23
3308.454233,55,88,0.88,33,0.026666667,23
3308.454233,54,89,0.94,35,0.026857143,23
3308.317906,44,72,0.75,28,0.026785714,23
3308.150569,59,69,0.34,10,0.034,23
3307.413173,58,83,0.68,25,0.0272,23
3306.425355,55,86,0.84,31,0.027096774,23
3305.281979,53,59,0.15,6,0.025,23
3304.919056,42,53,0.38,11,0.034545455,23
3304.263867,44,49,0.19,5,0.038,23
3303.668391,46,68,0.55,22,0.025,23
3303.334422,58,84,0.69,26,0.026538462,23
3303.319135,43,51,0.28,8,0.035,23
3303.064678,57,83,0.72,26,0.027692308,23
3303.064678,54,87,0.91,33,0.027575758,23
3302.938586,52,77,0.83,25,0.0332,23
3302.664274,42,76,0.88,34,0.025882353,23
3302.073409,46,67,0.53,21,0.025238095,23
3302.029834,42,52,0.35,10,0.035,23
3301.106463,44,51,0.23,7,0.032857143,23
3301.081746,40,56,0.52,16,0.0325,23
3300.749777,54,87,0.9,33,0.027272727,23
3299.472629,44,71,0.72,27,0.026666667,23
3299.355339,52,60,0.26,8,0.0325,23
3299.144954,53,89,0.96,36,0.026666667,23
3297.712234,47,67,0.54,20,0.027,23
3297.614245,55,87,0.86,32,0.026875,23
3296.962717,41,54,0.44,13,0.033846154,23
3296.734879,48,68,0.49,20,0.0245,23
3296.734879,47,69,0.54,22,0.024545455,23
3296.130049,60,68,0.27,8,0.03375,23
3295.421215,40,59,0.67,19,0.035263158,23
3295.340656,38,60,0.78,22,0.035454545,23
3295.155258,56,85,0.78,29,0.026896552,23
3293.608466,37,97,0.1,60,0.001666667,23
3292.818727,44,51,0.24,7,0.034285714,23
3292.818727,43,52,0.31,9,0.034444444,23
3291.953348,54,88,0.92,34,0.027058824,23
3291.45674,41,75,0.9,34,0.026470588,23
3291.277565,41,47,0.22,6,0.036666667,23
3291.176303,42,53,0.37,11,0.033636364,23
3290.352676,55,87,0.85,32,0.0265625,23
3290.352676,53,90,0.98,37,0.026486486,23
3290.329094,57,72,0.49,15,0.032666667,23
3289.971678,51,78,0.9,27,0.033333333,23
3289.834435,59,69,0.33,10,0.033,23
3288.267931,36,98,0.11,62,0.001774194,23
3287.666645,47,67,0.49,20,0.0245,23
3287.27869,44,73,0.7,29,0.024137931,23
3286.546544,45,69,0.6,24,0.025,23
3286.3733,54,88,0.91,34,0.026764706,23
3285.866131,43,50,0.26,7,0.037142857,23
3285.184499,54,88,0.9,34,0.026470588,23
3284.436973,41,76,0.92,35,0.026285714,23
3284.059754,43,74,0.76,31,0.024516129,23
3282.892465,37,63,0.91,26,0.035,23
3282.441706,54,89,0.93,35,0.026571429,23
3281.41431,56,72,0.54,16,0.03375,23
3280.993129,40,59,0.66,19,0.034736842,23
3280.61823,54,75,0.7,21,0.033333333,23
3278.696487,36,97,0.13,61,0.002131148,23
3277.775626,55,73,0.61,18,0.033888889,23
3277.635229,53,76,0.77,23,0.033478261,23
3277.381651,57,71,0.47,14,0.033571429,23
3277.177852,50,62,0.34,12,0.028333333,23
3276.973031,42,58,0.51,16,0.031875,23
3276.893544,50,64,0.38,14,0.027142857,23
3276.638936,35,61,0.93,26,0.035769231,23
3275.490727,54,75,0.71,21,0.033809524,23
3275.249246,41,78,0.95,37,0.025675676,23
3275.216893,38,63,0.86,25,0.0344,23
3274.968407,43,70,0.76,27,0.028148148,23
3273.238441,38,50,0.45,12,0.0375,23
3273.099419,58,82,0.66,24,0.0275,23
3273.093865,40,60,0.69,20,0.0345,23
3272.823455,53,88,0.97,35,0.027714286,23
3272.801922,54,89,0.92,35,0.026285714,23
3271.615093,35,61,0.95,26,0.036538462,23
3271.58832,58,84,0.68,26,0.026153846,23
3271.229799,43,72,0.78,29,0.026896552,23
3271.217363,42,46,0.15,4,0.0375,23
3270.427663,54,74,0.68,20,0.034,23
3269.98938,59,82,0.62,23,0.026956522,23
3269.98938,57,84,0.73,27,0.027037037,23
3269.636389,66,75,0.24,9,0.026666667,23
3269.479445,54,90,0.95,36,0.026388889,23
3269.438966,34,52,0.74,18,0.041111111,23
3269.251069,60,79,0.54,19,0.028421053,23
3269.163658,57,84,0.74,27,0.027407407,23
3269.163658,55,87,0.87,32,0.0271875,23
3268.979877,53,90,0.99,37,0.026756757,23
3268.44105,54,88,0.93,34,0.027352941,23
3268.147735,53,76,0.78,23,0.033913043,23
3268.147735,52,77,0.85,25,0.034,23
3268.147735,51,78,0.92,27,0.034074074,23
3267.943056,38,63,0.87,25,0.0348,23
3267.727019,56,86,0.79,30,0.026333333,23
3266.418819,41,58,0.59,17,0.034705882,23
3265.91247,46,69,0.62,23,0.026956522,23
3264.37451,56,85,0.79,29,0.027241379,23
3263.403991,48,65,0.42,17,0.024705882,23
3263.173706,40,74,0.93,34,0.027352941,23
3263.134614,37,62,0.88,25,0.0352,23
3263.047022,43,73,0.8,30,0.026666667,23
3262.993725,41,77,0.95,36,0.026388889,23
3262.98086,40,55,0.51,15,0.034,23
3261.945163,41,52,0.41,11,0.037272727,23
3261.930245,55,87,0.84,32,0.02625,23
3261.902671,50,79,0.97,29,0.033448276,23
3261.898094,53,90,0.97,37,0.026216216,23
3261.309438,53,89,0.98,36,0.027222222,23
3260.669934,47,65,0.5,18,0.027777778,23
3260.222153,44,73,0.77,29,0.026551724,23
3258.820273,39,55,0.61,16,0.038125,23
3258.248774,58,81,0.65,23,0.02826087,23
3258.196257,55,74,0.65,19,0.034210526,23
3258.027791,45,70,0.67,25,0.0268,23
3257.528987,39,60,0.75,21,0.035714286,23
3257.494045,43,57,0.44,14,0.031428571,23
3257.405067,56,87,0.81,31,0.026129032,23
3257.405067,53,91,0.99,38,0.026052632,23
3256.121348,37,58,0.77,21,0.036666667,23
3255.554837,47,65,0.51,18,0.028333333,23
3254.467403,45,52,0.25,7,0.035714286,23
3253.19287,42,74,0.85,32,0.0265625,23
3252.436339,36,62,0.83,26,0.031923077,23
3252.213823,53,58,0.14,5,0.028,23
3252.017895,57,85,0.74,28,0.026428571,23
3251.953905,53,88,0.99,35,0.028285714,23
3251.127624,42,52,0.38,10,0.038,23
3251.057179,53,89,0.97,36,0.026944444,23
3249.562279,61,78,0.48,17,0.028235294,23
3249.562279,58,82,0.67,24,0.027916667,23
3249.301973,37,60,0.76,23,0.033043478,23
3248.219637,41,78,0.96,37,0.025945946,23
3247.280281,40,77,0.97,37,0.026216216,23
3247.1097,61,93,0.61,32,0.0190625,23
3246.526327,45,68,0.64,23,0.027826087,23
3245.228832,40,60,0.7,20,0.035,23
3245.063605,43,56,0.42,13,0.032307692,23
3244.759171,64,77,0.35,13,0.026923077,23
3244.759171,60,81,0.57,21,0.027142857,23
3244.759171,59,83,0.64,24,0.026666667,23
3244.001408,37,96,0.13,59,0.00220339,23
3243.37949,59,83,0.63,24,0.02625,23
3242.956694,55,88,0.86,33,0.026060606,23
3242.956694,54,90,0.93,36,0.025833333,23
3242.419396,40,58,0.64,18,0.035555556,23
3242.180917,48,64,0.46,16,0.02875,23
3241.949343,62,79,0.46,17,0.027058824,23
3241.862045,43,82,0.94,39,0.024102564,23
3241.614245,48,65,0.48,17,0.028235294,23
3241.573349,51,61,0.28,10,0.028,23
3240.834919,38,59,0.67,21,0.031904762,23
3240.768287,35,51,0.65,16,0.040625,23
3240.181912,36,98,0.12,62,0.001935484,23
3240.059818,69,72,0.08,3,0.026666667,23
3239.630013,41,76,0.93,35,0.026571429,23
3239.355837,38,61,0.82,23,0.035652174,23
3238.593156,37,64,0.94,27,0.034814815,23
3238.101775,42,75,0.87,33,0.026363636,23
3236.910618,44,69,0.7,25,0.028,23
3236.791898,56,74,0.6,18,0.033333333,23
3236.381192,58,84,0.7,26,0.026923077,23
3235.652107,35,52,0.66,17,0.038823529,23
3235.52458,57,83,0.73,26,0.028076923,23
3235.52458,56,84,0.79,28,0.028214286,23
3234.673328,55,75,0.67,20,0.0335,23
3234.373824,54,76,0.74,22,0.033636364,23
3234.125206,43,72,0.72,29,0.024827586,23
3234.081259,40,53,0.49,13,0.037692308,23
3233.979755,55,86,0.85,31,0.027419355,23
3233.321933,52,60,0.2,8,0.025,23
3232.550184,35,62,0.91,27,0.033703704,23
3232.513702,43,71,0.78,28,0.027857143,23
3231.369641,57,86,0.76,29,0.026206897,23
3231.075813,37,59,0.75,22,0.034090909,23
3230.987574,62,77,0.42,15,0.028,23
3229.900164,66,85,0.37,19,0.019473684,23
3229.531335,47,52,0.16,5,0.032,23
3229.118635,41,74,0.86,33,0.026060606,23
3228.977165,59,71,0.4,12,0.033333333,23
3228.670063,39,53,0.52,14,0.037142857,23
3228.34161,41,77,0.94,36,0.026111111,23
3228.329309,61,68,0.24,7,0.034285714,23
3228.324762,43,49,0.23,6,0.038333333,23
3228.208425,53,59,0.17,6,0.028333333,23
3228.201756,58,72,0.47,14,0.033571429,23
3228.115715,37,97,0.11,60,0.001833333,23
3227.439901,45,53,0.28,8,0.035,23
3227.378396,39,60,0.74,21,0.035238095,23
3227.120277,58,71,0.44,13,0.033846154,23
3227.006245,55,85,0.85,30,0.028333333,23
3226.846784,38,61,0.81,23,0.035217391,23
3226.773793,35,63,0.91,28,0.0325,23
3226.505812,62,67,0.17,5,0.034,23
3226.363048,36,98,0.13,62,0.002096774,23
3226.207041,57,72,0.51,15,0.034,23
3226.207041,56,73,0.58,17,0.034117647,23
3226.207041,53,77,0.81,24,0.03375,23
3226.011689,65,86,0.41,21,0.01952381,23
3224.547505,38,58,0.67,20,0.0335,23
3224.516289,39,57,0.6,18,0.033333333,23
3223.989612,40,76,0.96,36,0.026666667,23
3223.099301,48,67,0.46,19,0.024210526,23
3222.218258,45,79,0.83,34,0.024411765,23
3221.72065,45,54,0.29,9,0.032222222,23
3221.624892,43,52,0.3,9,0.033333333,23
3221.576376,59,70,0.37,11,0.033636364,23
3220.312924,54,86,0.91,32,0.0284375,23
3219.504548,52,71,0.67,19,0.035263158,23
3219.436066,53,90,0.96,37,0.025945946,23
3219.235626,45,69,0.59,24,0.024583333,23
3218.676504,34,65,0.98,31,0.031612903,23
3218.663117,39,57,0.59,18,0.032777778,23
3218.400562,54,87,0.92,33,0.027878788,23
3217.862429,53,78,0.83,25,0.0332,23
3217.775211,48,64,0.45,16,0.028125,23
3217.717129,33,54,0.83,21,0.03952381,23
3217.616451,41,58,0.6,17,0.035294118,23
3217.444253,37,61,0.86,24,0.035833333,23
3217.085783,47,68,0.51,21,0.024285714,23
3216.193384,44,71,0.67,27,0.024814815,23
3216.133895,40,56,0.54,16,0.03375,23
3215.833744,54,90,0.94,36,0.026111111,23
3213.831307,35,51,0.66,16,0.04125,23
3213.348057,44,82,0.9,38,0.023684211,23
3213.348057,43,83,0.95,40,0.02375,23
3213.182104,44,71,0.66,27,0.024444444,23
3212.933297,56,85,0.81,29,0.027931034,23
3210.849964,54,89,0.91,35,0.026,23
3210.768464,34,64,0.99,30,0.033,23
3209.31533,36,51,0.58,15,0.038666667,23
3208.865806,44,70,0.69,26,0.026538462,23
3208.525264,60,70,0.33,10,0.033,23
3208.186085,46,69,0.56,23,0.024347826,23
3207.830904,37,59,0.76,22,0.034545455,23
3207.75503,49,63,0.39,14,0.027857143,23
3205.756501,35,60,0.92,25,0.0368,23
3205.67811,34,60,0.96,26,0.036923077,23
3205.189974,46,66,0.57,20,0.0285,23
3205.081594,45,68,0.65,23,0.02826087,23
3204.815877,57,73,0.53,16,0.033125,23
3204.540826,63,78,0.4,15,0.026666667,23
3203.211262,37,60,0.75,23,0.032608696,23
3203.049865,52,60,0.23,8,0.02875,23
3202.406754,57,79,0.6,22,0.027272727,23
3202.268782,39,48,0.34,9,0.037777778,23
3202.211878,37,96,0.11,59,0.001864407,23
3202.128953,56,87,0.82,31,0.026451613,23
3201.510889,52,85,0.89,33,0.026969697,23
3200.870066,49,63,0.4,14,0.028571429,23
3200.702338,53,91,0.98,38,0.025789474,23
3200.46042,38,57,0.66,19,0.034736842,23
3199.833315,43,71,0.77,28,0.0275,23
3199.30785,55,76,0.69,21,0.032857143,23
3199.30785,54,77,0.76,23,0.033043478,23
3198.820951,43,50,0.27,7,0.038571429,23
3198.666227,40,46,0.24,6,0.04,23
3198.511189,43,70,0.78,27,0.028888889,23
3197.296345,59,81,0.61,22,0.027727273,23
3196.916836,55,89,0.88,34,0.025882353,23
3196.353666,41,57,0.57,16,0.035625,23
3195.925258,55,86,0.87,31,0.028064516,23
3195.925258,54,87,0.93,33,0.028181818,23
3195.78958,53,77,0.82,24,0.034166667,23
3195.752726,37,96,0.12,59,0.002033898,23
3195.550955,43,70,0.75,27,0.027777778,23
3194.614119,49,64,0.42,15,0.028,23
3192.62,37,64,0.95,27,0.035185185,23
3191.576465,39,54,0.57,15,0.038,23
3191.511753,39,49,0.37,10,0.037,23
3191.511753,36,52,0.6,16,0.0375,23
3191.009856,55,85,0.84,30,0.028,23
3190.050284,67,75,0.21,8,0.02625,23
3189.965497,67,68,0.03,1,0.03,23
3189.965497,66,69,0.09,3,0.03,23
3189.965497,65,70,0.15,5,0.03,23
3189.902581,53,87,0.97,34,0.028529412,23
3189.670689,62,71,0.28,9,0.031111111,23
3189.647933,54,75,0.72,21,0.034285714,23
3189.647933,53,76,0.79,23,0.034347826,23
3189.502164,50,62,0.3,12,0.025,23
3188.812765,44,70,0.65,26,0.025,23
3188.476007,42,72,0.8,30,0.026666667,23
3188.358435,64,78,0.37,14,0.026428571,23
3188.358435,61,81,0.53,20,0.0265,23
3188.358435,58,85,0.71,27,0.026296296,23
3187.941773,38,94,0.11,56,0.001964286,23
3187.684965,41,73,0.92,32,0.02875,23
3186.516603,44,69,0.72,25,0.0288,23
3185.688344,60,82,0.58,22,0.026363636,23
3185.595988,59,84,0.66,25,0.0264,23
3185.595988,57,86,0.77,29,0.026551724,23
3185.526254,41,46,0.19,5,0.038,23
3185.397314,50,61,0.32,11,0.029090909,23
3185.038522,46,68,0.54,22,0.024545455,23
3184.488935,42,72,0.84,30,0.028,23
3184.170947,56,85,0.8,29,0.027586207,23
3184.096103,36,50,0.56,14,0.04,23
3184.096103,35,51,0.64,16,0.04,23
3184.016503,42,56,0.5,14,0.035714286,23
3183.799878,38,56,0.67,18,0.037222222,23
3183.477688,55,86,0.86,31,0.027741935,23
3182.191346,65,87,0.43,22,0.019545455,23
3182.046964,52,86,0.91,34,0.026764706,23
3181.739569,62,80,0.48,18,0.026666667,23
3181.416467,40,51,0.41,11,0.037272727,23
3181.225629,44,55,0.35,11,0.031818182,23
3180.144193,61,80,0.51,19,0.026842105,23
3179.614691,42,44,0.08,2,0.04,23
3179.614691,41,45,0.16,4,0.04,23
3178.850256,39,75,0.98,36,0.027222222,23
3178.73453,67,72,0.14,5,0.028,23
3178.595974,55,87,0.88,32,0.0275,23
3178.57391,53,88,0.98,35,0.028,23
3177.680025,38,55,0.65,17,0.038235294,23
3176.59668,48,64,0.4,16,0.025,23
3176.271735,56,87,0.83,31,0.026774194,23
3175.741058,46,51,0.18,5,0.036,23
3174.919761,57,64,0.25,7,0.035714286,23
3173.900989,39,54,0.55,15,0.036666667,23
3173.771512,63,66,0.1,3,0.033333333,23
3173.291501,45,67,0.64,22,0.029090909,23
3173.291501,44,68,0.7,24,0.029166667,23
3173.060134,51,61,0.25,10,0.025,23
3172.68945,47,65,0.52,18,0.028888889,23
3172.68945,46,66,0.58,20,0.029,23
3172.603532,45,67,0.63,22,0.028636364,23
3172.546743,37,51,0.52,14,0.037142857,23
3171.424427,55,84,0.84,29,0.028965517,23
3171.127781,56,77,0.66,21,0.031428571,23
3171.049611,54,88,0.94,34,0.027647059,23
3170.83199,42,72,0.83,30,0.027666667,23
3170.531743,38,95,0.11,57,0.001929825,23
3170.341724,37,62,0.89,25,0.0356,23
3169.98914,36,99,0.1,63,0.001587302,23
3169.873561,52,82,0.95,30,0.031666667,23
3169.739548,36,61,0.88,25,0.0352,23
3169.264502,42,75,0.88,33,0.026666667,23
3167.333194,42,73,0.84,31,0.027096774,23
3166.899051,38,60,0.79,22,0.035909091,23
3166.475886,60,74,0.43,14,0.030714286,23
3166.452559,44,69,0.73,25,0.0292,23
3165.515561,36,58,0.83,22,0.037727273,23
3165.100023,32,55,0.93,23,0.040434783,23
3164.662628,53,69,0.57,16,0.035625,23
3164.415578,55,78,0.73,23,0.03173913,23
3164.415578,53,80,0.86,27,0.031851852,23
3164.215439,35,59,0.91,24,0.037916667,23
3163.973138,36,99,0.12,63,0.001904762,23
3163.934796,58,74,0.51,16,0.031875,23
3163.192015,37,95,0.13,58,0.002241379,23
3163.164494,52,78,0.89,26,0.034230769,23
3163.019878,36,61,0.83,25,0.0332,23
3162.645191,36,57,0.78,21,0.037142857,23
3161.477787,36,97,0.12,61,0.001967213,23
3160.981648,39,74,0.98,35,0.028,23
3160.769375,36,60,0.85,24,0.035416667,23
3160.717987,38,58,0.73,20,0.0365,23
3160.246039,40,75,0.95,35,0.027142857,23
3160.185333,42,49,0.26,7,0.037142857,23
3159.517455,40,53,0.5,13,0.038461538,23
3159.516033,42,54,0.4,12,0.033333333,23
3159.516033,41,55,0.47,14,0.033571429,23
3159.476681,55,85,0.86,30,0.028666667,23
3158.521158,41,77,0.93,36,0.025833333,23
3158.40953,40,47,0.27,7,0.038571429,23
3158.200837,47,66,0.54,19,0.028421053,23
3157.753722,48,65,0.55,17,0.032352941,23
3157.641343,46,53,0.22,7,0.031428571,23
3157.594404,49,64,0.38,15,0.025333333,23
3157.592602,37,64,0.93,27,0.034444444,23
3157.241502,38,58,0.71,20,0.0355,23
3156.885768,53,60,0.17,7,0.024285714,23
3156.632985,38,62,0.84,24,0.035,23
3156.571625,45,71,0.63,26,0.024230769,23
3156.527882,61,79,0.5,18,0.027777778,23
3156.527882,60,80,0.56,20,0.028,23
3156.306097,51,58,0.2,7,0.028571429,23
3154.610392,62,78,0.44,16,0.0275,23
3153.690233,55,91,0.92,36,0.025555556,23
3153.036344,47,66,0.47,19,0.024736842,23
3152.820965,39,45,0.25,6,0.041666667,23
3152.265059,37,63,0.93,26,0.035769231,23
3152.136935,57,82,0.72,25,0.0288,23
3152.130196,39,57,0.64,18,0.035555556,23
3151.888523,41,72,0.86,31,0.027741935,23
3151.883519,49,63,0.35,14,0.025,23
3151.526894,62,72,0.29,10,0.029,23
3151.233595,42,74,0.86,32,0.026875,23
3151.001232,56,89,0.85,33,0.025757576,23
3150.698069,61,73,0.35,12,0.029166667,23
3150.363798,39,47,0.31,8,0.03875,23
3150.196463,46,69,0.64,23,0.027826087,23
3149.642611,61,72,0.34,11,0.030909091,23
3149.527105,32,55,0.92,23,0.04,23
3149.518984,59,84,0.65,25,0.026,23
3149.476563,54,79,0.8,25,0.032,23
3149.476563,52,81,0.93,29,0.032068966,23
3149.346105,47,66,0.53,19,0.027894737,23
3148.734742,46,61,0.4,15,0.026666667,23
3148.257048,53,89,0.99,36,0.0275,23
3148.106766,44,63,0.55,19,0.028947368,23
3147.786497,44,69,0.71,25,0.0284,23
3147.753771,60,72,0.38,12,0.031666667,23
3147.132425,39,75,0.99,36,0.0275,23
3146.143674,38,48,0.39,10,0.039,23
3145.963522,39,47,0.32,8,0.04,23
3145.777068,38,97,0.09,59,0.001525424,23
3144.884791,54,79,0.79,25,0.0316,23
3144.736147,35,62,0.95,27,0.035185185,23
3144.425177,48,65,0.54,17,0.031764706,23
3143.934821,44,72,0.68,28,0.024285714,23
3143.879728,41,73,0.91,32,0.0284375,23
3143.641371,34,59,0.93,25,0.0372,23
3143.234827,55,90,0.91,35,0.026,23
3143.049597,57,87,0.78,30,0.026,23
3142.880082,57,84,0.75,27,0.027777778,23
3142.864368,51,63,0.33,12,0.0275,23
3142.636597,55,89,0.89,34,0.026176471,23
3141.878378,42,72,0.85,30,0.028333333,23
3141.850853,61,91,0.59,30,0.019666667,23
3140.830505,46,68,0.69,22,0.031363636,23
3140.743588,40,77,0.99,37,0.026756757,23
3139.567841,37,57,0.73,20,0.0365,23
3139.377218,44,72,0.74,28,0.026428571,23
3138.598119,47,68,0.52,21,0.024761905,23
3138.273109,55,79,0.75,24,0.03125,23
3136.262515,55,77,0.71,22,0.032272727,23
3136.175549,37,51,0.53,14,0.037857143,23
3135.978853,58,76,0.54,18,0.03,23
3134.696528,42,71,0.8,29,0.027586207,23
3134.538755,41,74,0.9,33,0.027272727,23
3134.450731,58,77,0.55,19,0.028947368,23
3134.0014,40,75,0.97,35,0.027714286,23
3133.955759,35,59,0.89,24,0.037083333,23
3133.78853,38,57,0.72,19,0.037894737,23
3133.581946,52,55,0.08,3,0.026666667,23
3133.28484,46,67,0.59,21,0.028095238,23
3132.543913,57,90,0.84,33,0.025454545,23
3131.949583,58,83,0.69,25,0.0276,23
3131.688464,56,83,0.78,27,0.028888889,23
3131.007592,41,49,0.34,8,0.0425,23
3130.736786,46,67,0.52,21,0.024761905,23
3130.500148,57,76,0.6,19,0.031578947,23
3130.42206,45,80,0.84,35,0.024,23
3129.918884,41,56,0.5,15,0.033333333,23
3129.581641,57,77,0.62,20,0.031,23
3128.979284,53,87,0.98,34,0.028823529,23
3128.237212,41,77,0.96,36,0.026666667,23
3128.194265,56,83,0.77,27,0.028518519,23
3128.141171,39,61,0.76,22,0.034545455,23
3128.113743,51,81,0.99,30,0.033,23
3128.079962,53,60,0.19,7,0.027142857,23
3126.852751,41,53,0.43,12,0.035833333,23
3126.824966,40,53,0.48,13,0.036923077,23
3126.791717,36,62,0.82,26,0.031538462,23
3126.728599,34,53,0.75,19,0.039473684,23
3126.492188,63,79,0.42,16,0.02625,23
3126.468965,45,69,0.75,24,0.03125,23
3125.131365,55,92,0.94,37,0.025405405,23
3125.131365,54,93,0.99,39,0.025384615,23
3125.10944,37,50,0.5,13,0.038461538,23
3125.092892,38,54,0.59,16,0.036875,23
3124.701391,39,95,0.09,56,0.001607143,23
3124.410865,38,62,0.85,24,0.035416667,23
3124.374334,40,57,0.57,17,0.033529412,23
3123.602382,42,71,0.85,29,0.029310345,23
3123.46747,39,61,0.78,22,0.035454545,23
3123.395638,59,76,0.49,17,0.028823529,23
3122.857815,47,64,0.43,17,0.025294118,23
3122.46282,37,55,0.67,18,0.037222222,23
3122.391907,36,97,0.14,61,0.002295082,23
3122.151019,56,78,0.66,22,0.03,23
3122.151019,54,81,0.8,27,0.02962963,23
3121.276097,37,54,0.64,17,0.037647059,23
3120.998769,45,50,0.17,5,0.034,23
3120.978978,60,75,0.43,15,0.028666667,23
3120.829959,47,65,0.53,18,0.029444444,23
3120.808934,49,58,0.24,9,0.026666667,23
3120.724231,49,62,0.38,13,0.029230769,23
3120.724231,48,63,0.44,15,0.029333333,23
3120.671278,44,70,0.64,26,0.024615385,23
3120.627159,54,86,0.92,32,0.02875,23
3120.602882,48,68,0.48,20,0.024,23
3120.514761,46,70,0.58,24,0.024166667,23
3120.473705,44,72,0.76,28,0.027142857,23
3120.22947,38,48,0.4,10,0.04,23
3119.882268,43,70,0.79,27,0.029259259,23
3118.940192,40,52,0.44,12,0.036666667,23
3118.925963,37,95,0.12,58,0.002068966,23
3118.791841,44,52,0.27,8,0.03375,23
3118.790381,35,63,0.98,28,0.035,23
3118.25377,49,61,0.34,12,0.028333333,23
3117.449727,37,97,0.12,60,0.002,23
3116.793285,57,78,0.61,21,0.029047619,23
3116.646194,38,49,0.42,11,0.038181818,23
3115.947461,64,87,0.45,23,0.019565217,23
3115.947461,63,88,0.49,25,0.0196,23
3115.594136,42,76,0.9,34,0.026470588,23
3115.42845,41,56,0.48,15,0.032,23
3114.591541,54,92,0.98,38,0.025789474,23
3114.505006,42,69,0.75,27,0.027777778,23
3114.484876,59,74,0.47,15,0.031333333,23
3114.011448,58,75,0.53,17,0.031176471,23
3113.872448,54,59,0.12,5,0.024,23
3112.933605,33,54,0.84,21,0.04,23
3112.899338,45,68,0.58,23,0.025217391,23
3112.246832,60,84,0.62,24,0.025833333,23
3111.955933,39,56,0.6,17,0.035294118,23
3111.93105,38,96,0.09,58,0.001551724,23
3110.922115,38,96,0.1,58,0.001724138,23
3110.714327,37,55,0.66,18,0.036666667,23
3110.630762,48,75,0.67,27,0.024814815,23
3110.602059,54,86,0.89,32,0.0278125,23
3110.57964,50,69,0.49,19,0.025789474,23
3110.389647,35,58,0.86,23,0.037391304,23
3110.196423,40,73,0.92,33,0.027878788,23
3110.191234,55,80,0.74,25,0.0296,23
3110.039924,44,68,0.71,24,0.029583333,23
3110.035746,44,60,0.48,16,0.03,23
3109.845909,58,67,0.32,9,0.035555556,23
3109.710201,57,77,0.6,20,0.03,23
3109.32606,41,55,0.45,14,0.032142857,23
3108.71483,40,78,0.99,38,0.026052632,23
3108.05046,43,72,0.9,29,0.031034483,23
3108.003651,48,66,0.43,18,0.023888889,23
3107.835494,46,79,0.74,33,0.022424242,23
3107.492847,53,87,0.95,34,0.027941176,23
3107.455683,42,57,0.53,15,0.035333333,23
3107.423903,56,90,0.87,34,0.025588235,23
3107.036014,68,72,0.11,4,0.0275,23
3107.036014,66,74,0.22,8,0.0275,23
3107.036014,64,76,0.33,12,0.0275,23
3107.001248,44,81,0.89,37,0.024054054,23
3106.843665,60,83,0.6,23,0.026086957,23
3106.83202,54,89,0.95,35,0.027142857,23
3106.563656,60,78,0.52,18,0.028888889,23
3106.440026,47,67,0.48,20,0.024,23
3105.968122,60,74,0.41,14,0.029285714,23
3105.968122,59,75,0.47,16,0.029375,23
3105.835736,45,67,0.65,22,0.029545455,23
3105.777753,43,53,0.33,10,0.033,23
3105.341335,42,74,0.79,32,0.0246875,23
3105.338654,47,68,0.57,21,0.027142857,23
3105.189519,54,87,0.89,33,0.026969697,23
3105.189519,53,88,0.95,35,0.027142857,23
3105.120547,57,67,0.36,10,0.036,23
3103.338369,44,65,0.6,21,0.028571429,23
3103.083061,38,60,0.73,22,0.033181818,23
3102.825903,54,78,0.78,24,0.0325,23
3102.277385,58,87,0.75,29,0.025862069,23
3102.277385,57,89,0.82,32,0.025625,23
3102.226896,36,56,0.75,20,0.0375,23
3102.080326,46,67,0.6,21,0.028571429,23
3102.080326,45,68,0.66,23,0.028695652,23
3101.913298,39,62,0.75,23,0.032608696,23
3101.340833,44,73,0.69,29,0.023793103,23
3100.625915,51,77,0.9,26,0.034615385,23
3100.35658,41,60,0.6,19,0.031578947,23
3100.117524,35,63,0.93,28,0.033214286,23
3100.052386,46,78,0.78,32,0.024375,23
3099.630875,65,78,0.34,13,0.026153846,23
3099.630875,61,83,0.57,22,0.025909091,23
3099.630875,59,85,0.68,26,0.026153846,23
3099.630875,58,86,0.73,28,0.026071429,23
3099.630875,57,88,0.8,31,0.025806452,23
3099.591261,59,67,0.27,8,0.03375,23
3099.579127,48,59,0.32,11,0.029090909,23
3099.478738,36,60,0.89,24,0.037083333,23
3099.414512,49,66,0.4,17,0.023529412,23
3099.296264,39,52,0.54,13,0.041538462,23
3099.205684,56,79,0.67,23,0.029130435,23
3099.205684,55,80,0.73,25,0.0292,23
3098.97864,43,74,0.83,31,0.026774194,23
3098.543333,46,58,0.36,12,0.03,23
3098.298081,36,58,0.81,22,0.036818182,23
3097.993491,45,70,0.62,25,0.0248,23
3097.916812,37,60,0.81,23,0.035217391,23
3097.653499,52,84,0.94,32,0.029375,23
3097.299459,61,80,0.52,19,0.027368421,23
3097.299459,59,82,0.63,23,0.027391304,23
3097.299459,57,85,0.76,28,0.027142857,23
3097.007743,37,58,0.8,21,0.038095238,23
3096.941947,55,91,0.93,36,0.025833333,23
3096.934573,61,82,0.55,21,0.026190476,23
3096.901059,38,55,0.63,17,0.037058824,23
3096.613711,56,86,0.82,30,0.027333333,23
3096.226068,39,59,0.72,20,0.036,23
3096.082253,37,48,0.45,11,0.040909091,23
3095.6285,64,71,0.2,7,0.028571429,23
3095.41197,57,82,0.71,25,0.0284,23
3095.18511,55,79,0.72,24,0.03,23
3094.627396,41,69,0.79,28,0.028214286,23
3094.323587,51,60,0.23,9,0.025555556,23
3094.299846,56,89,0.86,33,0.026060606,23
3094.248928,56,88,0.84,32,0.02625,23
3094.195121,46,68,0.59,22,0.026818182,23
3094.120769,38,50,0.46,12,0.038333333,23
3094.120769,37,51,0.54,14,0.038571429,23
3094.037208,36,50,0.57,14,0.040714286,23
3094.028778,40,76,0.97,36,0.026944444,23
3093.596364,38,56,0.69,18,0.038333333,23
3093.585163,36,49,0.54,13,0.041538462,23
3093.222723,54,62,0.19,8,0.02375,23
3092.922672,43,52,0.33,9,0.036666667,23
3092.842664,54,71,0.6,17,0.035294118,23
3092.823765,42,73,0.81,31,0.026129032,23
3092.817704,46,50,0.13,4,0.0325,23
3092.514879,54,82,0.81,28,0.028928571,23
3092.331516,64,88,0.47,24,0.019583333,23
3092.331516,63,89,0.51,26,0.019615385,23
3092.331516,62,90,0.55,28,0.019642857,23
3092.150696,39,48,0.35,9,0.038888889,23
3091.679113,48,65,0.43,17,0.025294118,23
3091.474461,53,82,0.86,29,0.029655172,23
3091.440908,46,51,0.17,5,0.034,23
3091.126981,41,74,0.87,33,0.026363636,23
3090.892495,39,59,0.66,20,0.033,23
3090.474937,58,76,0.53,18,0.029444444,23
3090.370781,37,98,0.1,61,0.001639344,23
3089.900811,37,63,0.92,26,0.035384615,23
3089.332329,36,61,0.89,25,0.0356,23
3089.045918,39,75,0.97,36,0.026944444,23
3088.926867,57,87,0.79,30,0.026333333,23
3088.926867,55,89,0.9,34,0.026470588,23
3088.926867,54,91,0.97,37,0.026216216,23
3088.722882,45,61,0.47,16,0.029375,23
3088.640313,56,69,0.46,13,0.035384615,23
3088.106343,57,85,0.77,28,0.0275,23
3088.071028,45,52,0.24,7,0.034285714,23
3087.941534,39,95,0.08,56,0.001428571,23
3087.603983,53,86,0.94,33,0.028484848,23
3087.5784,42,70,0.77,28,0.0275,23
3087.467419,58,70,0.41,12,0.034166667,23
3087.467419,57,71,0.48,14,0.034285714,23
3087.398429,59,66,0.25,7,0.035714286,23
3087.116874,46,69,0.57,23,0.024782609,23
3087.088431,43,53,0.34,10,0.034,23
3086.958186,38,94,0.12,56,0.002142857,23
3086.74644,37,98,0.09,61,0.00147541,23
3086.716076,45,59,0.42,14,0.03,23
3086.198613,44,70,0.7,26,0.026923077,23
3086.118889,37,56,0.73,19,0.038421053,23
3086.003419,51,86,0.99,35,0.028285714,23
3085.599537,53,83,0.85,30,0.028333333,23
3085.599537,52,84,0.91,32,0.0284375,23
3084.971322,48,66,0.52,18,0.028888889,23
3084.589749,47,66,0.48,19,0.025263158,23
3083.071067,44,63,0.56,19,0.029473684,23
3082.92749,46,60,0.41,14,0.029285714,23
3082.355787,37,98,0.11,61,0.001803279,23
3081.466668,53,88,0.96,35,0.027428571,23
3081.348599,38,53,0.56,15,0.037333333,23
3081.307104,53,61,0.19,8,0.02375,23
3081.240605,57,77,0.59,20,0.0295,23
3081.240605,56,78,0.65,22,0.029545455,23
3080.309464,51,63,0.28,12,0.023333333,23
3080.266397,56,80,0.68,24,0.028333333,23
3080.266397,55,81,0.74,26,0.028461538,23
3080.266397,54,82,0.8,28,0.028571429,23
3080.084626,38,56,0.65,18,0.036111111,23
3079.968861,53,89,0.95,36,0.026388889,23
3079.863242,63,71,0.23,8,0.02875,23
3079.863242,57,78,0.6,21,0.028571429,23
3079.863242,56,79,0.66,23,0.028695652,23
3079.863242,55,80,0.72,25,0.0288,23
3079.863242,54,81,0.78,27,0.028888889,23
3079.842716,57,68,0.39,11,0.035454545,23
3079.842716,51,76,0.87,25,0.0348,23
3079.842716,50,77,0.94,27,0.034814815,23
3079.353513,35,59,0.88,24,0.036666667,23
3079.141599,54,85,0.88,31,0.028387097,23
3079.133625,56,91,0.9,35,0.025714286,23
3078.953364,41,51,0.34,10,0.034,23
3078.884327,55,81,0.71,26,0.027307692,23
3078.766774,45,71,0.72,26,0.027692308,23
3078.682964,45,68,0.57,23,0.024782609,23
3078.664966,40,73,0.9,33,0.027272727,23
3078.583276,38,58,0.72,20,0.036,23
3078.57357,59,76,0.47,17,0.027647059,23
3078.57357,57,78,0.58,21,0.027619048,23
3078.363528,48,63,0.38,15,0.025333333,23
3078.105297,36,61,0.91,25,0.0364,23
3077.967587,65,77,0.32,12,0.026666667,23
3077.967587,60,82,0.59,22,0.026818182,23
3077.339134,38,47,0.37,9,0.041111111,23
3077.12192,42,54,0.39,12,0.0325,23
3076.83942,36,63,0.97,27,0.035925926,23
3076.472631,48,56,0.24,8,0.03,23
3076.472631,47,57,0.3,10,0.03,23
3076.420939,50,78,0.97,28,0.034642857,23
3076.38911,41,70,0.93,29,0.032068966,23
3075.732227,42,73,0.97,31,0.031290323,23
3075.531884,35,63,0.9,28,0.032142857,23
3074.967632,53,83,0.86,30,0.028666667,23
3074.952937,43,47,0.17,4,0.0425,23
3074.933811,46,66,0.59,20,0.0295,23
3074.913775,41,74,0.91,33,0.027575758,23
3074.705488,43,70,0.77,27,0.028518519,23
3074.151893,43,73,0.84,30,0.028,23
3074.047594,41,52,0.4,11,0.036363636,23
3073.40919,41,71,0.83,30,0.027666667,23
3073.321039,54,83,0.81,29,0.027931034,23
3073.321039,53,84,0.87,31,0.028064516,23
3073.321039,52,85,0.92,33,0.027878788,23
3073.321039,52,85,0.93,33,0.028181818,23
3073.321039,52,86,0.94,34,0.027647059,23
3073.321039,51,86,0.98,35,0.028,23
3073.297087,46,49,0.11,3,0.036666667,23
3073.091711,46,49,0.1,3,0.033333333,23
3072.821044,54,80,0.78,26,0.03,23
3072.67402,54,92,0.97,38,0.025526316,23
3072.672652,58,85,0.72,27,0.026666667,23
3072.548431,42,73,0.96,31,0.030967742,23
3072.460972,42,71,0.79,29,0.027241379,23
3072.244789,51,53,0.06,2,0.03,23
3072.244789,50,54,0.12,4,0.03,23
3072.244789,49,55,0.18,6,0.03,23
3071.739145,56,86,0.83,30,0.027666667,23
3071.739145,55,87,0.89,32,0.0278125,23
3071.685043,61,84,0.59,23,0.025652174,23
3071.534021,60,73,0.38,13,0.029230769,23
3071.529457,35,57,0.82,22,0.037272727,23
3071.433493,43,75,0.77,32,0.0240625,23
3071.250061,35,52,0.68,17,0.04,23
3071.246824,45,79,0.84,34,0.024705882,23
3071.232489,42,47,0.18,5,0.036,23
3071.010678,40,52,0.41,12,0.034166667,23
3071.010678,39,53,0.48,14,0.034285714,23
3070.843222,36,60,0.91,24,0.037916667,23
3070.753065,60,92,0.63,32,0.0196875,23
3070.567776,36,56,0.74,20,0.037,23
3070.180093,47,69,0.53,22,0.024090909,23
3069.944021,35,58,0.85,23,0.036956522,23
3069.855213,37,54,0.71,17,0.041764706,23
3068.96573,50,67,0.4,17,0.023529412,23
3068.149997,47,63,0.45,16,0.028125,23
3068.106721,54,88,0.95,34,0.027941176,23
3068.060418,61,74,0.37,13,0.028461538,23
3067.853237,36,61,0.9,25,0.036,23
3067.706848,47,78,0.68,31,0.021935484,23
3067.603857,38,53,0.62,15,0.041333333,23
3067.337416,56,88,0.83,32,0.0259375,23
3067.337416,55,90,0.9,35,0.025714286,23
3067.085137,55,82,0.73,27,0.027037037,23
3067.041014,39,57,0.66,18,0.036666667,23
3066.93612,38,59,0.74,21,0.035238095,23
3066.832314,56,72,0.55,16,0.034375,23
3066.832314,55,73,0.62,18,0.034444444,23
3066.477077,43,52,0.32,9,0.035555556,23
3066.242117,42,77,0.84,35,0.024,23
3066.17891,58,77,0.54,19,0.028421053,23
3066.17891,55,80,0.71,25,0.0284,23
3066.08896,46,70,0.62,24,0.025833333,23
3065.718816,37,50,0.51,13,0.039230769,23
3065.667718,66,67,0.03,1,0.03,23
3065.667718,65,68,0.09,3,0.03,23
3065.667718,64,69,0.15,5,0.03,23
3065.667718,63,70,0.21,7,0.03,23
3065.667718,62,71,0.27,9,0.03,23
3065.667718,61,72,0.33,11,0.03,23
3065.667718,60,73,0.39,13,0.03,23
3065.489181,47,66,0.62,19,0.032631579,23
3065.489181,46,67,0.69,21,0.032857143,23
3065.470924,40,93,0.09,53,0.001698113,23
3065.470576,36,58,0.8,22,0.036363636,23
3065.341073,42,77,0.82,35,0.023428571,23
3064.95918,45,70,0.7,25,0.028,23
3064.937732,51,68,0.44,17,0.025882353,23
3064.71249,58,84,0.71,26,0.027307692,23
3064.71249,56,87,0.84,31,0.027096774,23
3064.247887,56,77,0.63,21,0.03,23
3064.001256,56,71,0.5,15,0.033333333,23
3063.998945,55,85,0.83,30,0.027666667,23
3063.985072,49,59,0.26,10,0.026,23
3063.895182,51,86,0.95,35,0.027142857,23
3063.836582,42,73,0.98,31,0.031612903,23
3063.406877,46,69,0.65,23,0.02826087,23
3063.35363,49,62,0.33,13,0.025384615,23
3063.302563,51,85,0.97,34,0.028529412,23
3062.919147,45,70,0.6,25,0.024,23
3062.881259,41,54,0.48,13,0.036923077,23
3062.840984,55,79,0.7,24,0.029166667,23
3062.556962,41,58,0.57,17,0.033529412,23
3062.000541,45,69,0.69,24,0.02875,23
3061.765506,52,57,0.13,5,0.026,23
3061.381903,52,58,0.17,6,0.028333333,23
3060.946736,52,82,0.86,30,0.028666667,23
3060.946736,52,82,0.87,30,0.029,23
3060.946736,51,83,0.93,32,0.0290625,23
3060.946736,50,84,0.99,34,0.029117647,23
3060.252731,39,94,0.09,55,0.001636364,23
3059.949415,40,59,0.68,19,0.035789474,23
3059.940171,38,54,0.55,16,0.034375,23
3059.828347,52,62,0.24,10,0.024,23
3059.626075,41,59,0.58,18,0.032222222,23
3059.558275,44,70,0.86,26,0.033076923,23
3059.163906,46,68,0.53,22,0.024090909,23
3059.163906,45,69,0.58,24,0.024166667,23
3058.768314,54,81,0.79,27,0.029259259,23
3058.768314,53,82,0.85,29,0.029310345,23
3058.63605,36,51,0.6,15,0.04,23
3058.427195,35,59,0.86,24,0.035833333,23
3058.245536,48,67,0.45,19,0.023684211,23
3058.199586,40,54,0.52,14,0.037142857,23
3058.019098,34,55,0.8,21,0.038095238,23
3058.015426,43,68,0.7,25,0.028,23
3057.922276,54,70,0.58,16,0.03625,23
3057.609684,50,76,0.92,26,0.035384615,23
3057.609684,49,77,0.99,28,0.035357143,23
3057.605281,59,96,0.71,37,0.019189189,23
3057.605057,52,73,0.75,21,0.035714286,23
3057.545293,51,84,0.94,33,0.028484848,23
3056.917544,46,62,0.46,16,0.02875,23
3056.854024,53,72,0.68,19,0.035789474,23
3056.850484,41,73,0.88,32,0.0275,23
3056.84683,53,83,0.82,30,0.027333333,23
3056.626937,40,70,0.85,30,0.028333333,23
3056.52082,56,72,0.39,16,0.024375,23
3056.334522,37,49,0.48,12,0.04,23
3056.153827,50,64,0.37,14,0.026428571,23
3055.922026,46,79,0.75,33,0.022727273,23
3055.709328,42,56,0.46,14,0.032857143,23
3055.441448,41,78,0.89,37,0.024054054,23
3055.217169,53,85,0.88,32,0.0275,23
3054.897839,54,91,0.96,37,0.025945946,23
3054.866989,55,58,0.07,3,0.023333333,23
3054.676399,62,70,0.24,8,0.03,23
3054.676399,61,71,0.3,10,0.03,23
3054.283106,34,56,0.83,22,0.037727273,23
3054.248855,44,71,0.77,27,0.028518519,23
3054.021979,39,50,0.42,11,0.038181818,23
3054.015353,43,67,0.77,24,0.032083333,23
3053.975266,57,79,0.62,22,0.028181818,23
3053.727792,47,68,0.59,21,0.028095238,23
3053.595877,34,58,0.9,24,0.0375,23
3053.461574,55,70,0.53,15,0.035333333,23
3053.251236,58,76,0.52,18,0.028888889,23
3053.219167,53,85,0.86,32,0.026875,23
3053.219167,51,88,0.99,37,0.026756757,23
3053.167745,38,48,0.41,10,0.041,23
3053.156807,39,76,0.99,37,0.026756757,23
3053.144358,42,72,0.86,30,0.028666667,23
3052.861191,44,52,0.26,8,0.0325,23
3052.419127,44,72,0.78,28,0.027857143,23
3052.290544,36,60,0.83,24,0.034583333,23
3052.162079,53,83,0.87,30,0.029,23
3052.070361,51,83,0.94,32,0.029375,23
3052.06372,35,54,0.73,19,0.038421053,23
3051.965628,50,61,0.31,11,0.028181818,23
3051.915311,46,62,0.42,16,0.02625,23
3051.892212,40,61,0.66,21,0.031428571,23
3051.683205,55,71,0.56,16,0.035,23
3051.544685,43,61,0.54,18,0.03,23
3050.917773,56,82,0.7,26,0.026923077,23
3050.81072,37,61,0.84,24,0.035,23
3050.642922,42,69,0.86,27,0.031851852,23
3050.608638,53,87,0.96,34,0.028235294,23
3050.547872,43,58,0.47,15,0.031333333,23
3050.444493,48,62,0.36,14,0.025714286,23
3050.355324,44,70,0.72,26,0.027692308,23
3050.221595,45,70,0.71,25,0.0284,23
3049.617193,39,55,0.6,16,0.0375,23
3049.615349,36,99,0.11,63,0.001746032,23
3049.549908,34,52,0.75,18,0.041666667,23
3049.474667,52,72,0.44,20,0.022,23
3049.103386,47,64,0.5,17,0.029411765,23
3048.762581,55,84,0.83,29,0.02862069,23
3048.762581,54,85,0.89,31,0.028709677,23
3048.762581,53,86,0.95,33,0.028787879,23
3048.746635,43,71,0.75,28,0.026785714,23
3048.420441,35,50,0.62,15,0.041333333,23
3047.987519,52,62,0.25,10,0.025,23
3047.919162,39,62,0.73,23,0.03173913,23
3047.80078,54,89,0.96,35,0.027428571,23
3047.24251,48,65,0.45,17,0.026470588,23
3047.085935,56,81,0.69,25,0.0276,23
3047.085935,53,84,0.86,31,0.027741935,23
3047.039769,46,57,0.35,11,0.031818182,23
3046.899818,42,68,0.73,26,0.028076923,23
3046.662233,38,97,0.08,59,0.001355932,23
3046.567309,41,73,0.93,32,0.0290625,23
3046.502305,49,61,0.31,12,0.025833333,23
3046.125641,42,43,0.04,1,0.04,23
3046.125641,41,44,0.12,3,0.04,23
3046.125641,40,45,0.2,5,0.04,23
3046.093352,41,76,0.94,35,0.026857143,23
3046.049813,42,55,0.47,13,0.036153846,23
3046.040889,34,60,0.95,26,0.036538462,23
3045.847233,58,78,0.56,20,0.028,23
3045.847233,55,82,0.75,27,0.027777778,23
3045.748331,47,68,0.58,21,0.027619048,23
3045.713723,44,70,0.75,26,0.028846154,23
3045.643222,33,56,0.88,23,0.03826087,23
3045.599005,50,83,0.98,33,0.02969697,23
3045.547355,50,64,0.39,14,0.027857143,23
3045.536569,34,54,0.76,20,0.038,23
3045.447742,32,58,0.99,26,0.038076923,23
3045.341525,49,68,0.45,19,0.023684211,23
3045.237284,37,56,0.64,19,0.033684211,23
3045.204086,42,57,0.49,15,0.032666667,23
3045.012815,55,71,0.54,16,0.03375,23
3044.761036,54,72,0.63,18,0.035,23
3044.761036,53,73,0.7,20,0.035,23
3044.761036,52,74,0.77,22,0.035,23
3044.761036,51,75,0.84,24,0.035,23
3044.543915,41,59,0.6,18,0.033333333,23
3044.460953,42,47,0.19,5,0.038,23
3044.243518,45,70,0.65,25,0.026,23
3044.017867,54,81,0.77,27,0.028518519,23
3044.009788,61,81,0.54,20,0.027,23
3044.009788,54,90,0.96,36,0.026666667,23
3043.876498,47,68,0.55,21,0.026190476,23
3043.855097,42,82,0.97,40,0.02425,23
3043.769047,46,65,0.48,19,0.025263158,23
3043.563696,35,57,0.81,22,0.036818182,23
3043.476098,41,60,0.65,19,0.034210526,23
3043.436944,35,63,0.94,28,0.033571429,23
3043.301377,52,84,0.88,32,0.0275,23
3042.651466,39,53,0.51,14,0.036428571,23
3042.420041,43,83,0.96,40,0.024,23
3042.065928,52,83,0.89,31,0.028709677,23
3042.065928,51,84,0.95,33,0.028787879,23
3042.044501,46,75,0.73,29,0.025172414,23
3042.044501,45,76,0.78,31,0.02516129,23
3041.947712,51,75,0.85,24,0.035416667,23
3041.943108,52,74,0.78,22,0.035454545,23
3041.929595,51,85,0.94,34,0.027647059,23
3041.870194,54,82,0.79,28,0.028214286,23
3041.70689,48,64,0.47,16,0.029375,23
3041.676401,54,79,0.73,25,0.0292,23
3041.676401,53,80,0.79,27,0.029259259,23
3041.629911,57,76,0.57,19,0.03,23
3041.590142,52,77,0.86,25,0.0344,23
3041.534571,44,80,0.9,36,0.025,23
3041.503728,52,84,0.9,32,0.028125,23
3041.431188,45,68,0.67,23,0.029130435,23
3041.116996,53,84,0.84,31,0.027096774,23
3041.116996,52,85,0.9,33,0.027272727,23
3040.846323,51,63,0.3,12,0.025,23
3040.275757,44,71,0.7,27,0.025925926,23
3040.216779,52,81,0.86,29,0.029655172,23
3040.164097,44,69,0.66,25,0.0264,23
3039.951434,41,76,0.86,35,0.024571429,23
3039.757975,61,83,0.46,22,0.020909091,23
3039.695749,59,83,0.65,24,0.027083333,23
3039.695749,57,86,0.78,29,0.026896552,23
3039.681426,59,75,0.46,16,0.02875,23
3039.187431,43,64,0.62,21,0.02952381,23
3039.168688,42,70,0.8,28,0.028571429,23
3039.154958,53,74,0.74,21,0.035238095,23
3039.104749,59,74,0.44,15,0.029333333,23
3039.104749,58,75,0.5,17,0.029411765,23
3039.0992,38,95,0.12,57,0.002105263,23
3039.022356,55,88,0.89,33,0.026969697,23
3038.824436,58,79,0.57,21,0.027142857,23
3038.733368,41,75,0.93,34,0.027352941,23
3038.677257,35,58,0.79,23,0.034347826,23
3038.612955,39,52,0.48,13,0.036923077,23
3038.566713,51,76,0.88,25,0.0352,23
3038.566713,50,77,0.95,27,0.035185185,23
3038.522468,42,68,0.84,26,0.032307692,23
3038.341245,67,81,0.27,14,0.019285714,23
3038.340058,44,81,0.9,37,0.024324324,23
3038.340058,43,82,0.95,39,0.024358974,23
3038.027961,48,61,0.37,13,0.028461538,23
3038.020323,37,94,0.13,57,0.002280702,23
3037.698405,40,57,0.55,17,0.032352941,23
3037.671731,43,82,0.97,39,0.024871795,23
3037.478713,54,91,0.95,37,0.025675676,23
3037.428475,35,59,0.87,24,0.03625,23
3037.373494,43,72,0.83,29,0.02862069,23
3037.355766,65,67,0.06,2,0.03,23
3037.355766,64,68,0.12,4,0.03,23
3037.355766,63,69,0.18,6,0.03,23
3037.237898,39,58,0.62,19,0.032631579,23
3037.230395,45,57,0.37,12,0.030833333,23
3037.147747,65,73,0.23,8,0.02875,23
3037.127322,37,49,0.49,12,0.040833333,23
3036.773586,38,95,0.1,57,0.001754386,23
3036.52451,53,61,0.2,8,0.025,23
3036.438134,50,64,0.33,14,0.023571429,23
3036.269796,36,62,0.91,26,0.035,23
3036.047076,45,80,0.85,35,0.024285714,23
3035.962878,53,59,0.16,6,0.026666667,23
3035.677659,58,75,0.51,17,0.03,23
3035.517219,40,54,0.5,14,0.035714286,23
3035.516621,39,94,0.1,55,0.001818182,23
3035.367084,42,59,0.53,17,0.031176471,23
3035.332333,65,82,0.41,17,0.024117647,23
3035.330659,37,64,0.96,27,0.035555556,23
3035.270472,55,88,0.9,33,0.027272727,23
3035.270472,54,90,0.97,36,0.026944444,23
3035.261272,43,70,0.74,27,0.027407407,23
3035.135321,37,60,0.83,23,0.036086957,23
3034.927844,51,85,0.99,34,0.029117647,23
3034.87613,38,59,0.75,21,0.035714286,23
3034.813935,53,81,0.8,28,0.028571429,23
3034.680593,50,62,0.32,12,0.026666667,23
3034.627804,51,60,0.3,9,0.033333333,23
3034.566913,53,81,0.84,28,0.03,23
3034.297419,46,55,0.28,9,0.031111111,23
3034.2686,54,80,0.76,26,0.029230769,23
3034.2686,51,84,0.96,33,0.029090909,23
3034.258548,46,68,0.58,22,0.026363636,23
3034.109715,50,58,0.23,8,0.02875,23
3034.102535,55,83,0.76,28,0.027142857,23
3033.822143,34,55,0.81,21,0.038571429,23
3033.773356,55,81,0.73,26,0.028076923,23
3033.75592,52,61,0.21,9,0.023333333,23
3033.729238,44,55,0.36,11,0.032727273,23
3033.629965,44,54,0.34,10,0.034,23
3033.083514,46,66,0.56,20,0.028,23
3032.650139,52,59,0.21,7,0.03,23
3032.650139,51,60,0.27,9,0.03,23
3032.59949,37,60,0.77,23,0.033478261,23
3032.398873,40,52,0.47,12,0.039166667,23
3031.81753,51,64,0.31,13,0.023846154,23
3031.615517,58,70,0.29,12,0.024166667,23
3031.590229,60,74,0.4,14,0.028571429,23
3031.491934,53,86,0.88,33,0.026666667,23
3031.433373,54,86,0.9,32,0.028125,23
3031.34975,54,78,0.72,24,0.03,23
3031.180677,57,77,0.58,20,0.029,23
3031.180677,56,78,0.64,22,0.029090909,23
3031.162748,40,49,0.34,9,0.037777778,23
3031.068507,53,79,0.78,26,0.03,23
3031.068507,51,81,0.91,30,0.030333333,23
3031.068507,50,82,0.97,32,0.0303125,23
3031.068507,50,83,0.99,33,0.03,23
3031.045126,53,62,0.21,9,0.023333333,23
3031.011042,39,58,0.64,19,0.033684211,23
3030.927033,42,57,0.5,15,0.033333333,23
3030.753063,43,60,0.54,17,0.031764706,23
3030.572443,35,58,0.89,23,0.038695652,23
3030.504191,69,76,0.14,7,0.02,23
3030.504191,68,77,0.18,9,0.02,23
3030.504191,67,78,0.22,11,0.02,23
3030.504191,66,79,0.26,13,0.02,23
3030.423929,57,80,0.63,23,0.027391304,23
3030.423929,54,84,0.82,30,0.027333333,23
3030.286721,52,84,0.92,32,0.02875,23
3030.286721,51,85,0.98,34,0.028823529,23
3030.253678,51,87,0.97,36,0.026944444,23
3030.23634,48,77,0.64,29,0.022068966,23
3030.151479,36,53,0.65,17,0.038235294,23
3030.017977,47,63,0.41,16,0.025625,23
3029.247745,64,83,0.46,19,0.024210526,23
3029.033155,59,80,0.6,21,0.028571429,23
3029.003625,49,65,0.4,16,0.025,23
3028.998073,51,87,0.99,36,0.0275,23
3028.987793,42,74,0.98,32,0.030625,23
3028.728298,42,75,0.8,33,0.024242424,23
3028.709054,41,70,0.81,29,0.027931034,23
3028.657849,48,55,0.22,7,0.031428571,23
3028.192541,40,76,0.94,36,0.026111111,23
3027.980156,51,82,0.93,31,0.03,23
3027.960014,44,72,0.79,28,0.028214286,23
3027.503585,64,70,0.17,6,0.028333333,23
3027.503585,56,79,0.65,23,0.02826087,23
3027.384947,38,57,0.7,19,0.036842105,23
3027.37829,45,69,0.78,24,0.0325,23
3027.353361,52,83,0.87,31,0.028064516,23
3027.353361,51,84,0.93,33,0.028181818,23
3027.009694,41,59,0.59,18,0.032777778,23
3026.949425,40,75,0.99,35,0.028285714,23
3026.851832,42,75,0.92,33,0.027878788,23
3026.691513,41,72,0.85,31,0.027419355,23
3026.624565,60,65,0.17,5,0.034,23
3026.546186,41,50,0.33,9,0.036666667,23
3026.422237,51,82,0.92,31,0.029677419,23
3026.417177,42,74,0.99,32,0.0309375,23
3026.311926,46,60,0.42,14,0.03,23
3026.274831,61,72,0.32,11,0.029090909,23
3026.274831,55,79,0.69,24,0.02875,23
3026.274831,53,81,0.81,28,0.028928571,23
3026.027245,52,85,0.94,33,0.028484848,23
3025.704367,34,61,0.99,27,0.036666667,23
3024.601863,54,84,0.81,30,0.027,23
3024.453672,42,77,0.83,35,0.023714286,23
3024.439301,47,67,0.56,20,0.028,23
3024.32764,50,78,0.98,28,0.035,23
3024.297194,45,68,0.76,23,0.033043478,23
3024.297194,44,70,0.85,26,0.032692308,23
3024.223698,36,57,0.8,21,0.038095238,23
3024.206155,49,76,0.59,27,0.021851852,23
3023.900352,56,79,0.64,23,0.027826087,23
3023.866187,53,82,0.84,29,0.028965517,23
3023.703709,46,63,0.44,17,0.025882353,23
3023.645165,45,69,0.64,24,0.026666667,23
3023.331924,61,67,0.14,6,0.023333333,23
3023.291809,52,84,0.93,32,0.0290625,23
3023.152515,44,71,0.76,27,0.028148148,23
3022.976221,40,73,0.93,33,0.028181818,23
3022.910698,54,80,0.75,26,0.028846154,23
3022.817235,40,76,0.98,36,0.027222222,23
3022.736071,41,78,0.97,37,0.026216216,23
3022.523439,50,76,0.91,26,0.035,23
3022.441839,36,51,0.59,15,0.039333333,23
3022.441839,35,52,0.67,17,0.039411765,23
3022.368877,66,82,0.31,16,0.019375,23
3022.336471,54,71,0.61,17,0.035882353,23
3022.336471,54,72,0.64,18,0.035555556,23
3022.336471,53,73,0.71,20,0.0355,23
3021.797173,32,55,0.94,23,0.040869565,23
3021.616173,36,50,0.55,14,0.039285714,23
3021.541092,32,57,0.97,25,0.0388,23
3021.399014,37,60,0.82,23,0.035652174,23
3021.042162,58,81,0.66,23,0.028695652,23
3020.934408,55,82,0.74,27,0.027407407,23
3020.934408,53,85,0.87,32,0.0271875,23
3020.934408,52,86,0.93,34,0.027352941,23
3020.926241,35,97,0.15,62,0.002419355,23
3020.716614,59,79,0.59,20,0.0295,23
3020.538774,54,82,0.77,28,0.0275,23
3020.538774,53,83,0.83,30,0.027666667,23
3020.538774,51,86,0.97,35,0.027714286,23
3020.179804,44,72,0.77,28,0.0275,23
3020.134874,43,83,0.98,40,0.0245,23
3019.892969,35,63,0.92,28,0.032857143,23
3019.84646,48,66,0.45,18,0.025,23
3019.789293,45,58,0.41,13,0.031538462,23
3019.649059,42,75,0.89,33,0.026969697,23
3019.571123,73,74,0.02,1,0.02,23
3019.571123,72,75,0.06,3,0.02,23
3019.571123,71,76,0.1,5,0.02,23
3019.555001,42,66,0.69,24,0.02875,23
3019.52592,50,65,0.34,15,0.022666667,23
3019.515394,51,85,0.96,34,0.028235294,23
3019.505596,40,50,0.43,10,0.043,23
3019.360764,33,53,0.82,20,0.041,23
3019.357578,54,70,0.35,16,0.021875,23
3018.981147,52,75,0.81,23,0.035217391,23
3018.815081,46,56,0.32,10,0.032,23
3018.800635,36,53,0.63,17,0.037058824,23
3018.623543,39,46,0.29,7,0.041428571,23
3018.509985,50,62,0.35,12,0.029166667,23
3018.477875,49,67,0.42,18,0.023333333,23
3018.398578,50,64,0.35,14,0.025,23
3018.218183,62,71,0.26,9,0.028888889,23
3018.218183,56,78,0.63,22,0.028636364,23
3017.895838,50,59,0.23,9,0.025555556,23
3017.878812,42,58,0.52,16,0.0325,23
3017.705847,53,82,0.83,29,0.02862069,23
3017.601903,41,89,0.08,48,0.001666667,23
3017.502331,44,59,0.48,15,0.032,23
3017.421784,39,74,0.99,35,0.028285714,23
3017.119611,47,61,0.37,14,0.026428571,23
3016.772146,34,59,0.92,25,0.0368,23
3016.430918,48,59,0.29,11,0.026363636,23
3016.158895,40,71,0.99,31,0.031935484,23
3016.129345,43,56,0.45,13,0.034615385,23
3016.030731,45,52,0.23,7,0.032857143,23
3015.940052,46,65,0.53,19,0.027894737,23
3015.926668,54,83,0.8,29,0.027586207,23
3015.895106,65,70,0.14,5,0.028,23
3015.895106,62,73,0.31,11,0.028181818,23
3015.895106,62,74,0.33,12,0.0275,23
3015.895106,60,75,0.42,15,0.028,23
3015.895106,59,76,0.48,17,0.028235294,23
3015.895106,59,77,0.5,18,0.027777778,23
3015.895106,57,79,0.61,22,0.027727273,23
3015.895106,56,80,0.67,24,0.027916667,23
3015.890488,42,51,0.35,9,0.038888889,23
3015.857892,43,74,0.74,31,0.023870968,23
3015.767135,50,58,0.21,8,0.02625,23
3015.761061,40,53,0.47,13,0.036153846,23
3015.612561,49,63,0.41,14,0.029285714,23
3015.53167,54,82,0.78,28,0.027857143,23
3015.53167,53,83,0.84,30,0.028,23
3015.34329,35,61,0.92,26,0.035384615,23
3014.899135,57,71,0.34,14,0.024285714,23
3014.888493,40,75,0.93,35,0.026571429,23
3014.80187,60,72,0.36,12,0.03,23
3014.80187,59,73,0.42,14,0.03,23
3014.80187,58,74,0.48,16,0.03,23
3014.80187,57,75,0.54,18,0.03,23
3014.249203,37,57,0.78,20,0.039,23
3013.918614,45,67,0.61,22,0.027727273,23
3013.888887,41,53,0.46,12,0.038333333,23
3013.226003,56,58,0.05,2,0.025,23
3013.122212,49,65,0.38,16,0.02375,23
3013.023144,47,58,0.33,11,0.03,23
3012.992316,37,55,0.63,18,0.035,23
3012.855646,34,97,0.17,63,0.002698413,23
3012.609527,56,81,0.68,25,0.0272,23
3012.609527,54,83,0.79,29,0.027241379,23
3011.728125,40,60,0.67,20,0.0335,23
3011.635139,63,76,0.36,13,0.027692308,23
3011.450083,55,78,0.69,23,0.03,23
3011.360296,38,51,0.47,13,0.036153846,23
3011.264237,33,57,0.91,24,0.037916667,23
3011.22135,39,61,0.75,22,0.034090909,23
3010.874679,44,67,0.59,23,0.025652174,23
3010.866136,38,93,0.12,55,0.002181818,23
3010.765285,34,52,0.72,18,0.04,23
3010.749519,50,65,0.35,15,0.023333333,23
3010.745147,57,76,0.56,19,0.029473684,23
3010.452057,37,56,0.69,19,0.036315789,23
3010.354468,41,74,0.94,33,0.028484848,23
3009.932174,44,78,0.85,34,0.025,23
3009.503941,50,70,0.51,20,0.0255,23
3009.467611,45,65,0.52,20,0.026,23
3009.339352,40,54,0.55,14,0.039285714,23
3009.285134,43,81,0.92,38,0.024210526,23
3008.973802,35,63,0.99,28,0.035357143,23
3008.956147,58,78,0.55,20,0.0275,23
3008.956147,56,80,0.66,24,0.0275,23
3008.956147,55,81,0.72,26,0.027692308,23
3008.956147,53,84,0.85,31,0.027419355,23
3008.956147,52,85,0.91,33,0.027575758,23
3008.43603,56,94,0.8,38,0.021052632,23
3008.418983,52,83,0.92,31,0.029677419,23
3008.326495,54,84,0.88,30,0.029333333,23
3008.326495,54,85,0.9,31,0.029032258,23
3008.326495,53,85,0.94,32,0.029375,23
3008.326495,53,86,0.96,33,0.029090909,23
3008.230433,36,64,0.97,28,0.034642857,23
3008.0728,50,85,0.99,35,0.028285714,23
3007.410404,51,73,0.77,22,0.035,23
3007.200065,49,71,0.56,22,0.025454545,23
3006.91493,51,61,0.29,10,0.029,23
3006.657226,34,53,0.76,19,0.04,23
3006.631597,39,54,0.59,15,0.039333333,23
3006.310036,38,64,0.81,26,0.031153846,23
3006.221123,45,66,0.53,21,0.025238095,23
3006.001859,56,91,0.89,35,0.025428571,23
3005.776323,41,73,0.89,32,0.0278125,23
3005.609517,59,74,0.45,15,0.03,23
3005.562214,56,77,0.62,21,0.02952381,23
3005.562214,53,81,0.82,28,0.029285714,23
3005.562214,52,82,0.88,30,0.029333333,23
3005.338264,52,86,0.92,34,0.027058824,23
3005.338264,51,87,0.98,36,0.027222222,23
3005.157727,41,59,0.62,18,0.034444444,23
3004.670657,61,73,0.34,12,0.028333333,23
3004.52798,41,51,0.37,10,0.037,23
3004.505687,58,93,0.7,35,0.02,23
3004.436164,38,54,0.62,16,0.03875,23
3004.23823,36,55,0.67,19,0.035263158,23
3004.0624,37,58,0.81,21,0.038571429,23
3004.025353,62,83,0.43,21,0.02047619,23
3003.870298,51,85,0.95,34,0.027941176,23
3003.759641,51,62,0.26,11,0.023636364,23
3003.694147,49,72,0.58,23,0.025217391,23
3003.349216,57,87,0.66,30,0.022,23
3003.315087,45,53,0.27,8,0.03375,23
3003.180584,44,58,0.45,14,0.032142857,23
3003.11462,40,92,0.1,52,0.001923077,23
3003.06533,37,56,0.7,19,0.036842105,23
3002.847636,42,74,0.9,32,0.028125,23
3002.764768,54,81,0.75,27,0.027777778,23
3002.616092,39,73,0.94,34,0.027647059,23
3002.605086,35,61,0.96,26,0.036923077,23
3002.43659,42,73,0.85,31,0.027419355,23
3002.381189,43,72,0.79,29,0.027241379,23
3002.374464,42,62,0.6,20,0.03,23
3002.170167,38,49,0.43,11,0.039090909,23
3001.791729,37,56,0.65,19,0.034210526,23
3001.514782,61,74,0.36,13,0.027692308,23
3001.300225,51,86,0.96,35,0.027428571,23
3001.249549,49,65,0.44,16,0.0275,23
3001.180825,40,72,0.88,32,0.0275,23
3001.089714,48,72,0.61,24,0.025416667,23
3001.01808,62,82,0.52,20,0.026,23
3001.01808,60,84,0.63,24,0.02625,23
3001.01808,59,86,0.7,27,0.025925926,23
3001.01808,58,88,0.77,30,0.025666667,23
3000.949535,60,94,0.66,34,0.019411765,23
3000.947777,45,49,0.15,4,0.0375,23
3000.725579,39,62,0.72,23,0.031304348,23
3000.596184,42,56,0.47,14,0.033571429,23
2999.993983,62,91,0.57,29,0.019655172,23
2999.980514,41,58,0.56,17,0.032941176,23
2999.825087,40,59,0.64,19,0.033684211,23
2999.457114,45,69,0.66,24,0.0275,23
2999.250931,39,53,0.56,14,0.04,23
2999.088102,43,60,0.52,17,0.030588235,23
2998.889939,55,80,0.7,25,0.028,23
2998.705054,41,69,0.91,28,0.0325,23
2998.697181,52,84,0.89,32,0.0278125,23
2998.572721,52,83,0.88,31,0.028387097,23
2998.464956,49,70,0.55,21,0.026190476,23
2998.387749,39,53,0.55,14,0.039285714,23
2998.14492,36,57,0.77,21,0.036666667,23
2997.916389,33,53,0.83,20,0.0415,23
2997.873759,65,79,0.29,14,0.020714286,23
2997.873759,64,80,0.33,16,0.020625,23
2997.722815,52,83,0.9,31,0.029032258,23
2997.57732,43,55,0.4,12,0.033333333,23
2997.536452,37,58,0.78,21,0.037142857,23
2996.948594,56,88,0.71,32,0.0221875,23
2996.925903,43,58,0.46,15,0.030666667,23
2996.669729,37,96,0.1,59,0.001694915,23
2996.591634,36,62,0.92,26,0.035384615,23
2996.538203,58,77,0.53,19,0.027894737,23
2996.538203,57,78,0.59,21,0.028095238,23
2996.411785,43,72,0.76,29,0.026206897,23
2996.260362,62,65,0.1,3,0.033333333,23
2995.952304,42,61,0.61,19,0.032105263,23
2995.851353,57,88,0.81,31,0.026129032,23
2995.851353,56,90,0.88,34,0.025882353,23
2995.851353,54,92,0.99,38,0.026052632,23
2995.767547,54,72,0.61,18,0.033888889,23
2995.767547,53,73,0.68,20,0.034,23
2995.503762,45,75,0.78,30,0.026,23
2995.321615,56,77,0.61,21,0.029047619,23
2995.321615,55,78,0.67,23,0.029130435,23
2995.194799,54,65,0.29,11,0.026363636,23
2995.175618,45,71,0.71,26,0.027307692,23
2995.170141,67,69,0.06,2,0.03,23
2995.170141,66,70,0.12,4,0.03,23
2995.170141,65,71,0.18,6,0.03,23
2995.170141,64,72,0.24,8,0.03,23
2995.170141,63,73,0.3,10,0.03,23
2995.170141,62,74,0.36,12,0.03,23
2995.170141,61,75,0.42,14,0.03,23
2995.170141,60,76,0.48,16,0.03,23
2995.140849,40,75,0.96,35,0.027428571,23
2995.106938,38,57,0.67,19,0.035263158,23
2994.935028,49,65,0.43,16,0.026875,23
2994.907938,43,71,0.7,28,0.025,23
2994.595749,47,67,0.57,20,0.0285,23
2994.507787,36,53,0.62,17,0.036470588,23
2994.501486,42,71,0.84,29,0.028965517,23
2994.333456,46,64,0.46,18,0.025555556,23
2994.23848,49,63,0.46,14,0.032857143,23
2994.23848,48,64,0.53,16,0.033125,23
2994.183375,60,83,0.58,23,0.025217391,23
2993.883529,55,78,0.68,23,0.029565217,23
2993.731021,46,53,0.23,7,0.032857143,23
2993.689719,43,73,0.85,30,0.028333333,23
2993.55476,35,99,0.13,64,0.00203125,23
2993.513867,44,67,0.64,23,0.027826087,23
2993.371504,43,83,0.97,40,0.02425,23
2993.358494,45,70,0.69,25,0.0276,23
2993.292799,58,86,0.74,28,0.026428571,23
2993.292799,55,90,0.92,35,0.026285714,23
2993.045905,58,80,0.64,22,0.029090909,23
2993.045905,57,81,0.7,24,0.029166667,23
2993.045905,56,82,0.76,26,0.029230769,23
2993.045905,55,83,0.82,28,0.029285714,23
2992.830602,41,58,0.55,17,0.032352941,23
2992.597048,42,76,0.82,34,0.024117647,23
2992.409641,52,61,0.26,9,0.028888889,23
2992.266735,55,94,0.97,39,0.024871795,23
2992.09531,57,89,0.83,32,0.0259375,23
2992.09531,55,91,0.94,36,0.026111111,23
2992.09531,55,92,0.95,37,0.025675676,23
2991.971346,50,61,0.28,11,0.025454545,23
2991.885298,57,83,0.74,26,0.028461538,23
2991.761932,47,73,0.67,26,0.025769231,23
2991.697893,57,86,0.65,29,0.022413793,23
2991.526504,55,65,0.26,10,0.026,23
2991.361235,45,76,0.79,31,0.025483871,23
2991.251508,41,72,0.87,31,0.028064516,23
2991.232003,32,53,0.88,21,0.041904762,23
2991.189497,36,49,0.53,13,0.040769231,23
2991.180322,63,76,0.37,13,0.028461538,23
2991.042916,41,75,0.88,34,0.025882353,23
2990.965281,38,96,0.11,58,0.001896552,23
2990.860445,42,73,0.82,31,0.026451613,23
2990.845932,43,73,0.82,30,0.027333333,23
2990.50635,33,61,0.95,28,0.033928571,23
2990.35294,34,61,0.98,27,0.036296296,23
2990.233747,43,59,0.52,16,0.0325,23
2990.158772,46,72,0.61,26,0.023461538,23
2989.638271,54,79,0.74,25,0.0296,23
2989.638271,53,80,0.8,27,0.02962963,23
2989.612842,60,83,0.61,23,0.026521739,23
2989.608078,37,62,0.78,25,0.0312,23
2989.416003,40,77,0.89,37,0.024054054,23
2989.400269,45,64,0.54,19,0.028421053,23
2989.350351,55,79,0.71,24,0.029583333,23
2989.138552,66,78,0.25,12,0.020833333,23
2988.98332,41,71,0.86,30,0.028666667,23
2988.981531,62,63,0.03,1,0.03,23
2988.978538,44,73,0.74,29,0.025517241,23
2988.949162,64,79,0.42,15,0.028,23
2988.872911,52,62,0.23,10,0.023,23
2988.65348,35,62,0.92,27,0.034074074,23
2988.483984,38,56,0.68,18,0.037777778,23
2988.366305,54,80,0.83,26,0.031923077,23
2988.290233,40,60,0.66,20,0.033,23
2988.01296,48,61,0.34,13,0.026153846,23
2987.96771,68,83,0.3,15,0.02,23
2987.906824,48,66,0.48,18,0.026666667,23
2987.836891,45,69,0.68,24,0.028333333,23
2987.664973,41,78,0.9,37,0.024324324,23
2987.344736,58,75,0.49,17,0.028823529,23
2987.344736,57,76,0.55,19,0.028947368,23
2987.130714,53,61,0.21,8,0.02625,23
2987.112765,43,55,0.43,12,0.035833333,23
2986.918986,60,79,0.53,19,0.027894737,23
2986.751226,42,45,0.12,3,0.04,23
2986.657884,40,77,0.91,37,0.024594595,23
2986.559598,43,75,0.76,32,0.02375,23
2986.417779,60,74,0.44,14,0.031428571,23
2986.287496,44,53,0.3,9,0.033333333,23
2985.911209,36,62,0.93,26,0.035769231,23
2985.808938,46,68,0.62,22,0.028181818,23
2985.789002,39,58,0.61,19,0.032105263,23
2985.736448,42,57,0.52,15,0.034666667,23
2985.640788,54,59,0.14,5,0.028,23
2985.567986,42,55,0.43,13,0.033076923,23
2985.47868,66,79,0.36,13,0.027692308,23
2985.25172,47,65,0.45,18,0.025,23
2985.166639,74,76,0.04,2,0.02,23
2985.166639,73,77,0.08,4,0.02,23
2985.166639,72,78,0.12,6,0.02,23
2985.147331,56,76,0.6,20,0.03,23
2985.147331,55,77,0.66,22,0.03,23
2985.099264,46,68,0.63,22,0.028636364,23
2985.04466,63,72,0.25,9,0.027777778,23
2985.04466,60,76,0.44,16,0.0275,23
2984.68819,43,56,0.41,13,0.031538462,23
2984.651869,58,76,0.57,18,0.031666667,23
2984.465119,56,88,0.85,32,0.0265625,23
2984.462294,48,60,0.31,12,0.025833333,23
2984.242059,41,73,0.86,32,0.026875,23
2984.12718,47,67,0.53,20,0.0265,23
2983.940954,52,87,0.94,35,0.026857143,23
2983.842799,47,61,0.36,14,0.025714286,23
2983.776784,53,60,0.2,7,0.028571429,23
2983.758731,55,68,0.46,13,0.035384615,23
2983.723964,36,56,0.78,20,0.039,23
2983.632804,46,74,0.73,28,0.026071429,23
2983.378106,45,51,0.2,6,0.033333333,23
2983.211996,38,62,0.82,24,0.034166667,23
2983.208125,34,59,0.91,25,0.0364,23
2983.08961,48,66,0.51,18,0.028333333,23
2982.838395,39,50,0.4,11,0.036363636,23
2982.820684,45,57,0.39,12,0.0325,23
2982.693349,52,83,0.91,31,0.029354839,23
2982.656274,36,56,0.71,20,0.0355,23
2982.622691,60,89,0.58,29,0.02,23
2982.519857,43,73,0.81,30,0.027,23
2982.404887,51,84,0.98,33,0.02969697,23
2982.199552,54,91,0.98,37,0.026486486,23
2982.195019,41,57,0.54,16,0.03375,23
2982.11946,54,66,0.31,12,0.025833333,23
2982.059468,39,95,0.1,56,0.001785714,23
2981.910202,57,87,0.8,30,0.026666667,23
2981.879695,46,74,0.72,28,0.025714286,23
2981.827455,54,79,0.75,25,0.03,23
2981.827455,53,80,0.81,27,0.03,23
2981.827455,53,81,0.83,28,0.029642857,23
2981.827455,52,81,0.87,29,0.03,23
2981.827455,52,82,0.89,30,0.029666667,23
2981.827455,51,83,0.95,32,0.0296875,23
2981.808308,37,52,0.55,15,0.036666667,23
2981.273102,54,86,0.93,32,0.0290625,23
2981.209909,53,82,0.81,29,0.027931034,23
2981.138761,37,57,0.76,20,0.038,23
2981.110691,46,78,0.77,32,0.0240625,23
2981.023007,43,79,0.9,36,0.025,23
2980.972476,36,57,0.73,21,0.034761905,23
2980.932637,43,64,0.61,21,0.029047619,23
2980.736107,36,54,0.68,18,0.037777778,23
2980.441383,48,66,0.42,18,0.023333333,23
2979.943971,63,80,0.48,17,0.028235294,23
