% profit,ema1,ema2,threshold,diff,thresh / diff,ID
3870.202415,38,50,0.42,12,0.035,7
3866.482399,36,53,0.59,17,0.034705882,7
3754.76105,39,49,0.35,10,0.035,7
3735.940726,41,47,0.21,6,0.035,7
3735.940726,40,48,0.28,8,0.035,7
3678.826682,42,46,0.14,4,0.035,7
3672.80307,35,54,0.66,19,0.034736842,7
3641.820279,34,60,0.82,26,0.031538462,7
3618.68316,35,59,0.75,24,0.03125,7
3584.1039,36,52,0.57,16,0.035625,7
3569.520893,38,51,0.45,13,0.034615385,7
3569.520893,37,52,0.52,15,0.034666667,7
3526.395902,43,45,0.07,2,0.035,7
3491.342941,39,52,0.42,13,0.032307692,7
3489.124558,39,48,0.32,9,0.035555556,7
3479.977277,37,56,0.6,19,0.031578947,7
3439.227108,34,55,0.73,21,0.034761905,7
3432.549954,37,49,0.44,12,0.036666667,7
3423.387898,34,54,0.72,20,0.036,7
3401.29932,41,46,0.18,5,0.036,7
3382.654276,39,50,0.37,11,0.033636364,7
3370.903877,34,55,0.74,21,0.035238095,7
3369.155674,36,57,0.67,21,0.031904762,7
3368.815694,40,47,0.25,7,0.035714286,7
3362.412978,39,50,0.38,11,0.034545455,7
3362.196241,43,46,0.1,3,0.033333333,7
3352.191131,33,56,0.8,23,0.034782609,7
3348.925896,35,58,0.73,23,0.03173913,7
3342.82881,37,51,0.49,14,0.035,7
3333.491333,37,51,0.5,14,0.035714286,7
3320.558066,32,57,0.87,25,0.0348,7
3309.264233,42,48,0.2,6,0.033333333,7
3279.544369,39,47,0.29,8,0.03625,7
3268.473951,38,55,0.54,17,0.031764706,7
3259.542439,35,53,0.64,18,0.035555556,7
3258.670941,36,51,0.54,15,0.036,7
3255.809818,33,56,0.82,23,0.035652174,7
3255.39715,37,50,0.47,13,0.036153846,7
3249.519128,40,46,0.22,6,0.036666667,7
3246.823636,41,51,0.32,10,0.032,7
3237.874718,39,53,0.45,14,0.032142857,7
3230.787905,36,58,0.69,22,0.031363636,7
3230.080973,34,59,0.83,25,0.0332,7
3225.060373,32,58,0.89,26,0.034230769,7
3224.005338,32,57,0.9,25,0.036,7
3222.100132,32,59,0.93,27,0.034444444,7
3214.75552,34,56,0.76,22,0.034545455,7
3198.899592,35,58,0.77,23,0.033478261,7
3195.739483,42,49,0.23,7,0.032857143,7
3193.143177,35,54,0.67,19,0.035263158,7
3190.522635,40,50,0.33,10,0.033,7
3168.088515,72,74,0.04,2,0.02,7
3168.088515,71,75,0.08,4,0.02,7
3157.419323,38,51,0.44,13,0.033846154,7
3156.441497,35,53,0.66,18,0.036666667,7
3124.828367,33,56,0.83,23,0.036086957,7
3121.438961,34,61,0.84,27,0.031111111,7
3119.865266,40,51,0.36,11,0.032727273,7
3112.281999,56,85,0.8,29,0.027586207,7
3110.017003,33,55,0.8,22,0.036363636,7
3107.496692,54,88,0.93,34,0.027352941,7
3107.496692,53,89,0.99,36,0.0275,7
3104.000177,39,49,0.36,10,0.036,7
3103.817542,35,55,0.69,20,0.0345,7
3102.155016,39,51,0.4,12,0.033333333,7
3085.369043,33,63,0.92,30,0.030666667,7
3084.749495,34,59,0.85,25,0.034,7
3082.771658,38,53,0.51,15,0.034,7
3081.707484,31,59,0.96,28,0.034285714,7
3081.6725,41,52,0.35,11,0.031818182,7
3081.087217,61,68,0.23,7,0.032857143,7
3079.302692,55,87,0.87,32,0.0271875,7
3076.229572,38,54,0.52,16,0.0325,7
3070.102652,33,58,0.85,25,0.034,7
3068.647875,35,53,0.65,18,0.036111111,7
3067.738641,34,54,0.74,20,0.037,7
3066.299119,42,45,0.11,3,0.036666667,7
3064.832347,42,50,0.25,8,0.03125,7
3063.395719,36,53,0.6,17,0.035294118,7
3060.938071,70,76,0.12,6,0.02,7
3060.105038,37,55,0.58,18,0.032222222,7
3056.951871,32,58,0.93,26,0.035769231,7
3054.817335,35,54,0.68,19,0.035789474,7
3053.985214,34,59,0.84,25,0.0336,7
3052.728077,57,85,0.75,28,0.026785714,7
3049.8543,34,58,0.81,24,0.03375,7
3049.230893,69,77,0.16,8,0.02,7
3049.230893,68,78,0.2,10,0.02,7
3048.200868,57,85,0.76,28,0.027142857,7
3047.736051,34,55,0.76,21,0.036190476,7
3044.584139,56,74,0.59,18,0.032777778,7
3043.793377,35,57,0.74,22,0.033636364,7
3042.689713,31,58,0.95,27,0.035185185,7
3042.539666,37,56,0.59,19,0.031052632,7
3041.066573,38,55,0.53,17,0.031176471,7
3040.035911,56,86,0.81,30,0.027,7
3035.893101,55,86,0.86,31,0.027741935,7
3035.815474,56,86,0.82,30,0.027333333,7
3035.773258,33,56,0.81,23,0.035217391,7
3032.172565,36,56,0.68,20,0.034,7
3031.81203,38,50,0.43,12,0.035833333,7
3031.728959,34,54,0.73,20,0.0365,7
3029.557572,40,51,0.35,11,0.031818182,7
3028.268866,63,67,0.13,4,0.0325,7
3028.268866,61,69,0.26,8,0.0325,7
3027.588775,32,59,0.87,27,0.032222222,7
3026.473077,55,87,0.88,32,0.0275,7
3026.202002,55,87,0.86,32,0.026875,7
3026.032111,38,54,0.54,16,0.03375,7
3022.868392,38,53,0.49,15,0.032666667,7
3022.624323,41,48,0.23,7,0.032857143,7
3015.166146,63,70,0.22,7,0.031428571,7
3013.411621,55,74,0.63,19,0.033157895,7
3012.975698,32,58,0.9,26,0.034615385,7
3011.658757,33,57,0.85,24,0.035416667,7
3011.219696,58,83,0.69,25,0.0276,7
3011.02498,34,55,0.75,21,0.035714286,7
3009.13834,54,87,0.92,33,0.027878788,7
3009.037444,58,71,0.43,13,0.033076923,7
3008.872925,37,55,0.61,18,0.033888889,7
3008.273185,61,80,0.52,19,0.027368421,7
3006.550788,59,69,0.34,10,0.034,7
3005.68841,37,51,0.51,14,0.036428571,7
3005.527515,33,56,0.84,23,0.036521739,7
3004.138168,61,67,0.2,6,0.033333333,7
3003.175911,32,57,0.88,25,0.0352,7
3003.15586,59,71,0.39,12,0.0325,7
3002.508707,37,50,0.49,13,0.037692308,7
3001.269936,41,50,0.29,9,0.032222222,7
3001.087397,32,58,0.91,26,0.035,7
2999.59947,33,60,0.9,27,0.033333333,7
2996.444041,60,82,0.59,22,0.026818182,7
2996.294269,36,52,0.56,16,0.035,7
2995.942092,55,74,0.64,19,0.033684211,7
2994.942104,31,58,0.96,27,0.035555556,7
2994.480642,63,68,0.16,5,0.032,7
2994.2964,31,60,0.99,29,0.034137931,7
2993.748057,36,52,0.58,16,0.03625,7
2992.320355,33,57,0.82,24,0.034166667,7
2991.950307,55,75,0.66,20,0.033,7
2990.601273,36,58,0.68,22,0.030909091,7
2988.850152,40,52,0.38,12,0.031666667,7
2986.710838,55,73,0.61,18,0.033888889,7
2986.133434,57,72,0.5,15,0.033333333,7
2986.133434,56,73,0.57,17,0.033529412,7
2976.931427,60,68,0.27,8,0.03375,7
2973.589029,34,57,0.78,23,0.033913043,7
2972.651239,59,82,0.63,23,0.027391304,7
2972.579693,39,53,0.47,14,0.033571429,7
2972.206554,36,57,0.68,21,0.032380952,7
2971.061255,67,76,0.19,9,0.021111111,7
2970.656644,32,57,0.91,25,0.0364,7
2970.545875,35,58,0.76,23,0.033043478,7
2969.793491,34,54,0.75,20,0.0375,7
2969.138371,44,46,0.07,2,0.035,7
2969.138371,43,47,0.14,4,0.035,7
2968.963088,36,57,0.7,21,0.033333333,7
2968.148139,58,84,0.7,26,0.026923077,7
2964.764075,32,60,0.95,28,0.033928571,7
2964.678378,54,75,0.7,21,0.033333333,7
2964.678378,53,76,0.77,23,0.033478261,7
2963.733302,52,79,0.89,27,0.032962963,7
2962.616668,58,72,0.46,14,0.032857143,7
2962.034374,55,88,0.88,33,0.026666667,7
2960.414629,54,76,0.73,22,0.033181818,7
2960.414629,53,77,0.8,24,0.033333333,7
2960.202763,36,54,0.62,18,0.034444444,7
2959.825981,60,81,0.58,21,0.027619048,7
2957.662675,53,90,0.99,37,0.026756757,7
2955.540344,57,71,0.47,14,0.033571429,7
2955.540344,56,72,0.54,16,0.03375,7
2954.797223,32,57,0.92,25,0.0368,7
2953.662973,63,69,0.19,6,0.031666667,7
2953.521812,38,54,0.51,16,0.031875,7
2953.240359,64,79,0.32,15,0.021333333,7
2951.83823,37,95,0.13,58,0.002241379,7
2951.146955,59,70,0.37,11,0.033636364,7
2950.462447,54,77,0.75,23,0.032608696,7
2950.337174,52,78,0.87,26,0.033461538,7
2950.186705,43,48,0.16,5,0.032,7
2947.002751,37,53,0.55,16,0.034375,7
2946.566288,54,89,0.94,35,0.026857143,7
2946.492439,33,55,0.82,22,0.037272727,7
2946.202905,32,57,0.93,25,0.0372,7
2944.557032,51,79,0.94,28,0.033571429,7
2943.827079,55,88,0.89,33,0.026969697,7
2941.406113,61,66,0.17,5,0.034,7
2939.055334,34,55,0.72,21,0.034285714,7
2938.437006,54,89,0.92,35,0.026285714,7
2938.202191,51,80,0.96,29,0.033103448,7
2938.01288,57,86,0.77,29,0.026551724,7
2937.979651,36,54,0.61,18,0.033888889,7
2937.067312,35,59,0.76,24,0.031666667,7
2936.749442,32,56,0.89,24,0.037083333,7
2936.723148,39,52,0.43,13,0.033076923,7
2936.286628,54,89,0.95,35,0.027142857,7
2935.604141,36,53,0.57,17,0.033529412,7
2935.514052,38,52,0.48,14,0.034285714,7
2934.921223,64,81,0.35,17,0.020588235,7
2934.814199,60,83,0.6,23,0.026086957,7
2934.328244,39,53,0.44,14,0.031428571,7
2934.093842,55,89,0.9,34,0.026470588,7
2934.031145,33,55,0.81,22,0.036818182,7
2932.76543,53,90,0.98,37,0.026486486,7
2931.607058,59,81,0.62,22,0.028181818,7
2930.825072,54,87,0.93,33,0.028181818,7
2930.031366,60,72,0.38,12,0.031666667,7
2929.883248,56,87,0.83,31,0.026774194,7
2929.437903,38,52,0.47,14,0.033571429,7
2929.280237,35,52,0.62,17,0.036470588,7
2928.726118,37,57,0.63,20,0.0315,7
2927.616789,38,53,0.5,15,0.033333333,7
2926.738167,34,57,0.79,23,0.034347826,7
2926.32888,55,89,0.91,34,0.026764706,7
2923.683187,31,58,0.99,27,0.036666667,7
2921.857684,44,49,0.16,5,0.032,7
2921.45177,37,93,0.16,56,0.002857143,7
2920.463901,57,86,0.78,29,0.026896552,7
2920.150809,35,53,0.63,18,0.035,7
2918.338813,54,90,0.96,36,0.026666667,7
2916.898795,40,47,0.26,7,0.037142857,7
2915.649793,63,66,0.1,3,0.033333333,7
2915.649793,60,69,0.3,9,0.033333333,7
2915.520218,56,84,0.8,28,0.028571429,7
2915.399688,33,62,0.91,29,0.03137931,7
2914.574878,54,88,0.94,34,0.027647059,7
2914.422944,54,90,0.97,36,0.026944444,7
2914.266782,53,87,0.97,34,0.028529412,7
2912.745284,54,88,0.92,34,0.027058824,7
2912.717356,36,57,0.69,21,0.032857143,7
2912.619543,32,61,0.97,29,0.033448276,7
2912.606719,53,78,0.82,25,0.0328,7
2911.87228,34,98,0.16,64,0.0025,7
2911.797102,51,82,0.91,31,0.029354839,7
2911.537625,36,94,0.17,58,0.002931034,7
2911.184832,63,74,0.33,11,0.03,7
2911.154328,40,50,0.35,10,0.035,7
2911.113897,58,85,0.71,27,0.026296296,7
2910.741084,60,83,0.61,23,0.026521739,7
2910.741084,60,84,0.63,24,0.02625,7
2910.741084,57,87,0.79,30,0.026333333,7
2910.249142,57,84,0.75,27,0.027777778,7
2909.656584,34,54,0.76,20,0.038,7
2909.485089,35,54,0.64,19,0.033684211,7
2909.094835,37,52,0.5,15,0.033333333,7
2909.094835,35,55,0.66,20,0.033,7
2908.833518,57,83,0.74,26,0.028461538,7
2908.482781,31,59,0.98,28,0.035,7
2907.599981,36,55,0.65,19,0.034210526,7
2907.538348,58,82,0.68,24,0.028333333,7
2907.229559,57,87,0.78,30,0.026,7
2907.229559,56,88,0.84,32,0.02625,7
2907.229559,55,90,0.91,35,0.026,7
2906.689678,38,56,0.56,18,0.031111111,7
2905.935376,42,47,0.17,5,0.034,7
2905.518927,53,88,0.97,35,0.027714286,7
2904.787079,38,49,0.41,11,0.037272727,7
2904.702032,59,71,0.4,12,0.033333333,7
2903.705843,38,54,0.53,16,0.033125,7
2903.578855,54,86,0.91,32,0.0284375,7
2902.68443,58,85,0.72,27,0.026666667,7
2900.955291,37,56,0.61,19,0.032105263,7
2900.700756,37,94,0.15,57,0.002631579,7
2900.135266,42,48,0.21,6,0.035,7
2900.135266,41,49,0.28,8,0.035,7
2899.984389,31,59,0.97,28,0.034642857,7
2899.404018,60,70,0.33,10,0.033,7
2899.040038,53,80,0.79,27,0.029259259,7
2898.705526,36,57,0.66,21,0.031428571,7
2898.067212,55,75,0.67,20,0.0335,7
2896.277077,35,98,0.14,63,0.002222222,7
2895.041672,34,81,0.11,47,0.002340426,7
2894.917562,42,49,0.24,7,0.034285714,7
2894.103648,41,48,0.24,7,0.034285714,7
2894.103648,40,49,0.31,9,0.034444444,7
2893.761253,57,73,0.53,16,0.033125,7
2892.743145,60,80,0.57,20,0.0285,7
2892.673358,32,59,0.94,27,0.034814815,7
2892.637955,58,70,0.4,12,0.033333333,7
2892.03846,43,72,0.92,29,0.031724138,7
2891.184703,35,57,0.72,22,0.032727273,7
2890.461132,33,57,0.84,24,0.035,7
2890.086855,38,50,0.44,12,0.036666667,7
2889.58634,39,55,0.58,16,0.03625,7
2889.551186,53,89,0.98,36,0.027222222,7
2889.3839,34,56,0.73,22,0.033181818,7
2888.568644,56,74,0.6,18,0.033333333,7
2888.38522,52,81,0.85,29,0.029310345,7
2888.21472,35,54,0.69,19,0.036315789,7
2887.973831,44,46,0.08,2,0.04,7
2887.970953,36,53,0.61,17,0.035882353,7
2887.38806,36,52,0.59,16,0.036875,7
2887.057594,57,88,0.81,31,0.026129032,7
2887.017229,34,64,0.95,30,0.031666667,7
2886.407704,56,85,0.81,29,0.027931034,7
2886.407704,55,86,0.87,31,0.028064516,7
2885.744315,33,58,0.86,25,0.0344,7
2885.376343,58,72,0.47,14,0.033571429,7
2885.178294,35,98,0.15,63,0.002380952,7
2884.773346,53,88,0.98,35,0.028,7
2884.461346,50,84,0.98,34,0.028823529,7
2883.821139,59,83,0.65,24,0.027083333,7
2883.78268,55,85,0.85,30,0.028333333,7
2883.608412,35,96,0.17,61,0.002786885,7
2883.485744,58,86,0.74,28,0.026428571,7
2883.194155,66,78,0.25,12,0.020833333,7
2882.238526,40,77,0.93,37,0.025135135,7
2882.158531,57,87,0.8,30,0.026666667,7
2881.341104,48,59,0.03,11,0.002727273,7
2881.000323,61,70,0.29,9,0.032222222,7
2880.686473,63,81,0.38,18,0.021111111,7
2880.319418,58,84,0.71,26,0.027307692,7
2879.949769,62,80,0.48,18,0.026666667,7
2879.23844,37,51,0.52,14,0.037142857,7
2878.898047,52,79,0.9,27,0.033333333,7
2877.139373,33,57,0.86,24,0.035833333,7
2876.722714,31,61,0.96,30,0.032,7
2876.216114,54,91,0.98,37,0.026486486,7
2876.105633,62,81,0.5,19,0.026315789,7
2875.55984,33,56,0.86,23,0.037391304,7
2875.518873,61,79,0.51,18,0.028333333,7
2875.454225,32,58,0.92,26,0.035384615,7
2875.081744,33,56,0.85,23,0.036956522,7
2874.912666,35,55,0.7,20,0.035,7
2874.912666,34,56,0.77,22,0.035,7
2874.788273,59,81,0.63,22,0.028636364,7
2874.222903,61,83,0.56,22,0.025454545,7
2874.127422,35,58,0.75,23,0.032608696,7
2873.446426,54,91,0.97,37,0.026216216,7
2873.341996,53,91,0.98,38,0.025789474,7
2872.994073,56,85,0.82,29,0.028275862,7
2872.112649,54,89,0.93,35,0.026571429,7
2871.805461,56,89,0.87,33,0.026363636,7
2871.132879,35,58,0.74,23,0.032173913,7
2870.963861,38,51,0.43,13,0.033076923,7
2870.937173,39,54,0.48,15,0.032,7
2870.759201,43,47,0.13,4,0.0325,7
2870.448253,56,88,0.85,32,0.0265625,7
2870.448253,55,90,0.92,35,0.026285714,7
2869.991072,72,73,0.02,1,0.02,7
2869.405082,65,78,0.34,13,0.026153846,7
2869.113681,32,56,0.9,24,0.0375,7
2868.930313,37,54,0.58,17,0.034117647,7
2868.626069,65,82,0.34,17,0.02,7
2868.62411,36,56,0.65,20,0.0325,7
2868.010463,33,60,0.92,27,0.034074074,7
2866.907747,33,55,0.84,22,0.038181818,7
2865.930491,34,99,0.15,65,0.002307692,7
2865.730746,36,95,0.18,59,0.003050847,7
2865.261548,55,86,0.88,31,0.028387097,7
2865.261548,54,87,0.94,33,0.028484848,7
2865.125086,34,58,0.82,24,0.034166667,7
2864.947341,62,72,0.31,10,0.031,7
2864.004005,34,82,0.1,48,0.002083333,7
2863.857912,65,76,0.29,11,0.026363636,7
2863.821783,63,70,0.2,7,0.028571429,7
2863.529979,43,73,0.93,30,0.031,7
2863.510659,56,89,0.86,33,0.026060606,7
2863.352513,35,95,0.19,60,0.003166667,7
2862.471679,55,87,0.9,32,0.028125,7
2862.471679,54,88,0.96,34,0.028235294,7
2861.741186,35,52,0.61,17,0.035882353,7
2861.540185,69,74,0.13,5,0.026,7
2861.360835,63,78,0.41,15,0.027333333,7
2861.257245,60,73,0.41,13,0.031538462,7
2861.096959,33,61,0.93,28,0.033214286,7
2860.921529,37,52,0.51,15,0.034,7
2860.808238,62,82,0.51,20,0.0255,7
2860.808238,59,85,0.67,26,0.025769231,7
2860.149755,63,81,0.47,18,0.026111111,7
2859.508459,59,74,0.43,15,0.028666667,7
2859.267836,31,57,0.98,26,0.037692308,7
2859.23291,59,84,0.66,25,0.0264,7
2859.118835,55,91,0.93,36,0.025833333,7
2858.730547,54,82,0.77,28,0.0275,7
2858.670041,60,85,0.65,25,0.026,7
2856.949323,61,81,0.54,20,0.027,7
2856.599039,52,77,0.84,25,0.0336,7
2856.482345,58,87,0.76,29,0.026206897,7
2856.209746,40,49,0.3,9,0.033333333,7
2855.712601,35,56,0.68,21,0.032380952,7
2855.15819,68,74,0.16,6,0.026666667,7
2855.15819,65,77,0.32,12,0.026666667,7
2855.15819,63,80,0.45,17,0.026470588,7
2855.129747,36,96,0.14,60,0.002333333,7
2854.919631,32,57,0.89,25,0.0356,7
2854.86762,32,58,0.95,26,0.036538462,7
2854.61158,38,49,0.4,11,0.036363636,7
2854.376382,68,77,0.18,9,0.02,7
2854.146595,68,75,0.15,7,0.021428571,7
2853.638626,56,79,0.64,23,0.027826087,7
2853.4612,35,52,0.64,17,0.037647059,7
2853.137762,71,74,0.06,3,0.02,7
2853.137762,70,75,0.1,5,0.02,7
2853.137762,69,76,0.14,7,0.02,7
2853.134857,63,79,0.43,16,0.026875,7
2852.376349,55,91,0.9,36,0.025,7
2852.376349,54,92,0.95,38,0.025,7
2851.618763,59,72,0.42,13,0.032307692,7
2851.618763,57,74,0.55,17,0.032352941,7
2851.52995,66,79,0.26,13,0.02,7
2851.52995,65,80,0.3,15,0.02,7
2851.240348,32,84,0.12,52,0.002307692,7
2850.475475,53,92,0.98,39,0.025128205,7
2850.408405,57,78,0.58,21,0.027619048,7
2850.179752,56,84,0.79,28,0.028214286,7
2848.983685,62,81,0.41,19,0.021578947,7
2848.86337,40,54,0.44,14,0.031428571,7
2848.26931,61,83,0.57,22,0.025909091,7
2848.26931,59,85,0.68,26,0.026153846,7
2847.270203,35,51,0.6,16,0.0375,7
2847.270203,34,52,0.68,18,0.037777778,7
2847.250274,61,82,0.56,21,0.026666667,7
2846.483408,35,53,0.67,18,0.037222222,7
2845.129387,33,57,0.78,24,0.0325,7
2844.009358,54,92,0.99,38,0.026052632,7
2843.900073,58,87,0.75,29,0.025862069,7
2843.562856,57,89,0.83,32,0.0259375,7
2843.562856,55,91,0.94,36,0.026111111,7
2842.841604,38,49,0.39,11,0.035454545,7
2842.841604,37,50,0.46,13,0.035384615,7
2842.695754,31,57,0.97,26,0.037307692,7
2842.229125,58,87,0.74,29,0.025517241,7
2842.08368,56,87,0.84,31,0.027096774,7
2840.951311,64,79,0.39,15,0.026,7
2840.416447,35,57,0.75,22,0.034090909,7
2840.41368,66,81,0.3,15,0.02,7
2840.337599,36,95,0.14,59,0.002372881,7
2839.90275,36,52,0.6,16,0.0375,7
2839.800743,61,74,0.4,13,0.030769231,7
2839.773011,56,84,0.73,28,0.026071429,7
2839.445943,31,60,0.95,29,0.032758621,7
2839.267043,47,64,0.45,17,0.026470588,7
2839.118109,43,72,0.91,29,0.03137931,7
2839.060218,54,93,0.97,39,0.024871795,7
2838.415075,43,48,0.17,5,0.034,7
2836.688054,56,90,0.88,34,0.025882353,7
2836.386603,62,78,0.45,16,0.028125,7
2836.192781,68,99,0.54,31,0.017419355,7
2836.087573,57,87,0.77,30,0.025666667,7
2836.087573,56,89,0.83,33,0.025151515,7
2836.087573,55,90,0.89,35,0.025428571,7
2835.021374,67,73,0.17,6,0.028333333,7
2834.753955,35,61,0.8,26,0.030769231,7
2834.739725,45,70,0.78,25,0.0312,7
2834.629351,41,50,0.3,9,0.033333333,7
2834.252983,59,84,0.67,25,0.0268,7
2834.031819,35,96,0.18,61,0.00295082,7
2833.903825,65,81,0.33,16,0.020625,7
2832.670146,61,84,0.58,23,0.025217391,7
2832.670146,60,85,0.63,25,0.0252,7
2832.631511,56,81,0.67,25,0.0268,7
2832.61939,60,74,0.39,14,0.027857143,7
2832.300019,57,88,0.78,31,0.02516129,7
2832.288938,41,49,0.26,8,0.0325,7
2832.25796,63,81,0.46,18,0.025555556,7
2832.25796,60,84,0.62,24,0.025833333,7
2831.778999,59,78,0.51,19,0.026842105,7
2831.591341,37,93,0.14,56,0.0025,7
2830.266174,32,57,0.94,25,0.0376,7
2829.905,56,90,0.86,34,0.025294118,7
2829.522534,56,83,0.71,27,0.026296296,7
2828.864171,55,90,0.88,35,0.025142857,7
2828.864171,54,91,0.93,37,0.025135135,7
2828.648641,55,82,0.73,27,0.027037037,7
2828.324026,58,88,0.75,30,0.025,7
2828.152344,57,79,0.6,22,0.027272727,7
2828.145392,66,78,0.31,12,0.025833333,7
2828.122134,58,75,0.54,17,0.031764706,7
2828.051764,35,53,0.68,18,0.037777778,7
2827.989884,35,98,0.18,63,0.002857143,7
2827.772696,61,82,0.55,21,0.026190476,7
2827.772696,58,86,0.73,28,0.026071429,7
2827.302315,56,78,0.62,22,0.028181818,7
2826.932885,67,78,0.22,11,0.02,7
2826.920464,40,52,0.39,12,0.0325,7
2826.894287,53,88,0.99,35,0.028285714,7
2826.461538,34,56,0.78,22,0.035454545,7
2825.910724,33,57,0.87,24,0.03625,7
2825.74885,35,55,0.68,20,0.034,7
2825.743517,43,74,0.95,31,0.030645161,7
2825.681504,53,85,0.85,32,0.0265625,7
2825.509716,35,54,0.65,19,0.034210526,7
2825.377703,57,92,0.69,35,0.019714286,7
2825.275377,39,55,0.49,16,0.030625,7
2825.080218,36,96,0.15,60,0.0025,7
2825.048115,57,82,0.66,25,0.0264,7
2824.485488,34,99,0.16,65,0.002461538,7
2824.432965,58,83,0.7,25,0.028,7
2824.388012,31,57,0.99,26,0.038076923,7
2824.216612,57,80,0.62,23,0.026956522,7
2824.216612,54,83,0.79,29,0.027241379,7
2823.935304,34,62,0.86,28,0.030714286,7
2823.863072,60,83,0.5,23,0.02173913,7
2823.855064,55,92,0.95,37,0.025675676,7
2823.609263,40,53,0.41,13,0.031538462,7
2822.669685,37,57,0.62,20,0.031,7
2822.610246,34,65,0.93,31,0.03,7
2822.080003,56,80,0.66,24,0.0275,7
2822.006927,63,77,0.4,14,0.028571429,7
2822.002665,36,51,0.53,15,0.035333333,7
2821.18097,33,60,0.91,27,0.033703704,7
2821.162162,66,77,0.29,11,0.026363636,7
2821.039965,36,97,0.12,61,0.001967213,7
2820.779509,32,58,0.94,26,0.036153846,7
2820.733015,34,53,0.7,19,0.036842105,7
2820.389778,65,79,0.36,14,0.025714286,7
2820.389778,65,80,0.38,15,0.025333333,7
2820.389778,64,81,0.43,17,0.025294118,7
2820.363071,63,84,0.42,21,0.02,7
2820.299633,44,48,0.13,4,0.0325,7
2820.250382,62,82,0.52,20,0.026,7
2819.884414,57,84,0.76,27,0.028148148,7
2819.716624,43,52,0.26,9,0.028888889,7
2819.118301,57,88,0.8,31,0.025806452,7
2819.118301,56,89,0.85,33,0.025757576,7
2819.118301,55,91,0.92,36,0.025555556,7
2819.074439,58,86,0.72,28,0.025714286,7
2819.074439,56,89,0.84,33,0.025454545,7
2819.008791,44,71,0.85,27,0.031481481,7
2818.775541,59,75,0.5,16,0.03125,7
2818.533516,59,87,0.7,28,0.025,7
2817.416633,32,58,0.88,26,0.033846154,7
2817.274329,54,88,0.95,34,0.027941176,7
2817.217031,38,99,0.09,61,0.00147541,7
2817.163888,42,50,0.26,8,0.0325,7
2817.124047,37,50,0.48,13,0.036923077,7
2817.121717,58,81,0.61,23,0.026521739,7
2817.121717,56,83,0.72,27,0.026666667,7
2816.756996,32,62,0.94,30,0.031333333,7
2816.650703,55,85,0.86,30,0.028666667,7
2816.588446,65,75,0.27,10,0.027,7
2816.500992,60,86,0.67,26,0.025769231,7
2816.44724,32,56,0.85,24,0.035416667,7
2816.27784,33,61,0.94,28,0.033571429,7
2816.044813,61,76,0.4,15,0.026666667,7
2815.893663,33,55,0.78,22,0.035454545,7
2815.109894,59,76,0.53,17,0.031176471,7
2814.762498,55,81,0.71,26,0.027307692,7
2814.585172,55,76,0.7,21,0.033333333,7
2814.401571,54,83,0.78,29,0.026896552,7
2813.831377,36,94,0.18,58,0.003103448,7
2813.712972,63,82,0.49,19,0.025789474,7
2813.529422,58,77,0.52,19,0.027368421,7
2813.529422,56,80,0.65,24,0.027083333,7
2813.459222,35,56,0.72,21,0.034285714,7
2813.173231,33,55,0.83,22,0.037727273,7
2812.782924,56,75,0.62,19,0.032631579,7
2811.873836,54,81,0.75,27,0.027777778,7
2811.473954,52,80,0.93,28,0.033214286,7
2811.396588,38,67,0.14,29,0.004827586,7
2811.220082,58,83,0.68,25,0.0272,7
2811.216401,55,90,0.93,35,0.026571429,7
2810.978539,62,73,0.31,11,0.028181818,7
2810.915132,55,84,0.77,29,0.026551724,7
2810.821191,58,83,0.71,25,0.0284,7
2810.749211,34,63,0.88,29,0.030344828,7
2810.475751,68,77,0.23,9,0.025555556,7
2810.443459,52,86,0.91,34,0.026764706,7
2809.948752,62,83,0.53,21,0.025238095,7
2809.948752,60,86,0.65,26,0.025,7
2809.906016,59,82,0.64,23,0.027826087,7
2809.816975,32,85,0.12,53,0.002264151,7
2809.634261,63,73,0.27,10,0.027,7
2809.572494,55,80,0.69,25,0.0276,7
2809.51929,57,84,0.74,27,0.027407407,7
2809.141187,61,75,0.38,14,0.027142857,7
2809.141187,59,77,0.49,18,0.027222222,7
2809.07669,55,82,0.72,27,0.026666667,7
2809.052983,54,92,0.98,38,0.025789474,7
2809.035244,53,84,0.85,31,0.027419355,7
2809.011823,59,75,0.45,16,0.028125,7
2808.983992,52,88,0.94,36,0.026111111,7
2808.809468,56,79,0.63,23,0.027391304,7
2808.685561,66,76,0.27,10,0.027,7
2807.768189,50,84,0.99,34,0.029117647,7
2807.3033,61,84,0.59,23,0.025652174,7
2807.04077,61,71,0.32,10,0.032,7
2807.04077,58,74,0.51,16,0.031875,7
2806.822273,53,92,0.99,39,0.025384615,7
2806.452705,33,58,0.87,25,0.0348,7
2806.259787,55,85,0.79,30,0.026333333,7
2806.146981,55,88,0.87,33,0.026363636,7
2805.5705,39,57,0.58,18,0.032222222,7
2805.458989,41,51,0.31,10,0.031,7
2805.400042,55,85,0.78,30,0.026,7
2805.371118,66,79,0.34,13,0.026153846,7
2805.043212,59,74,0.48,15,0.032,7
2804.453388,62,73,0.3,11,0.027272727,7
2804.448281,63,71,0.25,8,0.03125,7
2804.391196,64,80,0.41,16,0.025625,7
2804.298044,55,79,0.76,24,0.031666667,7
2804.145717,37,59,0.71,22,0.032272727,7
2804.04859,53,87,0.89,34,0.026176471,7
2804.01962,58,76,0.51,18,0.028333333,7
2803.977444,32,61,0.99,29,0.034137931,7
2803.869327,58,79,0.56,21,0.026666667,7
2803.661887,59,77,0.55,18,0.030555556,7
2803.408951,60,78,0.48,18,0.026666667,7
2803.398001,55,83,0.75,28,0.026785714,7
2803.398001,54,84,0.81,30,0.027,7
2803.14595,56,82,0.69,26,0.026538462,7
2802.757958,38,52,0.46,14,0.032857143,7
2801.90115,61,83,0.58,22,0.026363636,7
2801.663334,59,87,0.72,28,0.025714286,7
2801.313209,73,90,0.3,17,0.017647059,7
2800.989858,56,77,0.67,21,0.031904762,7
2800.84935,56,88,0.82,32,0.025625,7
2800.84935,55,89,0.87,34,0.025588235,7
2800.84935,54,91,0.94,37,0.025405405,7
2800.790955,66,83,0.33,17,0.019411765,7
2800.686122,33,57,0.83,24,0.034583333,7
2800.632486,56,91,0.9,35,0.025714286,7
2800.604016,37,53,0.54,16,0.03375,7
2800.377853,38,53,0.52,15,0.034666667,7
2800.086985,63,82,0.48,19,0.025263158,7
2799.90598,55,91,0.95,36,0.026388889,7
2799.847168,56,81,0.68,25,0.0272,7
2799.60289,60,85,0.64,25,0.0256,7
2799.447936,35,95,0.18,60,0.003,7
2799.369617,55,87,0.89,32,0.0278125,7
2799.137901,37,94,0.17,57,0.002982456,7
2799.067541,33,59,0.88,26,0.033846154,7
2799.064431,66,71,0.15,5,0.03,7
2799.064431,65,72,0.21,7,0.03,7
2799.064431,64,73,0.27,9,0.03,7
2798.820664,52,89,0.96,37,0.025945946,7
2798.732758,34,61,0.83,27,0.030740741,7
2798.449633,53,91,0.99,38,0.026052632,7
2798.342699,65,70,0.14,5,0.028,7
2798.296913,55,90,0.9,35,0.025714286,7
2798.296913,55,91,0.91,36,0.025277778,7
2798.296913,54,92,0.96,38,0.025263158,7
2797.75984,55,92,0.93,37,0.025135135,7
2797.758517,37,52,0.53,15,0.035333333,7
2797.417983,68,79,0.22,11,0.02,7
2797.359533,51,88,0.98,37,0.026486486,7
2797.278722,59,86,0.7,27,0.025925926,7
2797.174705,57,75,0.58,18,0.032222222,7
2797.174705,55,77,0.71,22,0.032272727,7
2797.128486,62,80,0.5,18,0.027777778,7
2797.117403,36,54,0.6,18,0.033333333,7
2797.048934,68,81,0.25,13,0.019230769,7
2797.048934,67,82,0.29,15,0.019333333,7
2796.932993,59,84,0.69,25,0.0276,7
2796.854949,33,82,0.12,49,0.00244898,7
2796.779578,33,83,0.12,50,0.0024,7
2796.564157,55,78,0.67,23,0.029130435,7
2796.542146,37,55,0.6,18,0.033333333,7
2795.825882,34,97,0.2,63,0.003174603,7
2795.798504,40,50,0.36,10,0.036,7
2795.777801,60,71,0.36,11,0.032727273,7
2795.538818,39,54,0.5,15,0.033333333,7
2795.071347,37,49,0.45,12,0.0375,7
2795.043269,31,58,0.98,27,0.036296296,7
2795.026306,60,79,0.5,19,0.026315789,7
2795.00606,43,73,0.94,30,0.031333333,7
2794.938636,56,90,0.89,34,0.026176471,7
2794.72341,43,49,0.19,6,0.031666667,7
2794.69939,34,98,0.18,64,0.0028125,7
2794.66627,36,51,0.57,15,0.038,7
2794.372525,36,50,0.52,14,0.037142857,7
2794.205908,67,97,0.54,30,0.018,7
2794.152231,39,48,0.34,9,0.037777778,7
2793.960021,34,97,0.19,63,0.003015873,7
2793.727796,60,75,0.42,15,0.028,7
2793.669881,32,59,0.92,27,0.034074074,7
2793.341106,57,79,0.68,22,0.030909091,7
2793.297973,60,76,0.49,16,0.030625,7
2793.017352,53,81,0.8,28,0.028571429,7
2793.017352,52,82,0.86,30,0.028666667,7
2792.989759,38,68,0.13,30,0.004333333,7
2792.92244,55,84,0.76,29,0.026206897,7
2792.773086,34,54,0.7,20,0.035,7
2791.854489,43,51,0.27,8,0.03375,7
2791.840258,55,79,0.7,24,0.029166667,7
2791.55687,57,81,0.64,24,0.026666667,7
2791.497871,62,74,0.33,12,0.0275,7
2791.411327,56,84,0.74,28,0.026428571,7
2791.406785,67,80,0.26,13,0.02,7
2791.123938,39,54,0.46,15,0.030666667,7
2790.925722,54,81,0.85,27,0.031481481,7
2790.903082,61,72,0.35,11,0.031818182,7
2790.682993,37,94,0.13,57,0.002280702,7
2790.394971,33,84,0.11,51,0.002156863,7
2789.687132,64,80,0.34,16,0.02125,7
2789.517015,37,53,0.53,16,0.033125,7
2789.332088,58,75,0.5,17,0.029411765,7
2789.236181,57,89,0.81,32,0.0253125,7
2789.227507,56,78,0.63,22,0.028636364,7
2789.202732,54,85,0.82,31,0.026451613,7
2789.112923,67,77,0.26,10,0.026,7
2788.777447,54,90,0.95,36,0.026388889,7
2788.714466,62,83,0.54,21,0.025714286,7
2788.714466,58,88,0.77,30,0.025666667,7
2788.714466,57,89,0.82,32,0.025625,7
2788.714466,56,90,0.87,34,0.025588235,7
2788.714466,55,92,0.94,37,0.025405405,7
2788.606794,54,92,0.97,38,0.025526316,7
2788.561719,58,78,0.54,20,0.027,7
2788.47975,36,93,0.19,57,0.003333333,7
2788.07095,58,89,0.79,31,0.025483871,7
2788.07095,56,92,0.91,36,0.025277778,7
2787.961591,60,76,0.44,16,0.0275,7
2787.361935,37,55,0.59,18,0.032777778,7
2786.533842,31,60,0.94,29,0.032413793,7
2786.31375,32,58,0.96,26,0.036923077,7
2786.238927,34,55,0.77,21,0.036666667,7
2786.088497,57,86,0.81,29,0.027931034,7
2786.039214,44,71,0.86,27,0.031851852,7
2785.801173,36,56,0.67,20,0.0335,7
2785.784726,61,74,0.36,13,0.027692308,7
2785.559441,67,78,0.28,11,0.025454545,7
2785.559441,66,79,0.33,13,0.025384615,7
2785.559441,63,83,0.5,20,0.025,7
2785.559441,62,84,0.55,22,0.025,7
2785.420869,57,77,0.56,20,0.028,7
2785.326409,56,77,0.68,21,0.032380952,7
2785.267427,53,79,0.86,26,0.033076923,7
2784.97235,57,83,0.68,26,0.026153846,7
2784.798327,44,50,0.21,6,0.035,7
2783.919278,36,53,0.58,17,0.034117647,7
2783.842202,58,85,0.75,27,0.027777778,7
2783.761056,66,98,0.58,32,0.018125,7
2783.725318,57,90,0.82,33,0.024848485,7
2783.718183,59,86,0.69,27,0.025555556,7
2783.676198,63,72,0.25,9,0.027777778,7
2783.630494,59,73,0.45,14,0.032142857,7
2783.627917,69,78,0.18,9,0.02,7
2783.601405,38,49,0.42,11,0.038181818,7
2783.348415,54,90,0.94,36,0.026111111,7
2783.271754,35,60,0.78,25,0.0312,7
2783.069271,40,54,0.43,14,0.030714286,7
2782.997636,35,52,0.65,17,0.038235294,7
2782.997636,34,53,0.73,19,0.038421053,7
2782.638098,56,89,0.9,33,0.027272727,7
2782.32434,66,99,0.59,33,0.017878788,7
2782.032345,59,79,0.53,20,0.0265,7
2781.714093,62,68,0.2,6,0.033333333,7
2781.600321,57,76,0.56,19,0.029473684,7
2781.600321,56,77,0.62,21,0.02952381,7
2781.06329,59,87,0.71,28,0.025357143,7
2780.956723,70,75,0.13,5,0.026,7
2780.839613,63,75,0.32,12,0.026666667,7
2780.557321,64,82,0.45,18,0.025,7
2780.557321,60,87,0.67,27,0.024814815,7
2780.52578,59,72,0.43,13,0.033076923,7
2780.422536,65,77,0.33,12,0.0275,7
2780.216115,70,96,0.46,26,0.017692308,7
2780.201548,54,90,0.93,36,0.025833333,7
2780.032179,64,79,0.4,15,0.026666667,7
2779.651588,55,92,0.96,37,0.025945946,7
2779.608717,64,68,0.13,4,0.0325,7
2779.444609,58,88,0.76,30,0.025333333,7
2779.32736,57,77,0.57,20,0.0285,7
2779.088477,53,83,0.83,30,0.027666667,7
2779.039819,57,90,0.84,33,0.025454545,7
2778.885789,35,96,0.19,61,0.003114754,7
2778.750987,62,81,0.51,19,0.026842105,7
2778.722261,33,60,0.86,27,0.031851852,7
2778.620614,54,86,0.84,32,0.02625,7
2778.107564,36,97,0.14,61,0.002295082,7
2778.015969,53,82,0.82,29,0.028275862,7
2778.015969,52,83,0.88,31,0.028387097,7
2778.015969,52,84,0.89,32,0.0278125,7
2778.015969,51,85,0.95,34,0.027941176,7
2777.930022,58,78,0.55,20,0.0275,7
2777.575114,51,58,0.19,7,0.027142857,7
2777.434438,37,92,0.18,55,0.003272727,7
2777.412252,30,85,0.18,55,0.003272727,7
2777.409481,31,83,0.14,52,0.002692308,7
2777.305311,62,73,0.34,11,0.030909091,7
2777.079262,37,93,0.17,56,0.003035714,7
2776.945309,33,56,0.79,23,0.034347826,7
2776.636975,58,88,0.78,30,0.026,7
2776.6363,61,75,0.39,14,0.027857143,7
2776.635776,58,73,0.49,15,0.032666667,7
2776.635776,55,76,0.69,21,0.032857143,7
2776.542892,31,59,0.95,28,0.033928571,7
2776.480177,35,56,0.7,21,0.033333333,7
2776.376164,52,81,0.95,29,0.032758621,7
2776.283854,54,79,0.73,25,0.0292,7
2776.072766,58,75,0.49,17,0.028823529,7
2775.74776,59,82,0.62,23,0.026956522,7
2775.711452,57,86,0.76,29,0.026206897,7
2775.543472,64,70,0.17,6,0.028333333,7
2775.477529,55,80,0.71,25,0.0284,7
2775.416245,38,47,0.34,9,0.037777778,7
2775.377108,43,64,0.06,21,0.002857143,7
2775.242941,61,85,0.6,24,0.025,7
2775.242941,58,89,0.77,31,0.02483871,7
2775.179502,52,81,0.96,29,0.033103448,7
2774.885225,53,88,0.91,35,0.026,7
2774.825026,61,77,0.43,16,0.026875,7
2774.825026,59,79,0.54,20,0.027,7
2774.711167,57,78,0.66,21,0.031428571,7
2774.635135,51,84,0.95,33,0.028787879,7
2774.472285,61,73,0.34,12,0.028333333,7
2774.405664,70,77,0.14,7,0.02,7
2774.356615,38,64,0.68,26,0.026153846,7
2774.20462,50,60,0.27,10,0.027,7
2774.043702,40,45,0.19,5,0.038,7
2774.034633,38,51,0.46,13,0.035384615,7
2773.671495,53,84,0.84,31,0.027096774,7
2773.671495,51,86,0.95,35,0.027142857,7
2773.509376,43,50,0.22,7,0.031428571,7
2773.484489,52,82,0.88,30,0.029333333,7
2773.471809,34,82,0.11,48,0.002291667,7
2773.460285,61,85,0.61,24,0.025416667,7
2773.239684,68,69,0.03,1,0.03,7
2773.239684,67,70,0.09,3,0.03,7
2773.122754,36,55,0.63,19,0.033157895,7
2773.01898,36,77,0.1,41,0.002439024,7
2773.014626,59,85,0.69,26,0.026538462,7
2772.981048,39,54,0.47,15,0.031333333,7
2772.747682,34,59,0.82,25,0.0328,7
2772.47146,42,51,0.28,9,0.031111111,7
2772.425297,51,84,0.94,33,0.028484848,7
2772.189432,60,78,0.49,18,0.027222222,7
2772.16758,60,76,0.43,16,0.026875,7
2772.153809,67,73,0.16,6,0.026666667,7
2771.703591,64,78,0.38,14,0.027142857,7
2771.703591,62,80,0.49,18,0.027222222,7
2771.703591,60,82,0.6,22,0.027272727,7
2771.703591,60,83,0.62,23,0.026956522,7
2771.703591,58,85,0.73,27,0.027037037,7
2771.177347,47,63,0.43,16,0.026875,7
2771.040254,63,83,0.51,20,0.0255,7
2770.752154,34,99,0.17,65,0.002615385,7
2770.676209,57,75,0.59,18,0.032777778,7
2770.676209,54,78,0.79,24,0.032916667,7
2770.585928,65,80,0.31,15,0.020666667,7
2770.467296,41,49,0.27,8,0.03375,7
2770.226839,67,72,0.14,5,0.028,7
2770.164132,57,79,0.61,22,0.027727273,7
2769.695488,64,75,0.29,11,0.026363636,7
2769.663973,65,79,0.29,14,0.020714286,7
2769.434511,55,80,0.7,25,0.028,7
2769.434511,54,81,0.76,27,0.028148148,7
2769.390531,36,56,0.66,20,0.033,7
2769.246492,57,84,0.77,27,0.028518519,7
2768.73732,59,80,0.56,21,0.026666667,7
2768.73732,57,82,0.67,25,0.0268,7
2768.631882,54,93,0.99,39,0.025384615,7
2768.531459,61,87,0.51,26,0.019615385,7
2768.459787,53,82,0.92,29,0.031724138,7
2767.819767,36,97,0.13,61,0.002131148,7
2767.802388,54,82,0.76,28,0.027142857,7
2767.755791,55,93,0.97,38,0.025526316,7
2767.608518,34,57,0.8,23,0.034782609,7
2767.425641,56,88,0.86,32,0.026875,7
2767.401094,64,72,0.22,8,0.0275,7
2767.379722,51,58,0.23,7,0.032857143,7
2767.373327,37,54,0.6,17,0.035294118,7
2767.277225,39,63,0.62,24,0.025833333,7
2767.210948,56,88,0.83,32,0.0259375,7
2767.210948,55,89,0.88,34,0.025882353,7
2767.210948,54,91,0.95,37,0.025675676,7
2767.08757,56,79,0.72,23,0.031304348,7
2767.017692,62,83,0.44,21,0.020952381,7
2766.243904,57,74,0.56,17,0.032941176,7
2766.241074,54,77,0.76,23,0.033043478,7
2765.658873,57,76,0.55,19,0.028947368,7
2765.649514,34,99,0.2,65,0.003076923,7
2765.485206,65,75,0.28,10,0.028,7
2765.124271,56,87,0.82,31,0.026451613,7
2765.102992,53,83,0.82,30,0.027333333,7
2765.102992,52,84,0.88,32,0.0275,7
2765.084594,58,82,0.63,24,0.02625,7
2765.06197,52,80,0.92,28,0.032857143,7
2765.06197,51,81,0.99,30,0.033,7
2765.038604,40,65,0.11,25,0.0044,7
2764.887755,34,81,0.12,47,0.002553191,7
2764.655516,61,77,0.45,16,0.028125,7
2764.524842,36,95,0.15,59,0.002542373,7
2764.355913,61,79,0.5,18,0.027777778,7
2764.039551,34,53,0.69,19,0.036315789,7
2763.969326,55,89,0.89,34,0.026176471,7
2763.299567,54,84,0.8,30,0.026666667,7
2763.288872,56,75,0.63,19,0.033157895,7
2763.176211,58,86,0.75,28,0.026785714,7
2763.032837,62,76,0.39,14,0.027857143,7
2762.952373,52,87,0.93,35,0.026571429,7
2762.802237,65,78,0.28,13,0.021538462,7
2762.658525,39,51,0.42,12,0.035,7
2762.592307,54,81,0.77,27,0.028518519,7
2762.562594,61,78,0.45,17,0.026470588,7
2762.532056,72,91,0.34,19,0.017894737,7
2762.457276,53,82,0.83,29,0.02862069,7
2762.311806,53,86,0.87,33,0.026363636,7
2762.139496,61,86,0.62,25,0.0248,7
2762.139496,59,89,0.74,30,0.024666667,7
2762.082471,51,83,0.92,32,0.02875,7
2761.643197,64,76,0.33,12,0.0275,7
2761.571034,59,82,0.65,23,0.02826087,7
2761.258656,39,48,0.33,9,0.036666667,7
2761.033898,56,91,0.88,35,0.025142857,7
2760.934631,53,80,0.88,27,0.032592593,7
2760.88014,37,57,0.61,20,0.0305,7
2760.823459,68,98,0.53,30,0.017666667,7
2760.484267,33,54,0.78,21,0.037142857,7
2760.274805,54,91,0.96,37,0.025945946,7
2760.139456,64,76,0.34,12,0.028333333,7
2760.125504,30,85,0.19,55,0.003454545,7
2759.931589,59,76,0.47,17,0.027647059,7
2759.57205,32,61,0.98,29,0.033793103,7
2759.530288,60,77,0.46,17,0.027058824,7
2759.530288,58,79,0.57,21,0.027142857,7
2759.451005,53,85,0.86,32,0.026875,7
2759.1338,61,86,0.63,25,0.0252,7
2759.1338,58,90,0.8,32,0.025,7
2758.746792,46,65,0.61,19,0.032105263,7
2758.684655,55,88,0.9,33,0.027272727,7
2758.52006,46,68,0.7,22,0.031818182,7
2758.294468,50,61,0.25,11,0.022727273,7
2758.229146,35,97,0.15,62,0.002419355,7
2757.943988,73,74,0.02,1,0.02,7
2757.943988,72,75,0.06,3,0.02,7
2757.943988,71,76,0.1,5,0.02,7
2757.856866,36,95,0.16,59,0.002711864,7
2757.611279,34,56,0.72,22,0.032727273,7
2757.172383,68,95,0.49,27,0.018148148,7
2757.097944,34,70,0.93,36,0.025833333,7
2756.967432,63,84,0.43,21,0.02047619,7
2756.935408,54,82,0.78,28,0.027857143,7
2756.665794,51,83,0.94,32,0.029375,7
2756.511002,53,82,0.84,29,0.028965517,7
2756.511002,52,83,0.9,31,0.029032258,7
2756.372304,34,55,0.78,21,0.037142857,7
2756.07697,64,80,0.42,16,0.02625,7
2755.675415,37,54,0.55,17,0.032352941,7
2755.46788,56,87,0.87,31,0.028064516,7
2755.453319,57,90,0.85,33,0.025757576,7
2754.846691,55,93,0.96,38,0.025263158,7
2754.846691,55,94,0.97,39,0.024871795,7
2754.82294,60,84,0.61,24,0.025416667,7
2754.82294,59,86,0.68,27,0.025185185,7
2754.82294,58,87,0.73,29,0.025172414,7
2754.82294,56,90,0.85,34,0.025,7
2754.707806,63,85,0.44,22,0.02,7
2754.602077,35,97,0.16,62,0.002580645,7
2754.536961,48,63,0.4,15,0.026666667,7
2754.264763,35,99,0.14,64,0.0021875,7
2754.261908,60,86,0.66,26,0.025384615,7
2754.261908,56,91,0.89,35,0.025428571,7
2754.031545,52,85,0.91,33,0.027575758,7
2753.965134,70,73,0.08,3,0.026666667,7
2753.965134,68,76,0.21,8,0.02625,7
2753.965134,67,76,0.24,9,0.026666667,7
2753.965134,65,79,0.37,14,0.026428571,7
2753.965134,62,82,0.53,20,0.0265,7
2753.965134,61,84,0.6,23,0.026086957,7
2753.922736,47,63,0.52,16,0.0325,7
2753.92221,55,79,0.69,24,0.02875,7
2753.788701,37,69,0.15,32,0.0046875,7
2753.332023,54,80,0.76,26,0.029230769,7
2753.332023,53,81,0.82,28,0.029285714,7
2753.317158,58,77,0.54,19,0.028421053,7
2753.143137,58,80,0.59,22,0.026818182,7
2752.817649,56,77,0.61,21,0.029047619,7
2752.696675,61,80,0.51,19,0.026842105,7
2752.599243,59,83,0.67,24,0.027916667,7
2752.489548,55,77,0.73,22,0.033181818,7
2752.137299,57,82,0.7,25,0.028,7
2752.103643,32,60,0.96,28,0.034285714,7
2752.103118,31,58,0.94,27,0.034814815,7
2752.092683,52,83,0.89,31,0.028709677,7
2752.077718,64,69,0.16,5,0.032,7
2752.077718,61,73,0.38,12,0.031666667,7
2751.856478,66,80,0.29,14,0.020714286,7
2751.856062,58,77,0.59,19,0.031052632,7
2751.741078,62,75,0.35,13,0.026923077,7
2751.439937,32,59,0.95,27,0.035185185,7
2751.430675,57,91,0.84,34,0.024705882,7
2751.430675,55,94,0.96,39,0.024615385,7
2751.404772,36,95,0.19,59,0.003220339,7
2751.081719,59,88,0.72,29,0.024827586,7
2750.734468,64,73,0.24,9,0.026666667,7
2749.409364,51,89,0.99,38,0.026052632,7
2749.352165,57,89,0.84,32,0.02625,7
2749.314043,62,84,0.56,22,0.025454545,7
2749.314043,60,87,0.68,27,0.025185185,7
2749.314043,59,88,0.73,29,0.025172414,7
2749.314043,57,91,0.85,34,0.025,7
2749.314043,56,92,0.9,36,0.025,7
2749.302877,66,72,0.16,6,0.026666667,7
2749.253437,58,76,0.57,18,0.031666667,7
2749.015363,45,66,0.56,21,0.026666667,7
2748.704557,63,87,0.47,24,0.019583333,7
2748.378301,33,59,0.89,26,0.034230769,7
2748.064558,56,82,0.7,26,0.026923077,7
2747.914785,53,78,0.83,25,0.0332,7
2747.879993,55,85,0.84,30,0.028,7
2747.842831,56,88,0.88,32,0.0275,7
2747.757283,33,58,0.82,25,0.0328,7
2747.676575,55,79,0.68,24,0.028333333,7
2747.663498,36,56,0.64,20,0.032,7
2747.624222,33,80,0.12,47,0.002553191,7
2747.464623,51,78,0.91,27,0.033703704,7
2747.434306,55,90,0.96,35,0.027428571,7
2747.242425,58,77,0.53,19,0.027894737,7
2746.987852,60,75,0.41,15,0.027333333,7
2746.887505,62,79,0.46,17,0.027058824,7
2746.887505,60,81,0.57,21,0.027142857,7
2746.854754,52,83,0.99,31,0.031935484,7
2746.723053,76,86,0.18,10,0.018,7
2746.723053,73,89,0.29,16,0.018125,7
2746.701985,57,90,0.83,33,0.025151515,7
2746.573634,60,81,0.59,21,0.028095238,7
2746.51163,65,80,0.39,15,0.026,7
2746.434757,41,52,0.4,11,0.036363636,7
2746.245143,59,77,0.5,18,0.027777778,7
2746.049065,57,76,0.61,19,0.032105263,7
2745.849284,62,70,0.26,8,0.0325,7
2745.790446,37,48,0.42,11,0.038181818,7
2745.658857,39,51,0.43,12,0.035833333,7
2745.549715,44,72,0.87,28,0.031071429,7
2745.111659,66,70,0.11,4,0.0275,7
2745.111659,59,78,0.52,19,0.027368421,7
2745.111659,57,80,0.63,23,0.027391304,7
2745.028207,38,93,0.12,55,0.002181818,7
2744.89256,55,93,0.94,38,0.024736842,7
2744.628751,59,88,0.74,29,0.025517241,7
2744.290279,56,90,0.91,34,0.026764706,7
2744.290279,55,91,0.97,36,0.026944444,7
2744.285827,32,60,0.94,28,0.033571429,7
2744.138422,52,87,0.98,35,0.028,7
2744.123819,51,87,0.98,36,0.027222222,7
2744.040357,35,99,0.17,64,0.00265625,7
2744.028376,51,84,0.96,33,0.029090909,7
2743.849011,54,80,0.74,26,0.028461538,7
2743.588522,54,80,0.75,26,0.028846154,7
2743.57267,69,96,0.48,27,0.017777778,7
2743.451137,42,73,0.99,31,0.031935484,7
2742.897896,69,94,0.45,25,0.018,7
2742.642658,54,89,0.72,35,0.020571429,7
2742.57343,62,72,0.28,10,0.028,7
2742.568369,55,78,0.74,23,0.032173913,7
2742.436207,36,68,0.81,32,0.0253125,7
2742.368833,60,72,0.39,12,0.0325,7
2741.946806,57,88,0.79,31,0.025483871,7
2741.806009,62,76,0.38,14,0.027142857,7
2741.767225,58,89,0.78,31,0.02516129,7
2741.767225,58,90,0.79,32,0.0246875,7
2741.767225,56,93,0.91,37,0.024594595,7
2741.767225,55,93,0.95,38,0.025,7
2741.731126,36,62,0.79,26,0.030384615,7
2741.493633,59,86,0.71,27,0.026296296,7
2741.493633,57,88,0.82,31,0.026451613,7
2741.446512,48,61,0.43,13,0.033076923,7
2741.365483,33,62,0.92,29,0.031724138,7
2741.35745,62,78,0.44,16,0.0275,7
2741.298865,56,82,0.73,26,0.028076923,7
2741.147617,64,71,0.19,7,0.027142857,7
2740.977282,46,69,0.72,23,0.031304348,7
2740.928658,63,82,0.4,19,0.021052632,7
2740.589666,56,83,0.76,27,0.028148148,7
2740.537515,38,59,0.64,21,0.03047619,7
2740.508313,53,81,0.81,28,0.028928571,7
2739.870766,57,77,0.64,20,0.032,7
2739.216336,55,83,0.74,28,0.026428571,7
2739.178684,69,97,0.49,28,0.0175,7
2739.036483,55,80,0.79,25,0.0316,7
2738.89445,62,83,0.55,21,0.026190476,7
2738.735645,32,59,0.97,27,0.035925926,7
2738.485939,33,64,0.94,31,0.030322581,7
2738.427495,42,74,0.99,32,0.0309375,7
2738.062048,63,78,0.4,15,0.026666667,7
2738.017247,36,95,0.17,59,0.002881356,7
2737.906763,43,68,0.82,25,0.0328,7
2737.895787,51,85,0.97,34,0.028529412,7
2737.860303,54,85,0.86,31,0.027741935,7
2737.620991,61,85,0.5,24,0.020833333,7
2737.521724,68,73,0.13,5,0.026,7
2737.340808,35,69,0.87,34,0.025588235,7
2737.333067,64,74,0.27,10,0.027,7
2737.122723,64,84,0.4,20,0.02,7
2736.512051,64,83,0.38,19,0.02,7
2736.36951,36,54,0.59,18,0.032777778,7
2736.071759,67,77,0.21,10,0.021,7
2736.016282,57,86,0.8,29,0.027586207,7
2735.965966,60,84,0.64,24,0.026666667,7
2735.777525,62,74,0.37,12,0.030833333,7
2735.678272,56,86,0.83,30,0.027666667,7
2735.674745,56,85,0.75,29,0.025862069,7
2735.403807,40,51,0.37,11,0.033636364,7
2735.396089,52,85,0.9,33,0.027272727,7
2735.317983,51,85,0.96,34,0.028235294,7
2735.062964,31,58,0.97,27,0.035925926,7
2734.957017,36,69,0.82,33,0.024848485,7
2734.941746,57,77,0.58,20,0.029,7
2734.727327,53,83,0.84,30,0.028,7
2734.696278,44,51,0.24,7,0.034285714,7
2734.669776,59,81,0.6,22,0.027272727,7
2734.283875,37,92,0.16,55,0.002909091,7
2733.857291,37,95,0.15,58,0.002586207,7
2733.771,39,66,0.12,27,0.004444444,7
2733.495551,36,94,0.2,58,0.003448276,7
2733.292374,35,98,0.16,63,0.002539683,7
2732.736956,35,94,0.22,59,0.003728814,7
2732.723315,54,79,0.81,25,0.0324,7
2732.305059,39,66,0.13,27,0.004814815,7
2732.268917,51,86,0.96,35,0.027428571,7
2732.014717,72,93,0.37,21,0.017619048,7
2731.846037,51,86,0.97,35,0.027714286,7
2731.672966,40,49,0.32,9,0.035555556,7
2731.633548,64,80,0.33,16,0.020625,7
2731.607291,56,92,0.89,36,0.024722222,7
2731.542846,60,84,0.65,24,0.027083333,7
2731.097023,41,45,0.15,4,0.0375,7
2730.963985,60,74,0.44,14,0.031428571,7
2730.864583,58,79,0.59,21,0.028095238,7
2730.720595,54,85,0.83,31,0.026774194,7
2730.7056,60,73,0.38,13,0.029230769,7
2730.65942,63,83,0.41,20,0.0205,7
2730.641577,52,82,0.87,30,0.029,7
2730.638783,51,83,0.93,32,0.0290625,7
2730.494518,37,91,0.19,54,0.003518519,7
2730.348086,62,85,0.47,23,0.020434783,7
2730.266273,53,86,0.92,33,0.027878788,7
2730.196978,36,93,0.18,57,0.003157895,7
2730.030472,37,94,0.14,57,0.00245614,7
2729.908154,38,68,0.12,30,0.004,7
2729.46368,56,93,0.73,37,0.01972973,7
2729.463569,79,87,0.14,8,0.0175,7
2729.304934,32,62,0.99,30,0.033,7
2729.030333,48,64,0.42,16,0.02625,7
2728.700892,65,72,0.19,7,0.027142857,7
2728.700892,63,74,0.3,11,0.027272727,7
2728.700892,61,76,0.41,15,0.027333333,7
2728.700892,57,81,0.65,24,0.027083333,7
2728.4796,58,84,0.73,26,0.028076923,7
2728.318877,49,60,0.36,11,0.032727273,7
2728.196653,57,77,0.63,20,0.0315,7
2728.141715,51,60,0.24,9,0.026666667,7
2728.106267,53,82,0.81,29,0.027931034,7
2727.815791,67,99,0.56,32,0.0175,7
2727.493305,64,81,0.44,17,0.025882353,7
2727.109865,58,74,0.52,16,0.0325,7
2727.109865,56,76,0.65,20,0.0325,7
2727.109865,52,81,0.94,29,0.032413793,7
2727.097148,61,86,0.5,25,0.02,7
2727.052751,52,83,0.87,31,0.028064516,7
2727.052751,51,84,0.93,33,0.028181818,7
2726.59445,59,75,0.51,16,0.031875,7
2726.563509,67,78,0.23,11,0.020909091,7
2726.493909,54,78,0.78,24,0.0325,7
2726.488807,59,87,0.73,28,0.026071429,7
2726.335079,62,71,0.26,9,0.028888889,7
2725.794043,56,78,0.64,22,0.029090909,7
2725.789039,49,61,0.39,12,0.0325,7
2725.624584,59,83,0.62,24,0.025833333,7
2725.455619,39,47,0.3,8,0.0375,7
2725.422836,33,62,0.9,29,0.031034483,7
2725.360254,62,69,0.23,7,0.032857143,7
2725.347496,58,91,0.65,33,0.01969697,7
2725.314788,62,74,0.34,12,0.028333333,7
2725.286795,57,88,0.84,31,0.027096774,7
2724.994108,64,75,0.3,11,0.027272727,7
2724.962192,35,95,0.2,60,0.003333333,7
2724.698268,53,98,0.99,45,0.022,7
2724.501893,38,91,0.14,53,0.002641509,7
2724.500556,33,57,0.8,24,0.033333333,7
2724.426932,55,79,0.77,24,0.032083333,7
2724.211339,36,67,0.8,31,0.025806452,7
2724.140753,35,96,0.16,61,0.002622951,7
2723.797834,36,70,0.17,34,0.005,7
2723.546397,60,83,0.63,23,0.027391304,7
2723.479357,34,98,0.17,64,0.00265625,7
2723.399155,35,79,0.11,44,0.0025,7
2723.369692,54,98,0.95,44,0.021590909,7
2723.343156,59,74,0.44,15,0.029333333,7
2722.64434,56,84,0.78,28,0.027857143,7
2722.63827,57,81,0.67,24,0.027916667,7
2722.564768,61,74,0.37,13,0.028461538,7
2722.547232,34,98,0.19,64,0.00296875,7
2722.255688,62,85,0.46,23,0.02,7
2722.240221,26,92,0.59,66,0.008939394,7
2721.791235,55,77,0.72,22,0.032727273,7
2721.791235,53,79,0.85,26,0.032692308,7
2721.212206,58,73,0.5,15,0.033333333,7
2721.137749,57,80,0.65,23,0.02826087,7
2721.089289,56,91,0.83,35,0.023714286,7
2721.058595,37,99,0.11,62,0.001774194,7
2720.921205,34,97,0.23,63,0.003650794,7
2720.783797,53,80,0.87,27,0.032222222,7
2720.701793,60,75,0.43,15,0.028666667,7
2720.598375,34,99,0.18,65,0.002769231,7
2720.22784,54,94,0.94,40,0.0235,7
2720.221486,63,71,0.23,8,0.02875,7
2719.504691,59,76,0.48,17,0.028235294,7
2719.266001,62,84,0.57,22,0.025909091,7
2718.921985,33,57,0.81,24,0.03375,7
2718.875737,53,94,0.82,41,0.02,7
2718.768516,58,82,0.66,24,0.0275,7
2718.506999,26,90,0.59,64,0.00921875,7
2718.474501,65,81,0.41,16,0.025625,7
2718.221358,29,88,0.16,59,0.002711864,7
2718.208008,43,69,0.85,26,0.032692308,7
2717.761506,54,97,0.94,43,0.021860465,7
2717.694784,33,57,0.79,24,0.032916667,7
2717.3138,37,54,0.59,17,0.034705882,7
2717.308014,57,87,0.82,30,0.027333333,7
2717.301426,70,95,0.44,25,0.0176,7
2717.258418,44,67,0.75,23,0.032608696,7
2717.196067,55,85,0.8,30,0.026666667,7
2717.001813,67,98,0.55,31,0.017741935,7
2716.982072,65,77,0.31,12,0.025833333,7
2716.918037,54,89,0.97,35,0.027714286,7
2716.769611,62,83,0.43,21,0.02047619,7
2716.422077,61,78,0.47,17,0.027647059,7
2715.836583,59,76,0.49,17,0.028823529,7
2715.774262,52,84,0.91,32,0.0284375,7
2715.721935,35,96,0.23,61,0.003770492,7
2715.555256,52,87,0.92,35,0.026285714,7
2715.369066,56,91,0.91,35,0.026,7
2715.084684,58,78,0.57,20,0.0285,7
2715.038671,61,85,0.62,24,0.025833333,7
2714.99668,48,66,0.57,18,0.031666667,7
2714.938315,57,89,0.8,32,0.025,7
2714.92604,31,85,0.14,54,0.002592593,7
2714.696221,54,91,0.99,37,0.026756757,7
2714.608523,61,84,0.61,23,0.026521739,7
2714.550171,52,84,0.9,32,0.028125,7
2714.523993,58,75,0.55,17,0.032352941,7
2714.346732,55,81,0.74,26,0.028461538,7
2714.321714,36,50,0.53,14,0.037857143,7
2714.21995,62,79,0.47,17,0.027647059,7
2714.134545,35,68,0.86,33,0.026060606,7
2713.894679,56,78,0.7,22,0.031818182,7
2713.765599,35,59,0.79,24,0.032916667,7
2713.716637,63,83,0.4,20,0.02,7
2713.716637,62,84,0.44,22,0.02,7
2713.641491,36,98,0.12,62,0.001935484,7
2713.573346,38,57,0.68,19,0.035789474,7
2713.565247,57,85,0.77,28,0.0275,7
2713.565247,54,89,0.96,35,0.027428571,7
2713.491379,54,86,0.9,32,0.028125,7
2713.484732,64,82,0.37,18,0.020555556,7
2713.409843,43,73,0.95,30,0.031666667,7
2713.360483,35,98,0.17,63,0.002698413,7
2713.281832,65,83,0.36,18,0.02,7
2713.141341,64,77,0.35,13,0.026923077,7
2713.076363,32,56,0.91,24,0.037916667,7
2712.986874,40,63,0.18,23,0.007826087,7
2712.84176,42,50,0.27,8,0.03375,7
2712.76186,55,84,0.78,29,0.026896552,7
2712.76186,54,85,0.84,31,0.027096774,7
2712.76186,54,86,0.85,32,0.0265625,7
2712.76186,53,87,0.91,34,0.026764706,7
2712.76186,52,88,0.97,36,0.026944444,7
2712.734353,43,69,0.84,26,0.032307692,7
2712.734353,42,70,0.91,28,0.0325,7
2712.705772,66,79,0.27,13,0.020769231,7
2712.576558,40,52,0.43,12,0.035833333,7
2712.566129,54,80,0.84,26,0.032307692,7
2712.33537,37,94,0.16,57,0.002807018,7
2712.285484,55,81,0.72,26,0.027692308,7
2712.256654,59,79,0.55,20,0.0275,7
2712.221732,38,57,0.59,19,0.031052632,7
2712.183667,32,56,0.88,24,0.036666667,7
2712.135535,54,83,0.82,29,0.028275862,7
2712.073812,51,63,0.38,12,0.031666667,7
2712.002885,53,84,0.88,31,0.028387097,7
2711.86199,41,52,0.34,11,0.030909091,7
2711.804592,69,94,0.46,25,0.0184,7
2711.757776,31,60,0.93,29,0.032068966,7
2711.49311,62,86,0.47,24,0.019583333,7
2711.367707,38,48,0.38,10,0.038,7
2711.240263,38,98,0.09,60,0.0015,7
2710.76667,55,92,0.92,37,0.024864865,7
2710.446721,33,83,0.13,50,0.0026,7
2710.418835,62,72,0.29,10,0.029,7
2710.381999,59,73,0.46,14,0.032857143,7
2710.304531,46,48,0.07,2,0.035,7
2710.304531,45,49,0.14,4,0.035,7
2710.166629,35,55,0.65,20,0.0325,7
2710.078117,34,58,0.77,24,0.032083333,7
2710.053761,35,79,0.12,44,0.002727273,7
2709.986914,53,85,0.9,32,0.028125,7
2709.80502,60,74,0.4,14,0.028571429,7
2709.344291,60,80,0.55,20,0.0275,7
2709.080399,51,85,0.98,34,0.028823529,7
2709.037463,41,50,0.31,9,0.034444444,7
2709.031894,52,86,0.96,34,0.028235294,7
2708.404462,60,82,0.61,22,0.027727273,7
2708.392669,64,82,0.36,18,0.02,7
2708.191779,40,53,0.42,13,0.032307692,7
2708.147391,54,86,0.86,32,0.026875,7
2708.016614,57,79,0.59,22,0.026818182,7
2707.946655,58,87,0.78,29,0.026896552,7
2707.891441,33,59,0.9,26,0.034615385,7
2707.38347,33,54,0.81,21,0.038571429,7
2707.314527,63,85,0.42,22,0.019090909,7
2707.314527,62,86,0.46,24,0.019166667,7
2706.946131,58,89,0.8,31,0.025806452,7
2706.944924,56,76,0.66,20,0.033,7
2706.865096,53,95,0.99,42,0.023571429,7
2706.828662,38,98,0.08,60,0.001333333,7
2706.790758,71,94,0.41,23,0.017826087,7
2706.761449,55,82,0.77,27,0.028518519,7
2706.707497,52,88,0.98,36,0.027222222,7
2706.61003,39,53,0.46,14,0.032857143,7
2706.352575,52,82,0.98,30,0.032666667,7
2706.287429,71,92,0.38,21,0.018095238,7
2706.120243,38,92,0.13,54,0.002407407,7
2705.908437,51,57,0.2,6,0.033333333,7
2705.55186,68,96,0.5,28,0.017857143,7
2705.213666,55,84,0.8,29,0.027586207,7
2705.134641,43,72,0.93,29,0.032068966,7
2704.952472,51,87,0.97,36,0.026944444,7
2704.889312,79,84,0.09,5,0.018,7
2704.889312,74,89,0.27,15,0.018,7
2704.889312,70,94,0.43,24,0.017916667,7
2704.631384,34,59,0.81,25,0.0324,7
2704.471396,52,82,0.97,30,0.032333333,7
2704.412715,52,87,0.97,35,0.027714286,7
2704.393996,60,76,0.46,16,0.02875,7
2704.393996,56,80,0.69,24,0.02875,7
2704.256216,65,71,0.17,6,0.028333333,7
2704.156341,54,82,0.8,28,0.028571429,7
2703.928196,52,86,0.9,34,0.026470588,7
2703.692795,65,81,0.32,16,0.02,7
2703.615868,59,87,0.56,28,0.02,7
2703.606376,46,71,0.73,25,0.0292,7
2703.466466,64,77,0.34,13,0.026153846,7
2703.400824,56,81,0.71,25,0.0284,7
2703.385099,56,79,0.73,23,0.03173913,7
2703.282595,52,90,0.98,38,0.025789474,7
2703.205259,37,56,0.62,19,0.032631579,7
2703.010445,55,89,0.94,34,0.027647059,7
2702.691111,67,79,0.24,12,0.02,7
2702.51735,66,80,0.28,14,0.02,7
2702.500908,78,84,0.11,6,0.018333333,7
2702.500908,75,87,0.22,12,0.018333333,7
2702.452156,44,72,0.88,28,0.031428571,7
2702.211285,61,75,0.4,14,0.028571429,7
2702.211285,57,79,0.63,22,0.028636364,7
2702.059723,64,73,0.25,9,0.027777778,7
2701.932278,55,91,0.73,36,0.020277778,7
2701.916738,67,97,0.53,30,0.017666667,7
2701.916738,65,99,0.6,34,0.017647059,7
2701.853944,63,78,0.42,15,0.028,7
2701.751592,60,76,0.45,16,0.028125,7
2701.62992,32,60,0.98,28,0.035,7
2701.578447,61,84,0.47,23,0.020434783,7
2701.369199,56,91,0.87,35,0.024857143,7
2701.362622,52,88,0.95,36,0.026388889,7
2701.087881,56,87,0.86,31,0.027741935,7
2701.087881,55,88,0.92,33,0.027878788,7
2700.964244,58,77,0.55,19,0.028947368,7
2700.300695,35,51,0.61,16,0.038125,7
2700.195247,38,55,0.55,17,0.032352941,7
2700.14758,59,75,0.46,16,0.02875,7
2700.14758,58,76,0.52,18,0.028888889,7
2700.125259,30,87,0.15,57,0.002631579,7
2700.01116,69,76,0.18,7,0.025714286,7
2699.654729,58,80,0.61,22,0.027727273,7
2699.654729,56,83,0.74,27,0.027407407,7
2699.654729,53,86,0.91,33,0.027575758,7
2699.520203,69,97,0.51,28,0.018214286,7
2699.124176,72,92,0.36,20,0.018,7
2699.104179,37,93,0.18,56,0.003214286,7
2699.005283,63,80,0.37,17,0.021764706,7
2698.940154,34,60,0.84,26,0.032307692,7
2698.764987,37,93,0.15,56,0.002678571,7
2698.059062,72,90,0.33,18,0.018333333,7
2698.00833,41,46,0.19,5,0.038,7
2697.709143,35,98,0.13,63,0.002063492,7
2697.581922,37,99,0.1,62,0.001612903,7
2697.487287,53,86,0.9,33,0.027272727,7
2697.249034,71,91,0.37,20,0.0185,7
2697.249034,70,93,0.42,23,0.01826087,7
2697.21619,77,86,0.16,9,0.017777778,7
2697.133285,45,70,0.79,25,0.0316,7
2697.082134,57,78,0.6,21,0.028571429,7
2697.067779,57,83,0.72,26,0.027692308,7
2697.013119,41,52,0.36,11,0.032727273,7
2697.001591,68,97,0.52,29,0.017931034,7
2697.001591,67,99,0.57,32,0.0178125,7
2696.994596,53,85,0.87,32,0.0271875,7
2696.994596,52,86,0.93,34,0.027352941,7
2696.977857,55,88,0.93,33,0.028181818,7
2696.585633,34,99,0.21,65,0.003230769,7
2696.58274,56,79,0.66,23,0.028695652,7
2696.58274,55,80,0.72,25,0.0288,7
2696.58274,54,81,0.78,27,0.028888889,7
2696.47556,51,86,0.99,35,0.028285714,7
2696.470892,54,97,0.95,43,0.022093023,7
2696.46147,33,99,0.49,66,0.007424242,7
2696.376638,29,87,0.25,58,0.004310345,7
2696.053943,44,56,0.32,12,0.026666667,7
2696.037389,37,64,0.79,27,0.029259259,7
2696.007881,58,78,0.56,20,0.028,7
2696.007881,55,81,0.73,26,0.028076923,7
2695.775981,37,95,0.14,58,0.002413793,7
2695.745271,52,83,0.91,31,0.029354839,7
2695.644193,45,69,0.77,24,0.032083333,7
2695.580754,55,83,0.79,28,0.028214286,7
2695.576452,61,85,0.48,24,0.02,7
2695.570054,35,99,0.16,64,0.0025,7
2695.500661,60,87,0.54,27,0.02,7
2695.104044,56,83,0.73,27,0.027037037,7
2694.862084,26,88,0.58,62,0.009354839,7
2694.847921,34,70,0.35,36,0.009722222,7
2694.638424,53,81,0.9,28,0.032142857,7
2694.558523,34,59,0.79,25,0.0316,7
2694.338162,40,61,0.22,21,0.01047619,7
2694.274547,35,63,0.86,28,0.030714286,7
2694.193974,54,83,0.77,29,0.026551724,7
2694.193974,51,87,0.95,36,0.026388889,7
2694.11295,35,96,0.21,61,0.003442623,7
2694.109906,34,61,0.88,27,0.032592593,7
2693.972905,61,72,0.32,11,0.029090909,7
2693.921795,36,51,0.55,15,0.036666667,7
2693.817682,63,77,0.38,14,0.027142857,7
2693.817682,61,79,0.49,18,0.027222222,7
2693.805644,57,79,0.64,22,0.029090909,7
2693.695538,53,87,0.92,34,0.027058824,7
2693.679155,57,78,0.61,21,0.029047619,7
2693.465791,44,50,0.2,6,0.033333333,7
2693.460948,35,99,0.15,64,0.00234375,7
2693.457556,71,93,0.39,22,0.017727273,7
2693.242509,70,93,0.41,23,0.017826087,7
2693.133099,56,80,0.67,24,0.027916667,7
2692.983493,76,87,0.2,11,0.018181818,7
2692.944219,59,77,0.51,18,0.028333333,7
2692.727711,66,75,0.25,9,0.027777778,7
2692.326841,43,74,0.96,31,0.030967742,7
2692.139116,55,81,0.75,26,0.028846154,7
2692.020784,55,96,0.89,41,0.021707317,7
2691.748528,53,84,0.86,31,0.027741935,7
2691.689203,57,81,0.66,24,0.0275,7
2691.666734,64,71,0.2,7,0.028571429,7
2691.570377,51,54,0.01,3,0.003333333,7
2691.531964,54,84,0.84,30,0.028,7
2691.411285,39,46,0.27,7,0.038571429,7
2691.315463,55,90,0.95,35,0.027142857,7
2690.905956,52,85,0.94,33,0.028484848,7
2690.865565,68,96,0.51,28,0.018214286,7
2690.843603,53,88,0.92,35,0.026285714,7
2690.70947,53,90,0.77,37,0.020810811,7
2690.61223,35,58,0.78,23,0.033913043,7
2690.110516,30,86,0.19,56,0.003392857,7
2689.932533,63,73,0.28,10,0.028,7
2689.923611,40,55,0.49,15,0.032666667,7
2689.907707,36,98,0.11,62,0.001774194,7
2689.856981,73,92,0.34,19,0.017894737,7
2689.798222,58,82,0.67,24,0.027916667,7
2689.725792,41,53,0.37,12,0.030833333,7
2689.682839,38,68,0.14,30,0.004666667,7
2689.617412,56,86,0.77,30,0.025666667,7
2689.206918,40,52,0.47,12,0.039166667,7
2689.200582,54,80,0.83,26,0.031923077,7
2689.04178,36,96,0.19,60,0.003166667,7
2688.919323,56,86,0.84,30,0.028,7
2688.741818,43,50,0.26,7,0.037142857,7
2688.38847,54,87,0.86,33,0.026060606,7
2688.345747,36,49,0.5,13,0.038461538,7
2688.306955,56,92,0.72,36,0.02,7
2688.241908,56,86,0.85,30,0.028333333,7
2688.139682,54,81,0.86,27,0.031851852,7
2687.88502,59,89,0.6,30,0.02,7
2687.82254,38,67,0.13,29,0.004482759,7
2687.759255,44,73,0.89,29,0.030689655,7
2687.746888,75,89,0.25,14,0.017857143,7
2687.610366,34,80,0.12,46,0.002608696,7
2687.574313,41,60,0.5,19,0.026315789,7
2687.305149,73,91,0.32,18,0.017777778,7
2687.264501,57,85,0.79,28,0.028214286,7
2687.085764,56,94,0.84,38,0.022105263,7
2687.059094,57,90,0.78,33,0.023636364,7
2686.940878,53,87,0.9,34,0.026470588,7
2686.867416,59,89,0.59,30,0.019666667,7
2686.673498,56,80,0.68,24,0.028333333,7
2686.427071,53,80,0.89,27,0.032962963,7
2686.222138,29,87,0.19,58,0.003275862,7
2686.17056,51,85,0.94,34,0.027647059,7
2686.126326,55,84,0.79,29,0.027241379,7
2686.041732,46,65,0.51,19,0.026842105,7
2686.022891,55,89,0.93,34,0.027352941,7
2685.604403,58,89,0.62,31,0.02,7
2685.545973,51,86,0.98,35,0.028,7
2685.520608,60,77,0.48,17,0.028235294,7
2685.34201,52,88,0.99,36,0.0275,7
2685.182505,49,65,0.51,16,0.031875,7
2685.182505,47,67,0.64,20,0.032,7
2685.034787,51,87,0.96,36,0.026666667,7
2684.805745,63,72,0.26,9,0.028888889,7
2684.774037,63,85,0.43,22,0.019545455,7
2684.714252,53,84,0.89,31,0.028709677,7
2684.714252,52,85,0.95,33,0.028787879,7
2684.394526,33,61,0.91,28,0.0325,7
2683.912096,63,72,0.28,9,0.031111111,7
2683.881692,56,79,0.65,23,0.02826087,7
2683.867147,52,88,0.96,36,0.026666667,7
2683.78772,68,97,0.51,29,0.017586207,7
2683.43232,56,90,0.9,34,0.026470588,7
2683.316313,36,94,0.19,58,0.003275862,7
2683.215374,63,73,0.29,10,0.029,7
2683.000356,35,60,0.77,25,0.0308,7
2682.956663,62,87,0.5,25,0.02,7
2682.881033,63,82,0.5,19,0.026315789,7
2682.737372,39,67,0.09,28,0.003214286,7
2682.707497,51,88,0.99,37,0.026756757,7
2682.652589,64,83,0.39,19,0.020526316,7
2682.588844,42,65,0.07,23,0.003043478,7
2682.579631,59,88,0.58,29,0.02,7
2682.546858,54,83,0.83,29,0.02862069,7
2682.381562,46,68,0.71,22,0.032272727,7
2682.235932,52,86,0.92,34,0.027058824,7
2682.143885,54,84,0.85,30,0.028333333,7
2682.113432,37,69,0.13,32,0.0040625,7
2682.051163,54,83,0.8,29,0.027586207,7
2682.035359,64,72,0.23,8,0.02875,7
2681.800304,41,75,0.85,34,0.025,7
2681.721834,51,88,0.97,37,0.026216216,7
2681.675958,36,95,0.2,59,0.003389831,7
2681.608746,36,96,0.17,60,0.002833333,7
2681.563066,61,73,0.35,12,0.029166667,7
2681.563066,60,74,0.41,14,0.029285714,7
2681.429481,54,93,0.98,39,0.025128205,7
2681.263705,41,63,0.11,22,0.005,7
2681.049557,34,98,0.23,64,0.00359375,7
2680.885464,60,79,0.53,19,0.027894737,7
2680.591645,41,51,0.39,10,0.039,7
2680.43866,58,78,0.62,20,0.031,7
2680.365105,54,60,0.19,6,0.031666667,7
2680.31488,67,81,0.28,14,0.02,7
2680.249551,60,88,0.55,28,0.019642857,7
2680.02993,34,56,0.74,22,0.033636364,7
2679.909487,51,87,0.99,36,0.0275,7
2679.822913,60,85,0.51,25,0.0204,7
2679.784835,55,82,0.76,27,0.028148148,7
2679.72893,66,82,0.32,16,0.02,7
2679.319834,47,67,0.63,20,0.0315,7
2679.298959,36,94,0.16,58,0.002758621,7
2679.290501,74,90,0.29,16,0.018125,7
2679.290501,71,93,0.4,22,0.018181818,7
2679.290501,70,95,0.45,25,0.018,7
2679.179442,54,85,0.85,31,0.027419355,7
2678.886057,37,99,0.09,62,0.001451613,7
2678.878494,61,75,0.43,14,0.030714286,7
2678.79226,52,95,0.87,43,0.020232558,7
2678.702776,52,89,0.97,37,0.026216216,7
2678.683664,62,77,0.4,15,0.026666667,7
2678.683664,60,79,0.51,19,0.026842105,7
2678.615043,52,89,0.98,37,0.026486486,7
2678.482303,34,60,0.86,26,0.033076923,7
2678.354102,59,77,0.52,18,0.028888889,7
2678.241339,68,72,0.11,4,0.0275,7
2678.241339,66,74,0.22,8,0.0275,7
2678.22018,55,83,0.76,28,0.027142857,7
2678.188187,73,89,0.31,16,0.019375,7
2678.090254,36,96,0.13,60,0.002166667,7
2677.964815,43,75,0.97,32,0.0303125,7
2677.818463,32,56,0.86,24,0.035833333,7
2677.75318,54,82,0.81,28,0.028928571,7
2677.311388,38,99,0.08,61,0.001311475,7
2677.296375,37,51,0.53,14,0.037857143,7
2677.283756,39,56,0.58,17,0.034117647,7
2677.157332,26,91,0.59,65,0.009076923,7
2676.965847,51,86,0.93,35,0.026571429,7
2676.919463,45,65,0.66,20,0.033,7
2676.787339,57,80,0.64,23,0.027826087,7
2676.709857,53,84,0.83,31,0.026774194,7
2676.544147,74,92,0.32,18,0.017777778,7
2676.512303,64,74,0.28,10,0.028,7
2676.507491,55,82,0.74,27,0.027407407,7
2676.506077,33,61,0.88,28,0.031428571,7
2676.442326,43,51,0.28,8,0.035,7
2676.42328,53,85,0.89,32,0.0278125,7
2676.42328,52,86,0.95,34,0.027941176,7
2676.4184,73,90,0.31,17,0.018235294,7
2676.358648,32,60,0.89,28,0.031785714,7
2676.056584,57,91,0.87,34,0.025588235,7
2675.8829,72,91,0.35,19,0.018421053,7
2675.850501,60,86,0.52,26,0.02,7
2675.793253,34,99,0.19,65,0.002923077,7
2675.697991,40,68,0.08,28,0.002857143,7
2675.577766,35,96,0.2,61,0.003278689,7
2675.472968,35,97,0.17,62,0.002741935,7
2675.412491,75,88,0.24,13,0.018461538,7
2675.357612,39,56,0.61,17,0.035882353,7
2675.350982,35,94,0.23,59,0.003898305,7
2675.181325,35,95,0.21,60,0.0035,7
2675.015668,58,83,0.65,25,0.026,7
2675.015668,57,85,0.72,28,0.025714286,7
2674.895201,29,89,0.17,60,0.002833333,7
2674.891495,40,76,0.95,36,0.026388889,7
2674.76921,33,99,0.22,66,0.003333333,7
2674.728449,36,96,0.18,60,0.003,7
2674.644333,58,69,0.37,11,0.033636364,7
2674.622561,38,92,0.15,54,0.002777778,7
2674.363976,77,87,0.18,10,0.018,7
2674.325744,40,54,0.51,14,0.036428571,7
2674.297116,52,85,0.89,33,0.026969697,7
2674.28187,53,86,0.88,33,0.026666667,7
2674.031754,30,84,0.19,54,0.003518519,7
2674.005187,58,80,0.6,22,0.027272727,7
2673.928353,29,85,0.25,56,0.004464286,7
2673.585969,69,74,0.14,5,0.028,7
2673.563077,50,85,0.99,35,0.028285714,7
2673.520417,42,53,0.36,11,0.032727273,7
2673.247722,56,81,0.69,25,0.0276,7
2673.236363,62,79,0.48,17,0.028235294,7
2673.233534,65,72,0.2,7,0.028571429,7
2672.916984,33,61,0.92,28,0.032857143,7
2672.765748,34,69,0.92,35,0.026285714,7
2672.686549,66,71,0.14,5,0.028,7
2672.557266,53,85,0.88,32,0.0275,7
2672.547256,54,59,0.16,5,0.032,7
2672.505068,43,65,0.06,22,0.002727273,7
2672.504234,62,75,0.36,13,0.027692308,7
2672.441711,75,88,0.23,13,0.017692308,7
2672.337043,52,87,0.95,35,0.027142857,7
2672.13724,59,78,0.54,19,0.028421053,7
2671.877289,52,85,0.92,33,0.027878788,7
2671.807596,58,86,0.76,28,0.027142857,7
2671.626375,59,87,0.74,28,0.026428571,7
2671.541384,58,88,0.6,30,0.02,7
2671.480852,59,87,0.57,28,0.020357143,7
2671.417372,58,79,0.6,21,0.028571429,7
2671.307398,58,89,0.73,31,0.023548387,7
2671.118085,48,89,0.9,41,0.02195122,7
2670.941683,35,97,0.18,62,0.002903226,7
2670.647852,57,84,0.7,27,0.025925926,7
2670.620068,59,75,0.47,16,0.029375,7
2670.450454,60,81,0.56,21,0.026666667,7
2670.100166,56,80,0.7,24,0.029166667,7
2669.794399,57,78,0.59,21,0.028095238,7
2669.792764,52,90,0.8,38,0.021052632,7
2669.394771,36,61,0.8,25,0.032,7
2669.322003,40,76,0.91,36,0.025277778,7
2669.236856,30,84,0.17,54,0.003148148,7
2669.188816,38,57,0.65,19,0.034210526,7
2669.151194,26,92,0.58,66,0.008787879,7
2669.061276,62,81,0.52,19,0.027368421,7
2668.985699,66,76,0.22,10,0.022,7
2668.928283,64,78,0.31,14,0.022142857,7
2668.923732,63,79,0.44,16,0.0275,7
2668.923732,61,81,0.55,20,0.0275,7
2668.923732,59,83,0.66,24,0.0275,7
2668.923732,58,85,0.74,27,0.027407407,7
2668.79312,64,77,0.36,13,0.027692308,7
2668.716367,69,95,0.46,26,0.017692308,7
2668.659669,55,94,0.77,39,0.01974359,7
2668.630968,52,84,0.87,32,0.0271875,7
2668.568602,60,82,0.49,22,0.022272727,7
2668.431614,32,59,0.96,27,0.035555556,7
2668.430466,55,81,0.7,26,0.026923077,7
2668.430466,51,86,0.94,35,0.026857143,7
2668.394046,46,67,0.55,21,0.026190476,7
2668.167311,39,52,0.44,13,0.033846154,7
2667.933123,59,86,0.55,27,0.02037037,7
2667.840274,65,74,0.25,9,0.027777778,7
2667.549797,57,86,0.74,29,0.025517241,7
2667.506813,34,57,0.75,23,0.032608696,7
2667.455533,46,64,0.59,18,0.032777778,7
2667.324411,37,54,0.56,17,0.032941176,7
2667.273714,39,56,0.56,17,0.032941176,7
2667.032513,54,84,0.82,30,0.027333333,7
2667.021577,33,97,0.49,64,0.00765625,7
2666.989177,54,89,0.98,35,0.028,7
2666.78257,33,62,0.95,29,0.032758621,7
2666.635423,62,73,0.32,11,0.029090909,7
2666.155343,57,90,0.66,33,0.02,7
2666.035136,49,89,0.87,40,0.02175,7
2666.029801,42,58,0.42,16,0.02625,7
2665.905254,36,67,0.79,31,0.025483871,7
2665.758816,57,80,0.66,23,0.028695652,7
2665.685474,36,55,0.66,19,0.034736842,7
2665.656626,74,88,0.26,14,0.018571429,7
2665.514049,42,51,0.34,9,0.037777778,7
2665.51097,35,54,0.7,19,0.036842105,7
2665.13525,55,93,0.98,38,0.025789474,7
2664.972143,38,69,0.06,31,0.001935484,7
2664.906999,35,98,0.19,63,0.003015873,7
2664.77647,66,75,0.24,9,0.026666667,7
2664.50586,58,81,0.62,23,0.026956522,7
2664.095222,35,57,0.77,22,0.035,7
2663.98971,62,77,0.42,15,0.028,7
2663.942377,34,60,0.87,26,0.033461538,7
2663.872598,34,60,0.85,26,0.032692308,7
2663.859343,46,59,0.04,13,0.003076923,7
2663.838899,31,59,0.94,28,0.033571429,7
2663.751644,25,89,0.61,64,0.00953125,7
2663.705005,36,56,0.69,20,0.0345,7
2663.391587,34,97,0.28,63,0.004444444,7
2663.128047,26,85,0.61,59,0.010338983,7
2662.976645,58,78,0.58,20,0.029,7
2662.796834,58,88,0.61,30,0.020333333,7
2662.753986,63,80,0.46,17,0.027058824,7
2662.699161,33,83,0.11,50,0.0022,7
2662.556642,30,84,0.22,54,0.004074074,7
2662.374726,70,92,0.4,22,0.018181818,7
2662.087938,55,78,0.75,23,0.032608696,7
2662.035403,62,75,0.37,13,0.028461538,7
2662.031832,35,62,0.87,27,0.032222222,7
2662.004735,55,94,0.88,39,0.022564103,7
2661.898175,54,90,0.99,36,0.0275,7
2661.875889,51,85,0.93,34,0.027352941,7
2661.722517,43,57,0.38,14,0.027142857,7
2661.681037,55,93,0.89,38,0.023421053,7
2661.673952,48,65,0.55,17,0.032352941,7
2661.318229,53,83,0.86,30,0.028666667,7
2661.318229,52,84,0.92,32,0.02875,7
2661.255886,33,60,0.88,27,0.032592593,7
2661.206954,69,95,0.47,26,0.018076923,7
2661.172739,54,95,0.93,41,0.022682927,7
2661.149922,61,85,0.47,24,0.019583333,7
2661.098735,43,48,0.18,5,0.036,7
2661.032149,55,93,0.76,38,0.02,7
2660.963582,57,79,0.62,22,0.028181818,7
2660.963582,54,83,0.81,29,0.027931034,7
2660.963582,53,84,0.87,31,0.028064516,7
2660.963582,52,85,0.93,33,0.028181818,7
2660.927842,59,90,0.61,31,0.019677419,7
2660.904631,46,66,0.53,20,0.0265,7
2660.874297,63,74,0.31,11,0.028181818,7
2660.77067,60,77,0.47,17,0.027647059,7
2660.675522,53,81,0.91,28,0.0325,7
2660.645052,35,94,0.2,59,0.003389831,7
2660.515767,31,85,0.13,54,0.002407407,7
2660.259831,76,90,0.25,14,0.017857143,7
2660.247081,52,85,0.88,33,0.026666667,7
2660.089876,54,87,0.87,33,0.026363636,7
2659.992188,64,82,0.46,18,0.025555556,7
2659.930988,58,90,0.63,32,0.0196875,7
2659.809316,56,81,0.7,25,0.028,7
2659.589531,53,83,0.81,30,0.027,7
2659.501602,57,89,0.64,32,0.02,7
2659.419777,36,94,0.15,58,0.002586207,7
2659.418287,55,83,0.78,28,0.027857143,7
2659.399413,60,80,0.53,20,0.0265,7
2659.387108,72,90,0.35,18,0.019444444,7
2659.387108,71,91,0.39,20,0.0195,7
2659.199061,57,91,0.86,34,0.025294118,7
2659.16807,27,89,0.54,62,0.008709677,7
2658.912306,58,87,0.79,29,0.027241379,7
2658.79148,80,85,0.09,5,0.018,7
2658.69964,53,85,0.91,32,0.0284375,7
2658.69964,52,86,0.97,34,0.028529412,7
