% profit,ema1,ema2,threshold,diff,thresh / diff,ID
3673.187061,41,47,0.23,6,0.038333333,32
3614.331827,8,9,0.05,1,0.05,32
3596.169084,40,48,0.31,8,0.03875,32
3556.124531,37,52,0.57,15,0.038,32
3555.81793,42,46,0.15,4,0.0375,32
3546.369812,32,57,0.96,25,0.0384,32
3531.157903,32,57,0.95,25,0.038,32
3527.126857,38,51,0.49,13,0.037692308,32
3512.603319,62,69,0.23,7,0.032857143,32
3509.349336,58,74,0.52,16,0.0325,32
3506.633968,56,76,0.65,20,0.0325,32
3497.429557,57,74,0.56,17,0.032941176,32
3493.422439,39,50,0.41,11,0.037272727,32
3485.247861,59,73,0.45,14,0.032142857,32
3478.669828,60,71,0.36,11,0.032727273,32
3476.547113,56,75,0.63,19,0.033157895,32
3468.064418,62,68,0.2,6,0.033333333,32
3468.064418,59,71,0.4,12,0.033333333,32
3458.058143,55,77,0.72,22,0.032727273,32
3457.95872,61,71,0.32,10,0.032,32
3457.896281,59,72,0.43,13,0.033076923,32
3453.332625,33,56,0.87,23,0.037826087,32
3452.081418,42,44,0.08,2,0.04,32
3452.081418,41,45,0.16,4,0.04,32
3444.624458,32,57,0.97,25,0.0388,32
3436.479104,38,51,0.48,13,0.036923077,32
3433.963491,45,50,0.18,5,0.036,32
3431.735003,39,50,0.42,11,0.038181818,32
3429.639512,40,59,0.65,19,0.034210526,32
3424.4635,36,54,0.66,18,0.036666667,32
3422.692348,40,49,0.33,9,0.036666667,32
3418.671748,33,56,0.88,23,0.03826087,32
3411.167928,37,52,0.56,15,0.037333333,32
3411.167928,35,55,0.74,20,0.037,32
3409.468056,32,58,0.97,26,0.037307692,32
3405.998064,38,51,0.5,13,0.038461538,32
3404.444832,39,47,0.32,8,0.04,32
3404.444832,38,48,0.4,10,0.04,32
3400.531613,40,48,0.32,8,0.04,32
3400.531613,39,49,0.4,10,0.04,32
3398.020748,34,55,0.79,21,0.037619048,32
3394.521737,33,57,0.88,24,0.036666667,32
3388.796628,40,49,0.34,9,0.037777778,32
3385.108442,36,52,0.61,16,0.038125,32
3384.393541,35,52,0.67,17,0.039411765,32
3383.915827,40,46,0.24,6,0.04,32
3377.94451,36,51,0.59,15,0.039333333,32
3376.276294,32,58,0.96,26,0.036923077,32
3374.114945,38,50,0.46,12,0.038333333,32
3365.880904,39,49,0.38,10,0.038,32
3360.667027,34,54,0.78,20,0.039,32
3359.463221,43,52,0.33,9,0.036666667,32
3358.59751,41,45,0.15,4,0.0375,32
3358.59751,36,51,0.56,15,0.037333333,32
3355.898715,34,54,0.77,20,0.0385,32
3355.792885,33,55,0.86,22,0.039090909,32
3352.866118,37,52,0.58,15,0.038666667,32
3350.981864,47,49,0.07,2,0.035,32
3349.024518,37,52,0.59,15,0.039333333,32
3349.024518,36,53,0.67,17,0.039411765,32
3348.002963,36,53,0.66,17,0.038823529,32
3343.344335,40,47,0.26,7,0.037142857,32
3342.675657,41,48,0.26,7,0.037142857,32
3342.153392,46,50,0.14,4,0.035,32
3342.153392,45,51,0.21,6,0.035,32
3340.436889,38,49,0.41,11,0.037272727,32
3322.453354,53,79,0.86,26,0.033076923,32
3321.577693,42,48,0.22,6,0.036666667,32
3316.028875,37,53,0.59,16,0.036875,32
3315.018407,35,53,0.7,18,0.038888889,32
3313.823911,43,46,0.11,3,0.036666667,32
3312.817543,55,73,0.61,18,0.033888889,32
3307.97738,61,66,0.17,5,0.034,32
3303.28631,35,53,0.69,18,0.038333333,32
3301.674423,39,48,0.35,9,0.038888889,32
3300.584247,40,47,0.27,7,0.038571429,32
3298.404657,37,50,0.51,13,0.039230769,32
3298.3856,38,49,0.43,11,0.039090909,32
3298.135247,53,75,0.75,22,0.034090909,32
3294.522297,40,48,0.3,8,0.0375,32
3294.086586,36,53,0.63,17,0.037058824,32
3292.496635,36,52,0.62,16,0.03875,32
3291.045548,56,77,0.68,21,0.032380952,32
3287.338292,57,76,0.61,19,0.032105263,32
3283.670687,58,73,0.49,15,0.032666667,32
3279.914534,39,49,0.39,10,0.039,32
3279.501716,60,73,0.42,13,0.032307692,32
3278.626146,37,52,0.55,15,0.036666667,32
3277.908107,35,54,0.71,19,0.037368421,32
3277.323165,51,62,0.27,11,0.024545455,32
3275.80708,64,69,0.16,5,0.032,32
3275.166035,32,56,0.94,24,0.039166667,32
3273.691678,62,71,0.29,9,0.032222222,32
3272.423756,33,54,0.84,21,0.04,32
3271.899625,54,79,0.81,25,0.0324,32
3271.398219,36,53,0.64,17,0.037647059,32
3269.313786,33,56,0.84,23,0.036521739,32
3268.586717,42,54,0.43,12,0.035833333,32
3266.670897,58,76,0.57,18,0.031666667,32
3266.292486,55,76,0.7,21,0.033333333,32
3266.292486,54,78,0.79,24,0.032916667,32
3265.548028,60,67,0.24,7,0.034285714,32
3265.546882,37,51,0.54,14,0.038571429,32
3264.273639,38,50,0.45,12,0.0375,32
3261.051663,39,47,0.3,8,0.0375,32
3257.710782,35,53,0.72,18,0.04,32
3257.190626,37,51,0.53,14,0.037857143,32
3256.10272,57,73,0.53,16,0.033125,32
3255.705798,35,54,0.72,19,0.037894737,32
3255.705798,34,55,0.8,21,0.038095238,32
3253.650366,41,59,0.61,18,0.033888889,32
3249.513373,43,53,0.36,10,0.036,32
3248.510248,36,52,0.64,16,0.04,32
3247.627913,46,49,0.11,3,0.036666667,32
3247.596989,58,72,0.46,14,0.032857143,32
3247.527275,52,61,0.22,9,0.024444444,32
3244.337711,34,55,0.83,21,0.03952381,32
3244.295411,53,60,0.17,7,0.024285714,32
3242.969539,41,54,0.48,13,0.036923077,32
3242.935438,35,54,0.73,19,0.038421053,32
3241.959548,32,58,0.9,26,0.034615385,32
3240.414035,39,61,0.75,22,0.034090909,32
3238.227114,34,55,0.81,21,0.038571429,32
3237.168895,64,68,0.13,4,0.0325,32
3237.168895,62,70,0.26,8,0.0325,32
3237.168895,60,72,0.39,12,0.0325,32
3236.223962,34,55,0.74,21,0.035238095,32
3234.564163,35,55,0.69,20,0.0345,32
3231.258687,55,76,0.69,21,0.032857143,32
3230.616793,35,53,0.67,18,0.037222222,32
3228.936071,54,74,0.68,20,0.034,32
3228.677349,41,55,0.51,14,0.036428571,32
3228.674666,38,50,0.47,12,0.039166667,32
3224.937958,36,53,0.65,17,0.038235294,32
3224.842748,51,86,0.94,35,0.026857143,32
3224.677334,60,70,0.33,10,0.033,32
3223.986428,37,51,0.55,14,0.039285714,32
3223.986428,36,52,0.63,16,0.039375,32
3223.904999,33,56,0.89,23,0.038695652,32
3222.164639,40,44,0.17,4,0.0425,32
3221.96913,53,86,0.98,33,0.02969697,32
3221.591903,36,54,0.68,18,0.037777778,32
3220.659191,42,55,0.46,13,0.035384615,32
3219.616117,40,60,0.68,20,0.034,32
3219.129475,32,56,0.95,24,0.039583333,32
3215.860416,37,51,0.56,14,0.04,32
3215.518591,34,54,0.8,20,0.04,32
3215.473033,36,52,0.59,16,0.036875,32
3213.058388,60,69,0.3,9,0.033333333,32
3212.848197,46,53,0.24,7,0.034285714,32
3210.920202,60,74,0.44,14,0.031428571,32
3210.747673,35,54,0.74,19,0.038947368,32
3208.750062,35,54,0.67,19,0.035263158,32
3208.182249,45,54,0.31,9,0.034444444,32
3207.555375,43,44,0.04,1,0.04,32
3207.555375,42,45,0.12,3,0.04,32
3207.555375,41,46,0.2,5,0.04,32
3207.555375,40,47,0.28,7,0.04,32
3204.660117,54,77,0.77,23,0.033478261,32
3202.974666,40,55,0.56,15,0.037333333,32
3202.654026,38,50,0.48,12,0.04,32
3201.566651,34,56,0.8,22,0.036363636,32
3200.737989,38,51,0.51,13,0.039230769,32
3199.706419,33,57,0.89,24,0.037083333,32
3198.528568,34,55,0.77,21,0.036666667,32
3198.202716,33,56,0.91,23,0.039565217,32
3196.691898,33,55,0.87,22,0.039545455,32
3196.536288,32,57,0.99,25,0.0396,32
3195.840852,34,57,0.86,23,0.037391304,32
3195.840643,38,52,0.51,14,0.036428571,32
3195.53079,32,56,0.97,24,0.040416667,32
3195.45776,43,54,0.39,11,0.035454545,32
3194.42202,35,53,0.71,18,0.039444444,32
3192.143434,63,71,0.25,8,0.03125,32
3191.771013,34,53,0.77,19,0.040526316,32
3191.771013,33,55,0.88,22,0.04,32
3190.124816,62,67,0.17,5,0.034,32
3189.713924,34,55,0.82,21,0.039047619,32
3189.015219,63,66,0.1,3,0.033333333,32
3188.892445,32,55,0.93,23,0.040434783,32
3188.785588,35,55,0.73,20,0.0365,32
3188.6435,51,56,0.13,5,0.026,32
3187.697862,61,69,0.27,8,0.03375,32
3187.697862,58,73,0.5,15,0.033333333,32
3187.697862,57,74,0.57,17,0.033529412,32
3186.998278,34,56,0.81,22,0.036818182,32
3186.782386,57,75,0.59,18,0.032777778,32
3186.759439,55,88,0.85,33,0.025757576,32
3186.291106,36,50,0.57,14,0.040714286,32
3185.802172,35,56,0.73,21,0.034761905,32
3184.763383,55,74,0.59,19,0.031052632,32
3183.934377,57,76,0.53,19,0.027894737,32
3183.790001,41,57,0.56,16,0.035,32
3183.283236,33,59,0.94,26,0.036153846,32
3180.961415,54,77,0.76,23,0.033043478,32
3180.415004,52,55,0.08,3,0.026666667,32
3179.693774,33,56,0.85,23,0.036956522,32
3178.92767,34,53,0.76,19,0.04,32
3178.836705,52,77,0.78,25,0.0312,32
3178.695127,47,67,0.48,20,0.024,32
3177.800866,58,75,0.55,17,0.032352941,32
3177.478847,36,54,0.67,18,0.037222222,32
3174.472396,57,81,0.71,24,0.029583333,32
3174.472396,56,82,0.77,26,0.029615385,32
3174.337295,34,54,0.74,20,0.037,32
3174.16671,48,52,0.13,4,0.0325,32
3173.90791,36,51,0.6,15,0.04,32
3172.41707,58,72,0.47,14,0.033571429,32
3171.359609,56,74,0.61,18,0.033888889,32
3168.62691,43,45,0.08,2,0.04,32
3168.62691,42,46,0.16,4,0.04,32
3168.62691,41,47,0.24,6,0.04,32
3168.623536,49,81,0.98,32,0.030625,32
3166.801124,34,56,0.82,22,0.037272727,32
3166.038162,57,73,0.54,16,0.03375,32
3165.826692,32,57,0.98,25,0.0392,32
3165.759351,56,74,0.6,18,0.033333333,32
3165.155342,35,52,0.68,17,0.04,32
3164.106126,62,81,0.51,19,0.026842105,32
3164.106126,58,86,0.75,28,0.026785714,32
3163.943311,53,78,0.84,25,0.0336,32
3163.849205,59,80,0.49,21,0.023333333,32
3163.777654,42,47,0.18,5,0.036,32
3163.552498,35,52,0.69,17,0.040588235,32
3163.047731,33,58,0.94,25,0.0376,32
3161.775277,56,87,0.8,31,0.025806452,32
3161.775277,54,90,0.92,36,0.025555556,32
3161.279024,44,54,0.35,10,0.035,32
3161.024986,46,53,0.23,7,0.032857143,32
3160.688799,39,60,0.75,21,0.035714286,32
3160.630189,42,53,0.41,11,0.037272727,32
3160.507486,53,92,0.99,39,0.025384615,32
3159.719743,35,51,0.65,16,0.040625,32
3159.485752,7,10,0.15,3,0.05,32
3159.068982,46,54,0.26,8,0.0325,32
3158.898754,62,79,0.47,17,0.027647059,32
3158.484303,35,56,0.78,21,0.037142857,32
3157.773485,32,55,0.94,23,0.040869565,32
3157.256978,36,54,0.64,18,0.035555556,32
3155.909206,64,78,0.39,14,0.027857143,32
3155.71202,58,65,0.25,7,0.035714286,32
3155.446278,50,80,0.92,30,0.030666667,32
3155.446278,49,81,0.99,32,0.0309375,32
3154.78147,41,54,0.49,13,0.037692308,32
3153.721937,59,70,0.37,11,0.033636364,32
3152.652804,33,54,0.85,21,0.04047619,32
3152.272266,45,53,0.28,8,0.035,32
3151.78318,44,51,0.26,7,0.037142857,32
3151.437073,41,56,0.53,15,0.035333333,32
3151.437073,40,58,0.63,18,0.035,32
3151.36014,65,75,0.28,10,0.028,32
3150.763624,37,69,0.86,32,0.026875,32
3150.501226,53,90,0.96,37,0.025945946,32
3150.439883,57,87,0.81,30,0.027,32
3149.808974,35,55,0.76,20,0.038,32
3148.890912,39,50,0.4,11,0.036363636,32
3148.614455,37,53,0.58,16,0.03625,32
3148.184721,54,85,0.92,31,0.029677419,32
3148.09809,38,62,0.83,24,0.034583333,32
3146.819669,36,54,0.65,18,0.036111111,32
3146.42086,54,80,0.73,26,0.028076923,32
3146.42086,53,81,0.79,28,0.028214286,32
3146.371448,54,75,0.65,21,0.030952381,32
3146.266618,40,57,0.61,17,0.035882353,32
3144.474684,54,77,0.78,23,0.033913043,32
3144.288826,33,56,0.9,23,0.039130435,32
3143.099482,43,55,0.42,12,0.035,32
3141.584099,53,78,0.83,25,0.0332,32
3141.318802,37,60,0.86,23,0.037391304,32
3140.952207,55,76,0.71,21,0.033809524,32
3140.73248,60,82,0.6,22,0.027272727,32
3140.097398,63,77,0.39,14,0.027857143,32
3139.984687,41,57,0.57,16,0.035625,32
3139.918808,39,59,0.74,20,0.037,32
3138.629773,42,57,0.5,15,0.033333333,32
3138.227849,59,85,0.69,26,0.026538462,32
3137.969125,63,80,0.45,17,0.026470588,32
3137.941146,55,84,0.85,29,0.029310345,32
3137.874388,39,60,0.73,21,0.034761905,32
3137.747261,62,78,0.45,16,0.028125,32
3137.747261,59,82,0.64,23,0.027826087,32
3137.747261,59,83,0.66,24,0.0275,32
3137.747261,58,83,0.7,25,0.028,32
3137.747261,58,84,0.72,26,0.027692308,32
3137.314066,44,46,0.07,2,0.035,32
3137.314066,43,47,0.14,4,0.035,32
3136.687973,51,85,0.92,34,0.027058824,32
3136.564057,34,57,0.83,23,0.036086957,32
3136.518219,32,57,0.92,25,0.0368,32
3136.409854,35,54,0.7,19,0.036842105,32
3136.096771,55,75,0.68,20,0.034,32
3135.24193,37,53,0.57,16,0.035625,32
3134.542922,40,55,0.57,15,0.038,32
3133.479937,38,58,0.75,20,0.0375,32
3132.957729,39,60,0.74,21,0.035238095,32
3132.904796,62,71,0.25,9,0.027777778,32
3132.521845,55,79,0.66,24,0.0275,32
3131.432702,32,56,0.96,24,0.04,32
3131.174292,40,56,0.59,16,0.036875,32
3130.87957,58,80,0.65,22,0.029545455,32
3130.440863,41,58,0.59,17,0.034705882,32
3129.861509,64,78,0.38,14,0.027142857,32
3129.861509,62,80,0.49,18,0.027222222,32
3129.861509,60,83,0.62,23,0.026956522,32
3129.786484,45,49,0.15,4,0.0375,32
3129.361267,38,61,0.82,23,0.035652174,32
3128.568994,65,69,0.11,4,0.0275,32
3127.928922,56,89,0.88,33,0.026666667,32
3127.666288,63,76,0.37,13,0.028461538,32
3127.559594,56,79,0.66,23,0.028695652,32
3127.477999,40,58,0.65,18,0.036111111,32
3126.976267,39,51,0.44,12,0.036666667,32
3126.888519,55,87,0.86,32,0.026875,32
3126.888519,54,89,0.93,35,0.026571429,32
3126.130275,33,57,0.87,24,0.03625,32
3123.903596,44,52,0.29,8,0.03625,32
3123.775498,44,53,0.32,9,0.035555556,32
3123.728198,42,52,0.38,10,0.038,32
3123.243157,59,76,0.47,17,0.027647059,32
3122.265236,32,58,0.95,26,0.036538462,32
3120.832789,43,56,0.45,13,0.034615385,32
3120.53884,58,75,0.47,17,0.027647059,32
3120.23361,61,72,0.35,11,0.031818182,32
3120.23361,59,74,0.48,15,0.032,32
3118.956564,64,75,0.31,11,0.028181818,32
3118.386635,34,55,0.76,21,0.036190476,32
3118.265984,61,79,0.41,18,0.022777778,32
3118.256268,42,56,0.5,14,0.035714286,32
3118.001639,41,58,0.6,17,0.035294118,32
3117.784001,42,59,0.55,17,0.032352941,32
3117.250826,45,66,0.71,21,0.033809524,32
3116.679697,53,82,0.79,29,0.027241379,32
3116.338642,59,84,0.68,25,0.0272,32
3116.338642,57,86,0.79,29,0.027241379,32
3116.307392,38,60,0.79,22,0.035909091,32
3116.192033,62,80,0.51,18,0.028333333,32
3115.801463,57,88,0.82,31,0.026451613,32
3115.801463,56,90,0.89,34,0.026176471,32
3115.569243,38,50,0.43,12,0.035833333,32
3114.782641,67,74,0.19,7,0.027142857,32
3114.582968,34,57,0.84,23,0.036521739,32
3114.466235,67,73,0.17,6,0.028333333,32
3114.466235,64,76,0.34,12,0.028333333,32
3114.466235,61,79,0.51,18,0.028333333,32
3114.466235,60,81,0.59,21,0.028095238,32
3114.046571,33,57,0.83,24,0.034583333,32
3113.856979,44,55,0.38,11,0.034545455,32
3113.835354,77,87,0.17,10,0.017,32
3113.504233,71,94,0.39,23,0.016956522,32
3113.420285,56,86,0.79,30,0.026333333,32
3113.420285,55,88,0.86,33,0.026060606,32
3113.420285,54,89,0.91,35,0.026,32
3113.420285,54,90,0.93,36,0.025833333,32
3113.420285,53,91,0.98,38,0.025789474,32
3113.183483,60,83,0.63,23,0.027391304,32
3113.049172,48,62,0.36,14,0.025714286,32
3112.662184,40,58,0.64,18,0.035555556,32
3112.619661,42,47,0.19,5,0.038,32
3112.414536,39,57,0.67,18,0.037222222,32
3112.229783,44,56,0.39,12,0.0325,32
3111.967263,54,89,0.98,35,0.028,32
3111.539721,42,70,0.95,28,0.033928571,32
3111.47503,34,57,0.85,23,0.036956522,32
3111.47503,33,58,0.93,25,0.0372,32
3111.464852,54,82,0.77,28,0.0275,32
3111.464852,53,83,0.83,30,0.027666667,32
3110.86992,41,56,0.56,15,0.037333333,32
3110.809753,42,54,0.44,12,0.036666667,32
3109.809903,65,76,0.3,11,0.027272727,32
3109.809903,63,78,0.41,15,0.027333333,32
3109.200762,53,87,0.94,34,0.027647059,32
3109.0883,39,59,0.72,20,0.036,32
3109.017379,51,85,0.98,34,0.028823529,32
3108.98271,35,54,0.75,19,0.039473684,32
3108.343554,37,62,0.9,25,0.036,32
3108.051886,7,10,0.16,3,0.053333333,32
3107.44245,40,61,0.71,21,0.033809524,32
3107.029877,40,57,0.62,17,0.036470588,32
3106.966978,57,75,0.52,18,0.028888889,32
3106.585243,42,56,0.49,14,0.035,32
3106.361884,42,55,0.47,13,0.036153846,32
3105.861821,58,83,0.67,25,0.0268,32
3105.83387,57,84,0.73,27,0.027037037,32
3105.83387,55,86,0.84,31,0.027096774,32
3105.83387,53,89,0.97,36,0.026944444,32
3105.763943,38,61,0.81,23,0.035217391,32
3105.733005,58,74,0.46,16,0.02875,32
3105.636891,33,59,0.93,26,0.035769231,32
3105.609103,65,76,0.31,11,0.028181818,32
3105.187943,52,80,0.93,28,0.033214286,32
3105.155361,40,59,0.66,19,0.034736842,32
3104.875114,57,77,0.55,20,0.0275,32
3104.653453,53,90,0.99,37,0.026756757,32
3104.254728,66,76,0.27,10,0.027,32
3104.254728,61,82,0.56,21,0.026666667,32
3103.998719,68,74,0.16,6,0.026666667,32
3103.997069,41,57,0.58,16,0.03625,32
3103.663687,54,89,0.92,35,0.026285714,32
3103.663687,53,91,0.99,38,0.026052632,32
3103.587346,64,77,0.36,13,0.027692308,32
3103.523298,66,75,0.25,9,0.027777778,32
3103.447402,42,57,0.53,15,0.035333333,32
3103.292746,64,74,0.29,10,0.029,32
3103.292746,62,77,0.43,15,0.028666667,32
3103.056202,55,87,0.9,32,0.028125,32
3103.056202,54,88,0.96,34,0.028235294,32
3102.933905,51,84,0.92,33,0.027878788,32
3102.867796,52,84,0.91,32,0.0284375,32
3102.742235,43,56,0.46,13,0.035384615,32
3102.68061,61,82,0.57,21,0.027142857,32
3102.431717,39,57,0.68,18,0.037777778,32
3102.19477,37,50,0.52,13,0.04,32
3101.940877,61,81,0.57,20,0.0285,32
3100.59708,32,58,0.94,26,0.036153846,32
3100.295513,56,85,0.79,29,0.027241379,32
3100.295513,54,88,0.92,34,0.027058824,32
3099.620456,35,55,0.75,20,0.0375,32
3099.298872,45,52,0.25,7,0.035714286,32
3099.158445,41,56,0.54,15,0.036,32
3099.136206,77,94,0.28,17,0.016470588,32
3099.136206,74,97,0.38,23,0.016521739,32
3098.69642,39,59,0.71,20,0.0355,32
3098.082244,65,73,0.23,8,0.02875,32
3097.260417,53,81,0.77,28,0.0275,32
3096.937165,33,55,0.89,22,0.040454545,32
3096.916357,63,71,0.22,8,0.0275,32
3096.334587,62,83,0.59,21,0.028095238,32
3095.915802,42,54,0.45,12,0.0375,32
3095.257709,50,86,0.97,36,0.026944444,32
3094.385462,43,58,0.48,15,0.032,32
3093.684647,34,57,0.87,23,0.037826087,32
3093.474392,56,82,0.7,26,0.026923077,32
3092.807923,52,83,0.86,31,0.027741935,32
3092.574047,39,59,0.73,20,0.0365,32
3092.453513,55,87,0.84,32,0.02625,32
3092.453513,53,90,0.97,37,0.026216216,32
3092.418745,55,78,0.66,23,0.028695652,32
3092.245689,41,57,0.59,16,0.036875,32
3091.775163,43,69,0.87,26,0.033461538,32
3091.682425,40,59,0.67,19,0.035263158,32
3091.605022,36,55,0.69,19,0.036315789,32
3091.373629,52,82,0.83,30,0.027666667,32
3090.721628,53,90,0.98,37,0.026486486,32
3090.238054,60,73,0.36,13,0.027692308,32
3090.174484,63,78,0.42,15,0.028,32
3090.174484,61,80,0.53,19,0.027894737,32
3089.711908,52,82,0.85,30,0.028333333,32
3089.621884,37,50,0.48,13,0.036923077,32
3089.184567,56,76,0.59,20,0.0295,32
3088.648295,57,84,0.76,27,0.028148148,32
3088.648295,56,85,0.82,29,0.028275862,32
3088.648295,56,86,0.84,30,0.028,32
3088.247226,57,75,0.53,18,0.029444444,32
3088.074601,41,55,0.52,14,0.037142857,32
3087.752727,53,79,0.78,26,0.03,32
3087.652339,65,74,0.26,9,0.028888889,32
3087.574107,74,90,0.3,16,0.01875,32
3087.376489,59,73,0.4,14,0.028571429,32
3087.368166,35,52,0.64,17,0.037647059,32
3086.904865,48,50,0.07,2,0.035,32
3086.904865,47,51,0.14,4,0.035,32
3086.904865,46,52,0.21,6,0.035,32
3086.678406,38,60,0.81,22,0.036818182,32
3086.269316,66,74,0.23,8,0.02875,32
3085.841213,46,57,0.3,11,0.027272727,32
3085.712517,63,79,0.43,16,0.026875,32
3085.677909,39,58,0.69,19,0.036315789,32
3085.446792,50,85,0.96,35,0.027428571,32
3085.36982,60,75,0.41,15,0.027333333,32
3085.106268,58,77,0.53,19,0.027894737,32
3085.096085,50,87,0.99,37,0.026756757,32
3085.006598,36,49,0.55,13,0.042307692,32
3084.674586,61,84,0.65,23,0.02826087,32
3084.478141,65,77,0.26,12,0.021666667,32
3083.669595,59,85,0.67,26,0.025769231,32
3083.669595,57,88,0.79,31,0.025483871,32
3083.407701,59,79,0.59,20,0.0295,32
3083.156394,55,82,0.74,27,0.027407407,32
3083.08678,52,83,0.87,31,0.028064516,32
3082.760575,54,88,0.9,34,0.026470588,32
3082.414987,36,50,0.53,14,0.037857143,32
3082.303008,58,85,0.75,27,0.027777778,32
3082.2552,69,75,0.17,6,0.028333333,32
3082.2552,65,79,0.4,14,0.028571429,32
3082.2552,60,85,0.71,25,0.0284,32
3082.229358,54,79,0.72,25,0.0288,32
3082.079556,53,86,0.94,33,0.028484848,32
3081.682004,42,45,0.11,3,0.036666667,32
3081.222592,37,61,0.88,24,0.036666667,32
3080.86052,55,86,0.85,31,0.027419355,32
3080.73976,57,74,0.51,17,0.03,32
3080.720926,56,85,0.78,29,0.026896552,32
3080.500407,59,85,0.7,26,0.026923077,32
3080.39128,59,84,0.69,25,0.0276,32
3080.365522,39,51,0.45,12,0.0375,32
3080.329626,38,59,0.77,21,0.036666667,32
3080.276004,58,88,0.83,30,0.027666667,32
3080.229126,51,81,0.91,30,0.030333333,32
3079.473109,68,73,0.14,5,0.028,32
3079.473109,65,77,0.33,12,0.0275,32
3079.473109,63,79,0.44,16,0.0275,32
3079.473109,62,80,0.5,18,0.027777778,32
3079.473109,61,81,0.55,20,0.0275,32
3079.473109,60,82,0.61,22,0.027727273,32
3079.473109,58,85,0.74,27,0.027407407,32
3078.69537,61,68,0.24,7,0.034285714,32
3078.50765,61,73,0.33,12,0.0275,32
3078.50765,59,75,0.44,16,0.0275,32
3078.030122,43,52,0.34,9,0.037777778,32
3077.885224,40,56,0.6,16,0.0375,32
3077.793249,56,87,0.85,31,0.027419355,32
3077.54263,39,48,0.33,9,0.036666667,32
3077.49239,52,80,0.84,28,0.03,32
3077.307142,53,85,0.87,32,0.0271875,32
3077.011756,45,51,0.22,6,0.036666667,32
3076.999271,48,62,0.48,14,0.034285714,32
3076.95506,66,73,0.2,7,0.028571429,32
3076.568818,44,67,0.78,23,0.033913043,32
3076.536019,65,75,0.29,10,0.029,32
3076.208163,42,72,0.95,30,0.031666667,32
3076.191296,44,68,0.79,24,0.032916667,32
3076.173485,45,67,0.72,22,0.032727273,32
3076.081428,55,79,0.67,24,0.027916667,32
3076.012423,54,79,0.71,25,0.0284,32
3076.012423,53,80,0.77,27,0.028518519,32
3076.012423,52,81,0.83,29,0.02862069,32
3075.800875,54,88,0.91,34,0.026764706,32
3075.596619,60,72,0.34,12,0.028333333,32
3075.581041,64,77,0.37,13,0.028461538,32
3075.560744,50,83,0.97,33,0.029393939,32
3075.27641,62,80,0.47,18,0.026111111,32
3074.813872,55,87,0.85,32,0.0265625,32
3074.718555,39,58,0.71,19,0.037368421,32
3074.543119,42,57,0.52,15,0.034666667,32
3074.516145,52,81,0.85,29,0.029310345,32
3074.516145,51,82,0.91,31,0.029354839,32
3074.469457,56,77,0.6,21,0.028571429,32
3074.384591,62,77,0.44,15,0.029333333,32
3074.384591,61,78,0.5,17,0.029411765,32
3074.322705,57,80,0.63,23,0.027391304,32
3074.322705,55,83,0.76,28,0.027142857,32
3074.146194,55,76,0.64,21,0.03047619,32
3073.748524,38,60,0.8,22,0.036363636,32
3072.633531,48,66,0.44,18,0.024444444,32
3072.456765,50,85,0.95,35,0.027142857,32
3072.342405,43,57,0.46,14,0.032857143,32
3072.285893,77,87,0.18,10,0.018,32
3071.394067,37,47,0.43,10,0.043,32
3071.353231,40,50,0.37,10,0.037,32
3071.103934,58,84,0.73,26,0.028076923,32
3070.887725,49,59,0.26,10,0.026,32
3070.586387,55,78,0.65,23,0.02826087,32
3069.928365,44,54,0.36,10,0.036,32
3069.91947,60,71,0.33,11,0.03,32
3069.842775,57,83,0.72,26,0.027692308,32
3069.842775,56,84,0.78,28,0.027857143,32
3069.732623,39,58,0.7,19,0.036842105,32
3069.608265,56,88,0.87,32,0.0271875,32
3069.482468,33,55,0.82,22,0.037272727,32
3069.376461,35,55,0.77,20,0.0385,32
3069.250659,62,72,0.29,10,0.029,32
3068.95255,60,68,0.27,8,0.03375,32
3068.824744,53,88,0.97,35,0.027714286,32
3068.72852,44,52,0.3,8,0.0375,32
3068.348654,44,59,0.41,15,0.027333333,32
3068.187286,54,90,0.99,36,0.0275,32
3067.769849,72,92,0.34,20,0.017,32
3067.667063,60,70,0.34,10,0.034,32
3067.667063,56,75,0.64,19,0.033684211,32
3067.487908,37,68,0.84,31,0.027096774,32
3067.394351,34,58,0.86,24,0.035833333,32
3067.394351,34,58,0.87,24,0.03625,32
3067.203952,58,87,0.74,29,0.025517241,32
3067.203952,56,90,0.86,34,0.025294118,32
3067.203952,54,93,0.98,39,0.025128205,32
3066.966802,58,81,0.54,23,0.023478261,32
3066.695198,55,80,0.68,25,0.0272,32
3065.987273,55,89,0.7,34,0.020588235,32
3065.456431,47,67,0.49,20,0.0245,32
3065.354776,55,84,0.82,29,0.028275862,32
3065.354776,54,85,0.88,31,0.028387097,32
3065.209781,50,60,0.34,10,0.034,32
3065.209781,49,61,0.41,12,0.034166667,32
3064.847069,34,56,0.85,22,0.038636364,32
3064.827914,51,85,0.94,34,0.027647059,32
3064.589304,53,89,0.96,36,0.026666667,32
3064.55165,57,85,0.78,28,0.027857143,32
3064.55165,55,88,0.91,33,0.027575758,32
3064.493056,50,85,0.98,35,0.028,32
3064.49193,67,74,0.2,7,0.028571429,32
3064.49193,63,78,0.43,15,0.028666667,32
3064.409406,54,87,0.91,33,0.027575758,32
3064.409406,53,89,0.98,36,0.027222222,32
3064.352557,39,62,0.78,23,0.033913043,32
3064.332036,33,59,0.95,26,0.036538462,32
3064.228311,50,58,0.21,8,0.02625,32
3064.173271,70,95,0.46,25,0.0184,32
3064.173271,67,98,0.57,31,0.018387097,32
3063.858224,55,77,0.65,22,0.029545455,32
3062.954331,39,49,0.36,10,0.036,32
3062.592204,46,51,0.18,5,0.036,32
3062.460581,64,76,0.35,12,0.029166667,32
3062.229268,58,74,0.47,16,0.029375,32
3061.822778,60,83,0.65,23,0.02826087,32
3061.251563,49,62,0.32,13,0.024615385,32
3061.190257,55,91,0.93,36,0.025833333,32
3061.152363,37,49,0.45,12,0.0375,32
3060.87194,59,84,0.65,25,0.026,32
3060.843399,59,86,0.77,27,0.028518519,32
3060.843399,58,87,0.83,29,0.02862069,32
3060.724246,58,77,0.55,19,0.028947368,32
3060.724246,57,78,0.61,21,0.029047619,32
3060.724246,55,81,0.75,26,0.028846154,32
3060.581586,60,83,0.64,23,0.027826087,32
3060.551842,53,83,0.84,30,0.028,32
3060.479089,43,53,0.37,10,0.037,32
3060.260337,62,70,0.23,8,0.02875,32
3060.039771,43,55,0.43,12,0.035833333,32
3059.855965,38,59,0.78,21,0.037142857,32
3059.299747,57,79,0.61,22,0.027727273,32
3057.855787,34,58,0.82,24,0.034166667,32
3057.835056,59,71,0.41,12,0.034166667,32
3057.792695,56,77,0.59,21,0.028095238,32
3057.769376,57,81,0.65,24,0.027083333,32
3057.720557,68,97,0.54,29,0.01862069,32
3057.705818,56,89,0.67,33,0.02030303,32
3057.587676,56,89,0.85,33,0.025757576,32
3057.587676,55,91,0.92,36,0.025555556,32
3057.587676,54,92,0.97,38,0.025526316,32
3057.36535,59,73,0.41,14,0.029285714,32
3056.908988,51,84,0.9,33,0.027272727,32
3056.630033,55,89,0.94,34,0.027647059,32
3056.340416,62,78,0.46,16,0.02875,32
3056.340416,59,82,0.66,23,0.028695652,32
3056.314222,56,88,0.89,32,0.0278125,32
3056.226215,61,78,0.49,17,0.028823529,32
3055.423833,53,57,0.1,4,0.025,32
3054.955273,55,91,0.95,36,0.026388889,32
3054.530835,69,97,0.51,28,0.018214286,32
3054.080243,34,53,0.71,19,0.037368421,32
3053.988912,61,81,0.52,20,0.026,32
3053.936226,55,89,0.93,34,0.027352941,32
3053.818979,59,72,0.39,13,0.03,32
3053.604037,50,82,0.98,32,0.030625,32
3053.192595,58,79,0.57,21,0.027142857,32
3052.994076,51,82,0.88,31,0.028387097,32
3052.961445,63,72,0.26,9,0.028888889,32
3052.950124,34,56,0.86,22,0.039090909,32
3052.890157,46,50,0.15,4,0.0375,32
3052.763016,55,89,0.87,34,0.025588235,32
3052.763016,54,91,0.94,37,0.025405405,32
3052.573012,53,89,0.95,36,0.026388889,32
3052.307201,67,98,0.58,31,0.018709677,32
3052.296221,54,85,0.83,31,0.026774194,32
3052.200472,50,83,0.95,33,0.028787879,32
3052.172931,58,82,0.66,24,0.0275,32
3052.079435,49,58,0.24,9,0.026666667,32
3051.958449,73,92,0.35,19,0.018421053,32
3051.75043,35,56,0.72,21,0.034285714,32
3051.386178,61,71,0.29,10,0.029,32
3051.384175,50,62,0.34,12,0.028333333,32
3051.274889,56,88,0.83,32,0.0259375,32
3051.274889,54,90,0.94,36,0.026111111,32
3051.143297,59,79,0.54,20,0.027,32
3051.140885,55,91,0.91,36,0.025277778,32
3050.979965,74,91,0.3,17,0.017647059,32
3050.931233,47,60,0.35,13,0.026923077,32
3050.560394,59,83,0.7,24,0.029166667,32
3050.362559,45,55,0.33,10,0.033,32
3050.249179,37,57,0.77,20,0.0385,32
3050.062232,51,83,0.92,32,0.02875,32
3050.062232,50,84,0.98,34,0.028823529,32
3050.021129,60,84,0.62,24,0.025833333,32
3049.423065,59,85,0.68,26,0.026153846,32
3049.423065,58,87,0.75,29,0.025862069,32
3049.071556,44,53,0.33,9,0.036666667,32
3049.039187,40,58,0.66,18,0.036666667,32
3049.018655,42,72,0.94,30,0.031333333,32
3048.82477,60,76,0.44,16,0.0275,32
3048.82477,58,78,0.55,20,0.0275,32
3048.765324,55,84,0.77,29,0.026551724,32
3048.677926,43,51,0.3,8,0.0375,32
3048.216116,57,72,0.5,15,0.033333333,32
3047.726559,49,60,0.28,11,0.025454545,32
3047.657105,55,90,0.94,35,0.026857143,32
3047.619478,54,83,0.8,29,0.027586207,32
3047.444727,75,89,0.26,14,0.018571429,32
3046.501641,58,83,0.72,25,0.0288,32
3046.33941,53,82,0.8,29,0.027586207,32
3046.145998,50,59,0.23,9,0.025555556,32
3046.094997,55,89,0.99,34,0.029117647,32
3046.043369,53,79,0.77,26,0.029615385,32
3046.043369,52,80,0.83,28,0.029642857,32
3045.741387,48,51,0.1,3,0.033333333,32
3045.724684,58,86,0.57,28,0.020357143,32
3045.621679,43,54,0.4,11,0.036363636,32
3045.562325,53,79,0.76,26,0.029230769,32
3045.562325,50,83,0.96,33,0.029090909,32
3045.269443,55,92,0.93,37,0.025135135,32
3045.249268,55,88,0.92,33,0.027878788,32
3045.190852,53,87,0.9,34,0.026470588,32
3045.097013,55,90,0.71,35,0.020285714,32
3045.029918,59,73,0.46,14,0.032857143,32
3045.029918,56,76,0.66,20,0.033,32
3044.851258,63,79,0.45,16,0.028125,32
3044.841575,55,88,0.93,33,0.028181818,32
3044.567325,64,75,0.32,11,0.029090909,32
3044.567325,63,76,0.38,13,0.029230769,32
3044.567325,61,79,0.52,18,0.028888889,32
3044.567325,60,80,0.58,20,0.029,32
3044.567325,59,81,0.64,22,0.029090909,32
3044.527595,56,76,0.58,20,0.029,32
3044.527595,55,77,0.64,22,0.029090909,32
3044.517811,54,78,0.71,24,0.029583333,32
3044.45355,63,75,0.35,12,0.029166667,32
3044.253388,63,72,0.25,9,0.027777778,32
3044.24183,56,80,0.69,24,0.02875,32
3044.037001,54,78,0.7,24,0.029166667,32
3044.037001,53,80,0.78,27,0.028888889,32
3044.037001,52,81,0.84,29,0.028965517,32
3044.037001,51,82,0.9,31,0.029032258,32
3043.358819,59,84,0.7,25,0.028,32
3043.358819,58,86,0.78,28,0.027857143,32
3043.047703,56,87,0.87,31,0.028064516,32
3042.954513,61,73,0.34,12,0.028333333,32
3042.908281,60,81,0.6,21,0.028571429,32
3042.905141,57,86,0.81,29,0.027931034,32
3042.765726,61,80,0.54,19,0.028421053,32
3042.765726,57,85,0.79,28,0.028214286,32
3042.751398,56,72,0.54,16,0.03375,32
3042.558912,39,48,0.36,9,0.04,32
3042.558912,38,49,0.44,11,0.04,32
3042.4848,82,91,0.14,9,0.015555556,32
3042.475486,65,72,0.19,7,0.027142857,32
3042.425237,51,83,0.91,32,0.0284375,32
3042.210108,64,69,0.14,5,0.028,32
3042.210108,58,75,0.48,17,0.028235294,32
3042.014971,72,93,0.39,21,0.018571429,32
3041.98891,55,77,0.63,22,0.028636364,32
3041.924444,32,57,0.93,25,0.0372,32
3041.529565,54,82,0.81,28,0.028928571,32
3041.512732,60,73,0.38,13,0.029230769,32
3041.49155,36,54,0.62,18,0.034444444,32
3040.805058,41,57,0.55,16,0.034375,32
3040.558779,42,69,0.92,27,0.034074074,32
3040.496208,50,86,0.98,36,0.027222222,32
3040.452952,61,73,0.35,12,0.029166667,32
3040.452952,60,74,0.41,14,0.029285714,32
3040.398156,43,54,0.41,11,0.037272727,32
3040.321299,54,80,0.72,26,0.027692308,32
3040.321299,53,81,0.78,28,0.027857143,32
3040.321299,51,84,0.91,33,0.027575758,32
3040.253072,50,84,0.96,34,0.028235294,32
3039.510159,57,76,0.55,19,0.028947368,32
3039.510159,56,77,0.61,21,0.029047619,32
3039.405835,62,74,0.34,12,0.028333333,32
3039.337647,39,61,0.76,22,0.034545455,32
3039.160307,47,54,0.22,7,0.031428571,32
3038.761936,58,80,0.59,22,0.026818182,32
3038.718667,62,79,0.49,17,0.028823529,32
3038.593811,56,73,0.57,17,0.033529412,32
3038.320091,40,45,0.21,5,0.042,32
3038.089898,42,71,0.95,29,0.032758621,32
3038.052036,60,77,0.46,17,0.027058824,32
3038.019897,46,52,0.2,6,0.033333333,32
3037.996316,53,81,0.8,28,0.028571429,32
3037.995999,53,86,0.89,33,0.026969697,32
3037.506741,52,82,0.86,30,0.028666667,32
3037.483866,56,76,0.57,20,0.0285,32
3037.141951,58,86,0.72,28,0.025714286,32
3036.988961,63,79,0.42,16,0.02625,32
3036.940852,54,78,0.72,24,0.03,32
3036.899991,45,52,0.26,7,0.037142857,32
3036.856214,56,79,0.67,23,0.029130435,32
3036.838624,59,76,0.49,17,0.028823529,32
3036.762398,66,75,0.26,9,0.028888889,32
3036.697041,58,86,0.77,28,0.0275,32
3036.697041,56,89,0.9,33,0.027272727,32
3036.553958,42,71,0.97,29,0.033448276,32
3036.427014,56,88,0.66,32,0.020625,32
3036.425035,57,78,0.59,21,0.028095238,32
3036.347988,54,86,0.89,32,0.0278125,32
3036.327449,60,74,0.4,14,0.028571429,32
3036.294033,56,84,0.77,28,0.0275,32
3036.294033,54,87,0.9,33,0.027272727,32
3035.898325,51,84,0.93,33,0.028181818,32
3035.719765,56,90,0.87,34,0.025588235,32
3035.677737,60,75,0.43,15,0.028666667,32
3035.615515,54,81,0.75,27,0.027777778,32
3035.615515,53,82,0.81,29,0.027931034,32
3035.440972,73,98,0.41,25,0.0164,32
3035.418673,54,77,0.71,23,0.030869565,32
3035.301303,70,94,0.45,24,0.01875,32
3035.301303,69,96,0.5,27,0.018518519,32
3035.292238,56,81,0.68,25,0.0272,32
3035.292238,55,81,0.72,26,0.027692308,32
3035.066426,59,77,0.51,18,0.028333333,32
3035.057108,64,71,0.2,7,0.028571429,32
3035.041758,41,56,0.55,15,0.036666667,32
3034.803084,54,83,0.79,29,0.027241379,32
3034.752499,36,71,0.93,35,0.026571429,32
3034.720686,33,58,0.97,25,0.0388,32
3034.489274,52,83,0.85,31,0.027419355,32
3034.043577,58,83,0.71,25,0.0284,32
3033.90984,59,78,0.52,19,0.027368421,32
3033.729513,58,86,0.73,28,0.026071429,32
3033.729513,57,88,0.8,31,0.025806452,32
3033.702191,56,89,0.86,33,0.026060606,32
3033.597421,62,82,0.58,20,0.029,32
3033.569684,47,67,0.5,20,0.025,32
3033.283379,59,83,0.64,24,0.026666667,32
3033.140037,61,81,0.56,20,0.028,32
3033.001055,62,79,0.48,17,0.028235294,32
3032.885581,56,88,0.88,32,0.0275,32
3032.81829,65,71,0.17,6,0.028333333,32
3032.319844,57,87,0.83,30,0.027666667,32
3032.31677,55,90,0.96,35,0.027428571,32
3032.24813,44,54,0.37,10,0.037,32
3032.153083,40,46,0.23,6,0.038333333,32
3031.90088,60,75,0.42,15,0.028,32
3031.814057,37,53,0.6,16,0.0375,32
3031.716286,45,54,0.3,9,0.033333333,32
3031.537779,33,54,0.79,21,0.037619048,32
3031.173977,56,80,0.68,24,0.028333333,32
3031.118388,64,79,0.39,15,0.026,32
3031.101386,59,83,0.67,24,0.027916667,32
3031.101386,56,87,0.86,31,0.027741935,32
3030.942388,58,81,0.67,23,0.029130435,32
3030.942388,57,82,0.73,25,0.0292,32
3030.942388,56,83,0.79,27,0.029259259,32
3030.942388,56,84,0.81,28,0.028928571,32
3030.942388,55,85,0.87,30,0.029,32
3030.922863,52,88,0.96,36,0.026666667,32
3030.869324,54,93,0.99,39,0.025384615,32
3030.584877,42,53,0.4,11,0.036363636,32
3030.57771,51,82,0.89,31,0.028709677,32
3030.431206,58,76,0.52,18,0.028888889,32
3030.325253,52,82,0.84,30,0.028,32
3030.325253,51,83,0.9,32,0.028125,32
3030.325253,50,85,0.97,35,0.027714286,32
3030.204369,52,86,0.93,34,0.027352941,32
3030.204369,51,87,0.99,36,0.0275,32
3029.812044,56,85,0.83,29,0.02862069,32
3029.812044,56,86,0.85,30,0.028333333,32
3029.812044,55,86,0.89,31,0.028709677,32
3029.812044,55,87,0.91,32,0.0284375,32
3029.670083,57,84,0.77,27,0.028518519,32
3029.587485,56,89,0.84,33,0.025454545,32
3029.381583,42,55,0.48,13,0.036923077,32
3029.353546,43,56,0.43,13,0.033076923,32
3028.882151,55,90,0.91,35,0.026,32
3028.882151,54,92,0.98,38,0.025789474,32
3028.692454,39,60,0.72,21,0.034285714,32
3028.524718,40,60,0.69,20,0.0345,32
3028.456403,54,81,0.79,27,0.029259259,32
3028.414937,51,86,0.95,35,0.027142857,32
3028.413628,35,57,0.75,22,0.034090909,32
3028.385074,37,54,0.62,17,0.036470588,32
3028.376528,53,83,0.87,30,0.029,32
3028.352336,37,54,0.63,17,0.037058824,32
3028.271457,52,87,0.94,35,0.026857143,32
3028.236073,77,86,0.17,9,0.018888889,32
3027.863792,39,69,0.96,30,0.032,32
3027.626582,63,80,0.44,17,0.025882353,32
3027.464424,60,82,0.58,22,0.026363636,32
3027.464424,58,85,0.71,27,0.026296296,32
3027.464424,57,86,0.76,29,0.026206897,32
3027.464424,56,87,0.82,31,0.026451613,32
3027.264176,54,84,0.82,30,0.027333333,32
3027.035608,38,51,0.46,13,0.035384615,32
3026.901462,36,50,0.54,14,0.038571429,32
3026.439637,61,64,0.09,3,0.03,32
3026.439637,60,65,0.15,5,0.03,32
3026.439637,59,66,0.21,7,0.03,32
3026.439637,58,67,0.27,9,0.03,32
3026.434884,62,75,0.35,13,0.026923077,32
3026.429119,54,92,0.96,38,0.025263158,32
3026.357826,57,79,0.62,22,0.028181818,32
3026.330567,55,81,0.74,26,0.028461538,32
3025.916665,48,55,0.19,7,0.027142857,32
3025.750413,56,90,0.96,34,0.028235294,32
3025.616198,63,71,0.23,8,0.02875,32
3025.616198,59,75,0.46,16,0.02875,32
3025.39989,57,89,0.65,32,0.0203125,32
3025.351461,45,53,0.29,8,0.03625,32
3025.245591,35,51,0.61,16,0.038125,32
3025.210968,57,85,0.8,28,0.028571429,32
3025.167624,44,55,0.36,11,0.032727273,32
3025.110035,67,99,0.59,32,0.0184375,32
3024.809274,58,78,0.57,20,0.0285,32
3024.789701,52,58,0.15,6,0.025,32
3024.734747,48,53,0.16,5,0.032,32
3024.72936,53,82,0.84,29,0.028965517,32
3024.702375,63,81,0.52,18,0.028888889,32
3024.569693,43,55,0.44,12,0.036666667,32
3024.260208,36,55,0.7,19,0.036842105,32
3024.178551,57,86,0.83,29,0.02862069,32
3024.178551,56,87,0.89,31,0.028709677,32
3024.087047,74,91,0.31,17,0.018235294,32
3023.915259,53,80,0.79,27,0.029259259,32
3023.836633,53,84,0.86,31,0.027741935,32
3023.823473,50,86,0.99,36,0.0275,32
3023.742282,39,50,0.39,11,0.035454545,32
3023.492344,57,77,0.58,20,0.029,32
3023.443679,56,88,0.93,32,0.0290625,32
3023.443385,59,87,0.56,28,0.02,32
3023.363714,55,87,0.94,32,0.029375,32
3023.327135,42,56,0.51,14,0.036428571,32
3023.216645,53,87,0.95,34,0.027941176,32
3022.945874,57,76,0.54,19,0.028421053,32
3022.803549,61,79,0.53,18,0.029444444,32
3022.740844,54,88,0.93,34,0.027352941,32
3022.740844,53,89,0.99,36,0.0275,32
3022.639506,61,81,0.58,20,0.029,32
3022.639506,60,82,0.64,22,0.029090909,32
3022.639506,56,87,0.9,31,0.029032258,32
3022.272617,36,51,0.57,15,0.038,32
3022.180745,68,98,0.55,30,0.018333333,32
3022.007704,57,82,0.67,25,0.0268,32
3022.007704,56,83,0.72,27,0.026666667,32
3022.007704,55,84,0.78,29,0.026896552,32
3021.748708,45,70,0.62,25,0.0248,32
3021.391852,58,84,0.68,26,0.026153846,32
3021.391852,57,86,0.75,29,0.025862069,32
3021.381375,59,75,0.47,16,0.029375,32
3021.381375,58,76,0.53,18,0.029444444,32
3021.381375,57,77,0.59,20,0.0295,32
3021.381375,56,78,0.65,22,0.029545455,32
3021.231934,59,83,0.68,24,0.028333333,32
3021.231934,58,84,0.74,26,0.028461538,32
3021.141233,41,60,0.62,19,0.032631579,32
3021.031047,68,97,0.53,29,0.018275862,32
3020.92956,54,82,0.8,28,0.028571429,32
3020.668015,61,82,0.58,21,0.027619048,32
3020.596257,61,75,0.39,14,0.027857143,32
3020.480766,57,79,0.63,22,0.028636364,32
3020.400233,76,87,0.2,11,0.018181818,32
3020.318584,56,78,0.63,22,0.028636364,32
3020.318584,55,78,0.67,23,0.029130435,32
3020.282203,63,78,0.4,15,0.026666667,32
3020.282203,60,81,0.56,21,0.026666667,32
3020.282203,59,82,0.62,23,0.026956522,32
3020.282203,56,86,0.8,30,0.026666667,32
3020.254998,57,85,0.75,28,0.026785714,32
3020.212386,52,84,0.9,32,0.028125,32
3020.189219,55,80,0.72,25,0.0288,32
3020.189219,54,81,0.78,27,0.028888889,32
3020.178625,58,85,0.7,27,0.025925926,32
3020.178625,56,88,0.82,32,0.025625,32
3020.178625,55,89,0.88,34,0.025882353,32
3020.178625,54,91,0.95,37,0.025675676,32
3019.9461,63,77,0.4,14,0.028571429,32
3019.882268,61,76,0.41,15,0.027333333,32
3019.77456,57,78,0.6,21,0.028571429,32
3019.62192,58,85,0.76,27,0.028148148,32
3019.604427,56,89,0.91,33,0.027575758,32
3019.509332,51,84,0.94,33,0.028484848,32
3019.391853,65,66,0.03,1,0.03,32
3019.391853,64,67,0.09,3,0.03,32
3019.391853,63,68,0.15,5,0.03,32
3019.391853,62,69,0.21,7,0.03,32
3019.391853,61,70,0.27,9,0.03,32
3019.384534,55,85,0.79,30,0.026333333,32
3019.2777,62,81,0.39,19,0.020526316,32
3019.264109,40,53,0.51,13,0.039230769,32
3019.176638,66,70,0.11,4,0.0275,32
3019.176638,64,72,0.22,8,0.0275,32
3019.171669,60,82,0.62,22,0.028181818,32
3018.897862,52,89,0.97,37,0.026216216,32
3018.896335,65,67,0.06,2,0.03,32
3018.896335,64,68,0.12,4,0.03,32
3018.896335,63,69,0.18,6,0.03,32
3018.896335,62,70,0.24,8,0.03,32
3018.896335,61,71,0.3,10,0.03,32
3018.896335,60,72,0.36,12,0.03,32
3018.896335,59,73,0.42,14,0.03,32
3018.896335,58,74,0.48,16,0.03,32
3018.896335,57,75,0.54,18,0.03,32
3018.793313,57,87,0.82,30,0.027333333,32
3018.793313,57,88,0.84,31,0.027096774,32
3018.793313,55,90,0.95,35,0.027142857,32
3018.703563,71,93,0.41,22,0.018636364,32
3018.627611,54,82,0.76,28,0.027142857,32
3018.071832,60,80,0.57,20,0.0285,32
3018.071832,59,81,0.63,22,0.028636364,32
3018.071832,59,82,0.65,23,0.02826087,32
3018.022087,51,85,0.93,34,0.027352941,32
3017.838872,40,61,0.69,21,0.032857143,32
3017.827119,66,99,0.61,33,0.018484848,32
3017.80648,55,80,0.73,25,0.0292,32
3017.772291,61,72,0.32,11,0.029090909,32
3017.764983,52,81,0.86,29,0.029655172,32
3017.764983,51,82,0.92,31,0.029677419,32
3017.508017,57,77,0.57,20,0.0285,32
3017.465433,61,77,0.43,16,0.026875,32
3017.458886,53,84,0.85,31,0.027419355,32
3017.458886,51,86,0.96,35,0.027428571,32
3017.409827,40,66,0.87,26,0.033461538,32
3017.297088,54,76,0.75,22,0.034090909,32
3017.297088,53,77,0.82,24,0.034166667,32
3017.247713,55,85,0.83,30,0.027666667,32
3017.247713,53,88,0.96,35,0.027428571,32
3017.22117,41,49,0.29,8,0.03625,32
3017.11091,54,87,0.89,33,0.026969697,32
3017.083732,53,88,0.95,35,0.027142857,32
3017.051152,57,86,0.77,29,0.026551724,32
3016.690513,54,84,0.81,30,0.027,32
3016.6839,58,82,0.69,24,0.02875,32
3016.625501,33,59,0.97,26,0.037307692,32
3016.60303,57,82,0.59,25,0.0236,32
3016.559536,59,74,0.43,15,0.028666667,32
3016.381619,62,81,0.5,19,0.026315789,32
3016.374977,55,85,0.85,30,0.028333333,32
3016.320435,36,50,0.58,14,0.041428571,32
3016.320435,34,53,0.78,19,0.041052632,32
3016.306098,63,77,0.41,14,0.029285714,32
3016.306098,62,78,0.47,16,0.029375,32
3016.306098,61,80,0.55,19,0.028947368,32
3016.306098,60,81,0.61,21,0.029047619,32
3016.306098,59,82,0.67,23,0.029130435,32
3016.306098,58,83,0.73,25,0.0292,32
3016.079809,55,79,0.7,24,0.029166667,32
3016.079809,54,80,0.76,26,0.029230769,32
3015.967596,58,73,0.45,15,0.03,32
3015.899063,35,51,0.64,16,0.04,32
3015.861843,61,82,0.43,21,0.02047619,32
3015.769622,64,70,0.17,6,0.028333333,32
3015.695194,44,68,0.81,24,0.03375,32
3015.695194,43,69,0.88,26,0.033846154,32
3015.677603,59,84,0.71,25,0.0284,32
3015.3581,53,82,0.85,29,0.029310345,32
3015.3581,52,83,0.91,31,0.029354839,32
3014.975943,61,74,0.37,13,0.028461538,32
3014.975943,58,77,0.54,19,0.028421053,32
3014.836446,58,88,0.6,30,0.02,32
3014.585274,56,76,0.6,20,0.03,32
3014.487393,58,84,0.69,26,0.026538462,32
3014.487393,55,88,0.87,33,0.026363636,32
3014.452437,53,81,0.81,28,0.028928571,32
3014.368668,60,76,0.45,16,0.028125,32
3014.26149,56,90,0.69,34,0.020294118,32
3013.904238,61,71,0.33,10,0.033,32
3013.55399,56,86,0.86,30,0.028666667,32
3013.55399,55,87,0.92,32,0.02875,32
3013.452006,57,88,0.63,31,0.020322581,32
3013.335689,63,74,0.3,11,0.027272727,32
3013.27306,56,78,0.64,22,0.029090909,32
3013.182921,59,85,0.53,26,0.020384615,32
3013.165723,53,85,0.86,32,0.026875,32
3013.097599,57,86,0.82,29,0.028275862,32
3012.72119,35,57,0.79,22,0.035909091,32
3012.486626,66,99,0.62,33,0.018787879,32
3012.373251,52,86,0.92,34,0.027058824,32
3012.080876,62,71,0.26,9,0.028888889,32
3011.92337,56,78,0.62,22,0.028181818,32
3011.728133,62,73,0.31,11,0.028181818,32
3011.666175,55,88,0.88,33,0.026666667,32
3011.617147,50,84,0.97,34,0.028529412,32
3011.614608,52,80,0.86,28,0.030714286,32
3011.414893,53,71,0.63,18,0.035,32
3011.404126,59,74,0.42,15,0.028,32
3011.285399,50,83,0.98,33,0.02969697,32
3011.262342,54,90,0.95,36,0.026388889,32
3011.08694,61,77,0.47,16,0.029375,32
3011.08694,60,78,0.53,18,0.029444444,32
3010.975776,43,70,0.88,27,0.032592593,32
3010.945828,62,76,0.41,14,0.029285714,32
3010.93925,79,91,0.2,12,0.016666667,32
3010.93925,76,94,0.3,18,0.016666667,32
3010.92919,63,69,0.17,6,0.028333333,32
3010.494257,35,52,0.65,17,0.038235294,32
3010.480031,72,92,0.37,20,0.0185,32
3010.390772,59,74,0.44,15,0.029333333,32
3010.390772,58,75,0.5,17,0.029411765,32
3010.390772,57,76,0.56,19,0.029473684,32
3010.390772,56,77,0.62,21,0.02952381,32
3010.390772,55,78,0.68,23,0.029565217,32
3010.390772,54,79,0.74,25,0.0296,32
3010.390772,53,80,0.8,27,0.02962963,32
3010.249441,55,89,0.95,34,0.027941176,32
3010.124535,39,51,0.42,12,0.035,32
3010.076633,51,82,0.93,31,0.03,32
3009.930001,33,58,0.95,25,0.038,32
3009.884788,74,96,0.37,22,0.016818182,32
3009.884788,72,99,0.45,27,0.016666667,32
3009.808167,64,77,0.35,13,0.026923077,32
3009.808167,62,80,0.48,18,0.026666667,32
3009.791087,60,80,0.59,20,0.0295,32
3009.791087,59,81,0.65,22,0.029545455,32
3009.791087,58,82,0.71,24,0.029583333,32
3009.702227,54,87,0.95,33,0.028787879,32
3009.634893,52,82,0.87,30,0.029,32
3009.605511,55,80,0.7,25,0.028,32
3009.112616,38,48,0.39,10,0.039,32
3009.023552,52,80,0.85,28,0.030357143,32
3008.930382,58,78,0.56,20,0.028,32
3008.912008,37,70,0.87,33,0.026363636,32
3008.726768,66,73,0.16,7,0.022857143,32
3008.573338,68,98,0.54,30,0.018,32
3007.674727,46,65,0.64,19,0.033684211,32
3007.646291,60,79,0.56,19,0.029473684,32
3007.60313,52,85,0.9,33,0.027272727,32
3007.594898,57,86,0.8,29,0.027586207,32
3007.589447,41,58,0.61,17,0.035882353,32
3007.554955,61,74,0.36,13,0.027692308,32
3007.231826,56,87,0.81,31,0.026129032,32
3007.220527,45,53,0.27,8,0.03375,32
3007.219558,52,85,0.93,33,0.028181818,32
3007.219558,51,86,0.99,35,0.028285714,32
3007.207748,52,86,0.91,34,0.026764706,32
3006.837187,53,86,0.88,33,0.026666667,32
3006.837187,52,87,0.93,35,0.026571429,32
3006.724157,61,75,0.4,14,0.028571429,32
3006.62832,54,91,0.96,37,0.025945946,32
3006.509555,55,80,0.71,25,0.0284,32
3006.501582,63,80,0.35,17,0.020588235,32
3006.501149,59,79,0.58,20,0.029,32
3006.501149,58,80,0.64,22,0.029090909,32
3006.482469,51,85,0.97,34,0.028529412,32
3006.476818,55,89,0.89,34,0.026176471,32
3006.433765,46,55,0.29,9,0.032222222,32
3006.312679,46,68,0.55,22,0.025,32
3006.052736,42,54,0.42,12,0.035,32
3005.926674,55,92,0.94,37,0.025405405,32
3005.70583,58,74,0.53,16,0.033125,32
3005.608673,52,84,0.88,32,0.0275,32
3005.328904,58,79,0.59,21,0.028095238,32
3005.024879,69,72,0.08,3,0.026666667,32
3005.024879,66,75,0.24,9,0.026666667,32
3004.812666,36,52,0.58,16,0.03625,32
3004.752767,52,84,0.93,32,0.0290625,32
3004.751914,45,66,0.72,21,0.034285714,32
3004.7343,54,86,0.85,32,0.0265625,32
3004.705939,67,99,0.58,32,0.018125,32
3004.682075,76,89,0.23,13,0.017692308,32
3004.612986,56,88,0.91,32,0.0284375,32
3004.586537,47,64,0.43,17,0.025294118,32
3004.568207,44,52,0.28,8,0.035,32
3004.199578,45,56,0.35,11,0.031818182,32
3004.178568,58,85,0.56,27,0.020740741,32
3004.090994,53,83,0.81,30,0.027,32
3004.072588,68,96,0.53,28,0.018928571,32
3004.018744,51,87,0.98,36,0.027222222,32
3004.016264,55,79,0.71,24,0.029583333,32
3003.990914,39,70,0.99,31,0.031935484,32
3003.98524,60,83,0.6,23,0.026086957,32
3003.918773,39,47,0.31,8,0.03875,32
3003.837279,42,58,0.53,16,0.033125,32
3003.830708,61,83,0.45,22,0.020454545,32
3003.635131,56,81,0.69,25,0.0276,32
3003.336483,51,81,0.92,30,0.030666667,32
3002.533574,51,88,0.99,37,0.026756757,32
3002.518647,59,86,0.55,27,0.02037037,32
3002.498337,57,77,0.56,20,0.028,32
3002.368422,39,50,0.43,11,0.039090909,32
3002.304311,69,95,0.49,26,0.018846154,32
3002.274129,54,79,0.73,25,0.0292,32
3002.178474,56,80,0.66,24,0.0275,32
3002.158315,53,80,0.76,27,0.028148148,32
3002.125071,59,77,0.5,18,0.027777778,32
3001.985773,60,84,0.49,24,0.020416667,32
3001.851566,53,83,0.86,30,0.028666667,32
3001.851566,52,84,0.92,32,0.02875,32
3001.831867,53,84,0.84,31,0.027096774,32
3001.831867,51,87,0.97,36,0.026944444,32
3001.732821,56,86,0.88,30,0.029333333,32
3001.679773,32,58,0.98,26,0.037692308,32
3001.596585,54,80,0.78,26,0.03,32
3001.471194,45,59,0.38,14,0.027142857,32
3001.448089,60,78,0.52,18,0.028888889,32
3001.408037,58,86,0.76,28,0.027142857,32
3001.408037,57,88,0.83,31,0.026774194,32
3001.408037,56,89,0.89,33,0.026969697,32
3001.408037,55,91,0.96,36,0.026666667,32
3000.589457,40,48,0.29,8,0.03625,32
3000.58007,57,84,0.78,27,0.028888889,32
3000.58007,56,85,0.84,29,0.028965517,32
3000.58007,54,88,0.98,34,0.028823529,32
3000.187498,56,79,0.64,23,0.027826087,32
3000.10936,62,74,0.33,12,0.0275,32
2999.858076,43,70,0.89,27,0.032962963,32
2999.629583,59,72,0.4,13,0.030769231,32
2999.473704,59,83,0.63,24,0.02625,32
2999.4191,67,75,0.21,8,0.02625,32
2999.349862,51,84,0.98,33,0.02969697,32
2999.258404,61,81,0.53,20,0.0265,32
2998.944232,54,89,0.99,35,0.028285714,32
2998.934872,32,58,0.91,26,0.035,32
2998.877015,52,86,0.96,34,0.028235294,32
2998.822934,65,70,0.14,5,0.028,32
2998.789072,55,77,0.66,22,0.03,32
2998.673985,58,82,0.7,24,0.029166667,32
2998.673985,57,83,0.76,26,0.029230769,32
2998.673985,55,86,0.9,31,0.029032258,32
2998.673985,54,87,0.96,33,0.029090909,32
2998.560187,57,87,0.87,30,0.029,32
2998.293574,52,81,0.82,29,0.028275862,32
2998.262022,50,85,0.99,35,0.028285714,32
2997.912232,38,50,0.44,12,0.036666667,32
2997.710505,76,96,0.33,20,0.0165,32
2997.611947,59,76,0.48,17,0.028235294,32
2997.61096,45,67,0.73,22,0.033181818,32
2997.481794,57,84,0.79,27,0.029259259,32
2997.481794,56,86,0.87,30,0.029,32
2997.481794,55,87,0.93,32,0.0290625,32
2997.309437,53,82,0.86,29,0.029655172,32
2997.309437,52,83,0.92,31,0.029677419,32
2997.247218,57,79,0.6,22,0.027272727,32
2997.247218,55,81,0.71,26,0.027307692,32
2997.031461,52,83,0.9,31,0.029032258,32
2997.031461,51,84,0.96,33,0.029090909,32
2997.008057,63,73,0.28,10,0.028,32
2997.008057,60,77,0.47,17,0.027647059,32
2997.008057,57,80,0.64,23,0.027826087,32
2997.008057,56,81,0.7,25,0.028,32
2996.754139,57,87,0.77,30,0.025666667,32
2996.652341,34,54,0.79,20,0.0395,32
2996.50312,66,78,0.34,12,0.028333333,32
2996.488758,57,83,0.75,26,0.028846154,32
2996.189727,58,69,0.38,11,0.034545455,32
2996.17862,50,84,0.95,34,0.027941176,32
2996.101023,59,69,0.34,10,0.034,32
2996.101023,55,74,0.64,19,0.033684211,32
2996.101023,54,75,0.71,21,0.033809524,32
2995.934344,54,82,0.79,28,0.028214286,32
2995.934344,53,83,0.85,30,0.028333333,32
2995.845497,55,79,0.69,24,0.02875,32
2995.783489,57,80,0.62,23,0.026956522,32
2995.74239,60,74,0.39,14,0.027857143,32
2995.559177,71,94,0.42,23,0.01826087,32
2995.506264,53,91,0.79,38,0.020789474,32
2995.391765,39,68,0.95,29,0.032758621,32
2995.299332,51,83,0.95,32,0.0296875,32
2995.259407,58,77,0.52,19,0.027368421,32
2995.259407,57,78,0.58,21,0.027619048,32
2995.259407,55,80,0.69,25,0.0276,32
2995.248253,70,95,0.45,25,0.018,32
2995.169046,57,80,0.65,23,0.02826087,32
2995.033205,67,75,0.22,8,0.0275,32
2995.031156,65,77,0.25,12,0.020833333,32
2994.938641,73,96,0.39,23,0.016956522,32
2994.90348,59,84,0.52,25,0.0208,32
2994.824584,36,50,0.55,14,0.039285714,32
2994.584429,53,84,0.88,31,0.028387097,32
2994.584429,52,85,0.94,33,0.028484848,32
2994.500366,42,62,0.54,20,0.027,32
2994.488217,60,79,0.55,19,0.028947368,32
2994.472809,47,63,0.55,16,0.034375,32
2994.472809,46,64,0.62,18,0.034444444,32
2994.405551,67,76,0.26,9,0.028888889,32
2994.405551,62,82,0.57,20,0.0285,32
2994.405551,61,83,0.63,22,0.028636364,32
2994.405551,60,84,0.69,24,0.02875,32
2994.285839,35,55,0.78,20,0.039,32
2994.211864,53,85,0.88,32,0.0275,32
2994.1477,40,57,0.63,17,0.037058824,32
2993.982294,37,50,0.49,13,0.037692308,32
2993.924932,33,58,0.96,25,0.0384,32
2993.88707,40,51,0.37,11,0.033636364,32
2993.526637,60,86,0.52,26,0.02,32
2993.487822,56,78,0.61,22,0.027727273,32
2993.377745,57,76,0.58,19,0.030526316,32
2993.372116,78,91,0.22,13,0.016923077,32
2993.372116,75,94,0.32,19,0.016842105,32
2993.372116,73,97,0.4,24,0.016666667,32
2993.368702,53,81,0.84,28,0.03,32
2993.293234,38,52,0.5,14,0.035714286,32
2993.130928,50,83,0.99,33,0.03,32
2993.093836,57,82,0.74,25,0.0296,32
2993.093836,56,83,0.8,27,0.02962963,32
2993.093836,55,84,0.86,29,0.029655172,32
2993.046193,59,74,0.45,15,0.03,32
2993.001848,58,75,0.49,17,0.028823529,32
2992.910684,58,84,0.75,26,0.028846154,32
2992.910684,57,85,0.81,28,0.028928571,32
2992.824502,56,84,0.79,28,0.028214286,32
2992.769417,55,89,0.9,34,0.026470588,32
2992.769417,54,89,0.94,35,0.026857143,32
2992.769417,54,90,0.96,36,0.026666667,32
2992.718189,52,85,0.91,33,0.027575758,32
2992.606664,61,72,0.31,11,0.028181818,32
2992.554911,43,69,0.86,26,0.033076923,32
2992.548906,53,81,0.82,28,0.029285714,32
2992.547794,34,59,0.84,25,0.0336,32
2992.503285,55,91,0.97,36,0.026944444,32
2992.323608,71,99,0.47,28,0.016785714,32
2992.140959,61,80,0.51,19,0.026842105,32
2992.127707,56,80,0.65,24,0.027083333,32
2992.12417,58,76,0.5,18,0.027777778,32
2991.977583,61,75,0.38,14,0.027142857,32
2991.977583,59,77,0.49,18,0.027222222,32
2991.723066,45,55,0.32,10,0.032,32
2991.558225,64,76,0.27,12,0.0225,32
2991.495187,55,82,0.73,27,0.027037037,32
2991.143956,40,59,0.68,19,0.035789474,32
2991.109722,56,88,0.92,32,0.02875,32
2991.109722,55,89,0.98,34,0.028823529,32
2991.038098,54,81,0.8,27,0.02962963,32
2990.999193,40,68,0.9,28,0.032142857,32
2990.999193,39,69,0.97,30,0.032333333,32
2990.995991,60,78,0.49,18,0.027222222,32
2990.760093,33,56,0.81,23,0.035217391,32
2990.742663,58,75,0.51,17,0.03,32
2990.509476,62,75,0.36,13,0.027692308,32
2990.43759,52,84,0.87,32,0.0271875,32
2990.128925,57,87,0.85,30,0.028333333,32
2990.063071,57,85,0.74,28,0.026428571,32
2989.925739,55,82,0.75,27,0.027777778,32
2989.925739,54,83,0.81,29,0.027931034,32
2989.925739,53,84,0.87,31,0.028064516,32
2989.925739,52,85,0.92,33,0.027878788,32
2989.925739,51,86,0.98,35,0.028,32
2989.904347,55,83,0.75,28,0.026785714,32
2989.719566,51,83,0.93,32,0.0290625,32
2989.719566,50,84,0.99,34,0.029117647,32
2989.634906,37,49,0.46,12,0.038333333,32
2989.192753,56,79,0.65,23,0.02826087,32
2989.162807,74,99,0.41,25,0.0164,32
2989.017269,55,88,0.94,33,0.028484848,32
2989.000929,70,99,0.51,29,0.017586207,32
2988.634758,65,76,0.32,11,0.029090909,32
2988.496126,55,82,0.76,27,0.028148148,32
2988.245552,38,68,0.8,30,0.026666667,32
2988.107638,33,59,0.96,26,0.036923077,32
2988.052447,56,80,0.67,24,0.027916667,32
2987.931718,57,87,0.78,30,0.026,32
2987.904794,56,88,0.84,32,0.02625,32
2987.572492,45,47,0.08,2,0.04,32
2987.572492,44,48,0.16,4,0.04,32
2987.450421,58,79,0.58,21,0.027619048,32
2987.333325,59,68,0.31,9,0.034444444,32
2987.085758,60,72,0.35,12,0.029166667,32
2986.93975,52,87,0.95,35,0.027142857,32
2986.916145,32,61,0.98,29,0.033793103,32
2986.260516,44,55,0.37,11,0.033636364,32
2986.247324,39,58,0.66,19,0.034736842,32
2986.102767,57,87,0.62,30,0.020666667,32
2986.066255,55,77,0.73,22,0.033181818,32
2985.951787,82,88,0.1,6,0.016666667,32
2985.859315,62,80,0.52,18,0.028888889,32
2985.859315,59,84,0.72,25,0.0288,32
2985.859315,55,89,0.97,34,0.028529412,32
2985.773661,51,85,0.99,34,0.029117647,32
2985.75385,73,93,0.36,20,0.018,32
2985.582855,62,79,0.46,17,0.027058824,32
2985.50183,71,98,0.46,27,0.017037037,32
2985.337547,60,73,0.39,13,0.03,32
2985.2725,54,80,0.75,26,0.028846154,32
2985.247896,54,86,0.93,32,0.0290625,32
2985.03476,58,85,0.77,27,0.028518519,32
2984.993436,42,70,0.94,28,0.033571429,32
2984.89459,56,77,0.64,21,0.03047619,32
2984.798987,59,80,0.61,21,0.029047619,32
2984.689324,64,81,0.47,17,0.027647059,32
2984.60513,58,81,0.61,23,0.026521739,32
2984.574845,56,85,0.85,29,0.029310345,32
2984.574845,55,86,0.91,31,0.029354839,32
2984.190841,42,71,0.96,29,0.033103448,32
2984.134049,54,88,0.97,34,0.028529412,32
2983.980275,54,56,0.05,2,0.025,32
2983.973933,39,46,0.29,7,0.041428571,32
2983.838379,52,88,0.95,36,0.026388889,32
2983.633096,83,86,0.05,3,0.016666667,32
2983.621814,57,86,0.61,29,0.021034483,32
2983.535132,52,84,0.89,32,0.0278125,32
2983.514999,58,85,0.78,27,0.028888889,32
2983.514999,57,86,0.84,29,0.028965517,32
2983.309196,60,76,0.46,16,0.02875,32
2983.309196,59,77,0.52,18,0.028888889,32
2983.244367,67,77,0.28,10,0.028,32
2982.846976,62,73,0.32,11,0.029090909,32
2982.846976,61,74,0.38,13,0.029230769,32
2982.818229,37,49,0.47,12,0.039166667,32
2982.717118,53,85,0.9,32,0.028125,32
2982.371448,38,48,0.38,10,0.038,32
2982.320098,57,68,0.33,11,0.03,32
2982.310655,34,54,0.75,20,0.0375,32
2982.238672,74,90,0.29,16,0.018125,32
2982.095474,62,72,0.28,10,0.028,32
2981.955083,44,68,0.8,24,0.033333333,32
2981.856592,47,64,0.58,17,0.034117647,32
2981.797036,78,90,0.21,12,0.0175,32
2981.797036,76,92,0.28,16,0.0175,32
2981.73743,80,89,0.15,9,0.016666667,32
2981.648734,42,43,0.04,1,0.04,32
2981.614086,53,84,0.89,31,0.028709677,32
2981.614086,52,85,0.95,33,0.028787879,32
2981.44742,54,85,0.84,31,0.027096774,32
2981.327729,38,47,0.36,9,0.04,32
2981.244097,58,87,0.59,29,0.020344828,32
2981.020711,69,98,0.52,29,0.017931034,32
2980.866086,63,70,0.2,7,0.028571429,32
2980.798521,51,59,0.2,8,0.025,32
2980.798521,50,60,0.25,10,0.025,32
2980.74693,40,60,0.67,20,0.0335,32
2980.654717,38,56,0.67,18,0.037222222,32
2980.59328,62,83,0.58,21,0.027619048,32
2980.24163,55,79,0.68,24,0.028333333,32
2980.193267,32,58,0.99,26,0.038076923,32
2980.075808,64,79,0.4,15,0.026666667,32
2980.035742,79,89,0.17,10,0.017,32
2979.936349,56,86,0.81,30,0.027,32
2979.835776,58,73,0.46,15,0.030666667,32
2979.728788,35,56,0.76,21,0.036190476,32
2979.614691,36,50,0.56,14,0.04,32
2979.35164,54,85,0.82,31,0.026451613,32
2979.268976,32,59,0.92,27,0.034074074,32
2979.18554,41,58,0.58,17,0.034117647,32
2979.140438,75,90,0.27,15,0.018,32
2978.946313,52,83,0.89,31,0.028709677,32
2978.946313,51,84,0.95,33,0.028787879,32
2978.889664,54,83,0.82,29,0.028275862,32
2978.790387,42,58,0.55,16,0.034375,32
2978.676492,55,81,0.73,26,0.028076923,32
2978.66932,41,44,0.12,3,0.04,32
2978.66932,40,45,0.2,5,0.04,32
2978.649944,51,58,0.18,7,0.025714286,32
2978.576594,60,75,0.44,15,0.029333333,32
2978.568908,44,57,0.42,13,0.032307692,32
2978.501971,55,90,0.97,35,0.027714286,32
2978.455904,56,84,0.82,28,0.029285714,32
2978.446815,63,78,0.44,15,0.029333333,32
2978.446815,62,79,0.5,17,0.029411765,32
2978.446815,58,84,0.76,26,0.029230769,32
2978.446815,57,85,0.82,28,0.029285714,32
2978.429321,57,70,0.45,13,0.034615385,32
2978.429321,56,71,0.52,15,0.034666667,32
2978.100155,56,81,0.71,25,0.0284,32
2978.100155,55,82,0.77,27,0.028518519,32
2978.032634,41,61,0.64,20,0.032,32
2977.723666,56,87,0.65,31,0.020967742,32
2977.65083,64,82,0.36,18,0.02,32
2977.467162,58,76,0.51,18,0.028333333,32
2977.445136,55,85,0.84,30,0.028,32
2977.445136,54,86,0.9,32,0.028125,32
2977.285596,33,60,0.91,27,0.033703704,32
2976.76304,59,75,0.45,16,0.028125,32
2976.744972,64,80,0.46,16,0.02875,32
2976.68042,47,50,0.11,3,0.036666667,32
2976.501968,54,80,0.77,26,0.029615385,32
2976.501968,53,81,0.83,28,0.029642857,32
2976.501968,52,82,0.89,30,0.029666667,32
2976.409633,76,87,0.21,11,0.019090909,32
2976.248524,54,84,0.84,30,0.028,32
2976.199832,54,81,0.77,27,0.028518519,32
2976.199832,53,82,0.83,29,0.02862069,32
2975.990975,64,78,0.37,14,0.026428571,32
2975.990975,61,82,0.55,21,0.026190476,32
2975.749796,34,56,0.76,22,0.034545455,32
2975.386454,54,82,0.82,28,0.029285714,32
2975.386454,53,83,0.88,30,0.029333333,32
2975.386454,52,84,0.94,32,0.029375,32
2975.386454,52,85,0.96,33,0.029090909,32
2975.314896,36,55,0.65,19,0.034210526,32
2975.207025,56,70,0.41,14,0.029285714,32
2975.205747,36,56,0.68,20,0.034,32
2974.974682,39,68,0.94,29,0.032413793,32
2974.897015,38,59,0.74,21,0.035238095,32
2974.693458,66,77,0.29,11,0.026363636,32
2974.390602,54,83,0.78,29,0.026896552,32
2974.390602,54,84,0.8,30,0.026666667,32
2974.390452,41,59,0.62,18,0.034444444,32
2974.092645,57,87,0.84,30,0.028,32
2973.868438,38,51,0.47,13,0.036153846,32
2973.646539,60,73,0.37,13,0.028461538,32
2973.644401,52,82,0.88,30,0.029333333,32
2973.635187,55,75,0.67,20,0.0335,32
2973.635187,54,76,0.74,22,0.033636364,32
2973.623862,57,77,0.6,20,0.03,32
2973.623862,56,78,0.66,22,0.03,32
2973.623862,55,79,0.72,24,0.03,32
2973.575116,49,61,0.3,12,0.025,32
2972.74929,38,62,0.84,24,0.035,32
2972.600797,77,91,0.24,14,0.017142857,32
2972.524522,32,55,0.87,23,0.037826087,32
2972.457006,55,90,0.9,35,0.025714286,32
2972.168356,51,87,0.96,36,0.026666667,32
2972.100979,58,80,0.6,22,0.027272727,32
2972.055841,66,78,0.31,12,0.025833333,32
2971.919069,53,87,0.96,34,0.028235294,32
2971.490694,60,82,0.63,22,0.028636364,32
2971.490694,59,83,0.69,24,0.02875,32
2971.462746,55,90,0.99,35,0.028285714,32
2971.364787,79,87,0.14,8,0.0175,32
2971.364787,77,89,0.21,12,0.0175,32
2971.306516,54,84,0.83,30,0.027666667,32
2971.306516,53,85,0.89,32,0.0278125,32
2971.306516,52,87,0.96,35,0.027428571,32
2971.13567,73,91,0.34,18,0.018888889,32
2971.130021,38,55,0.61,17,0.035882353,32
2971.104448,41,60,0.64,19,0.033684211,32
2970.696021,54,83,0.84,29,0.028965517,32
2970.678803,52,86,0.97,34,0.028529412,32
2970.678023,32,59,0.97,27,0.035925926,32
2970.671876,40,56,0.58,16,0.03625,32
2970.602026,41,59,0.6,18,0.033333333,32
2970.576477,53,95,0.98,42,0.023333333,32
2970.387385,79,85,0.11,6,0.018333333,32
2970.345867,72,98,0.45,26,0.017307692,32
2970.250246,58,86,0.58,28,0.020714286,32
2969.977604,64,77,0.38,13,0.029230769,32
2969.428718,35,54,0.68,19,0.035789474,32
2969.365745,33,59,0.91,26,0.035,32
2969.269136,57,76,0.57,19,0.03,32
2969.269136,56,77,0.63,21,0.03,32
2969.269136,55,78,0.69,23,0.03,32
2969.128295,60,85,0.7,25,0.028,32
2969.128295,57,89,0.89,32,0.0278125,32
2969.109995,52,82,0.9,30,0.03,32
2969.073529,72,94,0.4,22,0.018181818,32
2969.073529,68,99,0.56,31,0.018064516,32
2969.067006,75,88,0.25,13,0.019230769,32
2968.868141,51,84,0.97,33,0.029393939,32
2968.854288,57,87,0.86,30,0.028666667,32
2968.826799,76,88,0.22,12,0.018333333,32
2968.826799,73,91,0.33,18,0.018333333,32
2968.787367,51,83,0.89,32,0.0278125,32
2968.684761,55,91,0.98,36,0.027222222,32
2968.399777,61,86,0.5,25,0.02,32
2968.386883,54,88,0.99,34,0.029117647,32
2968.342621,50,63,0.32,13,0.024615385,32
2968.318936,54,79,0.7,25,0.028,32
2968.162763,36,55,0.71,19,0.037368421,32
2968.026523,60,81,0.57,21,0.027142857,32
2968.026523,58,83,0.68,25,0.0272,32
2967.684746,38,47,0.38,9,0.042222222,32
2967.631536,59,78,0.53,19,0.027894737,32
2967.62758,34,57,0.81,23,0.035217391,32
2967.624242,56,87,0.88,31,0.028387097,32
2967.498478,55,89,0.96,34,0.028235294,32
2967.418755,73,95,0.39,22,0.017727273,32
2967.402841,75,94,0.33,19,0.017368421,32
2967.361304,42,64,0.73,22,0.033181818,32
2967.361304,41,65,0.8,24,0.033333333,32
2967.098475,70,98,0.5,28,0.017857143,32
2967.05212,52,86,0.94,34,0.027647059,32
2967.025378,52,86,0.95,34,0.027941176,32
2966.820274,75,95,0.33,20,0.0165,32
2966.714378,44,60,0.43,16,0.026875,32
2966.660945,34,58,0.88,24,0.036666667,32
2966.394192,73,94,0.36,21,0.017142857,32
2966.26828,54,80,0.74,26,0.028461538,32
2966.026303,71,94,0.41,23,0.017826087,32
2965.68713,59,76,0.5,17,0.029411765,32
2965.682228,59,80,0.62,21,0.02952381,32
2965.682228,58,81,0.68,23,0.029565217,32
2965.682228,55,85,0.88,30,0.029333333,32
2965.682228,54,86,0.94,32,0.029375,32
2965.200408,72,95,0.41,23,0.017826087,32
2965.199856,79,88,0.16,9,0.017777778,32
2965.026672,54,79,0.75,25,0.03,32
2965.026672,53,80,0.81,27,0.03,32
2965.026093,35,51,0.63,16,0.039375,32
2964.893792,51,88,0.98,37,0.026486486,32
2964.881039,38,53,0.55,15,0.036666667,32
2964.876305,60,82,0.59,22,0.026818182,32
2964.876305,58,84,0.7,26,0.026923077,32
2964.876305,56,87,0.83,31,0.026774194,32
2964.629733,37,63,0.92,26,0.035384615,32
2964.595126,56,82,0.71,26,0.027307692,32
2964.399603,67,97,0.57,30,0.019,32
2964.398427,52,88,0.97,36,0.026944444,32
2964.38689,54,92,0.78,38,0.020526316,32
2964.134855,38,49,0.45,11,0.040909091,32
2964.064139,72,92,0.38,20,0.019,32
2963.991955,77,92,0.25,15,0.016666667,32
2963.714492,35,59,0.86,24,0.035833333,32
2963.160601,56,79,0.68,23,0.029565217,32
2963.160601,55,80,0.74,25,0.0296,32
2963.025859,40,50,0.36,10,0.036,32
2962.912092,54,79,0.76,25,0.0304,32
2962.778796,34,56,0.87,22,0.039545455,32
2962.593685,42,57,0.51,15,0.034,32
2962.518927,40,71,0.88,31,0.028387097,32
2962.376976,32,56,0.9,24,0.0375,32
2962.201556,32,58,0.92,26,0.035384615,32
2962.16918,56,76,0.61,20,0.0305,32
2962.16918,55,77,0.67,22,0.030454545,32
2962.16918,53,80,0.82,27,0.03037037,32
2961.884484,66,67,0.03,1,0.03,32
2961.884484,65,68,0.09,3,0.03,32
2961.884484,64,69,0.15,5,0.03,32
2961.884484,63,70,0.21,7,0.03,32
2961.884484,62,71,0.27,9,0.03,32
2961.884484,61,72,0.33,11,0.03,32
2961.853921,44,54,0.34,10,0.034,32
2961.594283,78,93,0.25,15,0.016666667,32
2961.493905,34,52,0.72,18,0.04,32
2961.413791,40,57,0.59,17,0.034705882,32
2961.368571,33,53,0.83,20,0.0415,32
2961.023014,46,65,0.65,19,0.034210526,32
2960.754374,51,86,0.97,35,0.027714286,32
2960.351514,44,56,0.4,12,0.033333333,32
2960.108633,43,55,0.41,12,0.034166667,32
2960.082236,59,84,0.66,25,0.0264,32
2960.025758,58,78,0.58,20,0.029,32
2959.911689,80,87,0.12,7,0.017142857,32
2959.772823,64,83,0.49,19,0.025789474,32
2959.631198,32,56,0.98,24,0.040833333,32
2959.479285,36,62,0.97,26,0.037307692,32
2959.433187,42,63,0.56,21,0.026666667,32
2959.407239,54,83,0.83,29,0.02862069,32
2959.349054,53,84,0.9,31,0.029032258,32
2959.169478,72,98,0.44,26,0.016923077,32
2959.062614,33,55,0.9,22,0.040909091,32
2958.744706,61,83,0.58,22,0.026363636,32
2958.744706,59,86,0.71,27,0.026296296,32
2958.707401,53,87,0.91,34,0.026764706,32
2958.649701,77,90,0.23,13,0.017692308,32
2958.59546,58,77,0.56,19,0.029473684,32
2958.59546,57,78,0.62,21,0.02952381,32
2958.537601,57,75,0.55,18,0.030555556,32
2958.374407,63,81,0.47,18,0.026111111,32
2958.161594,55,84,0.83,29,0.02862069,32
2957.953957,55,90,0.89,35,0.025428571,32
2957.93653,51,83,0.96,32,0.03,32
2957.83833,37,51,0.51,14,0.036428571,32
2957.794083,64,80,0.42,16,0.02625,32
2957.247987,72,98,0.43,26,0.016538462,32
2957.177597,73,92,0.34,19,0.017894737,32
2957.000844,56,83,0.77,27,0.028518519,32
2956.940072,81,92,0.17,11,0.015454545,32
2956.577917,75,96,0.35,21,0.016666667,32
2956.505371,37,55,0.61,18,0.033888889,32
2956.254585,69,73,0.11,4,0.0275,32
2956.125086,41,48,0.27,7,0.038571429,32
2956.099031,37,61,0.9,24,0.0375,32
2955.692038,46,69,0.55,23,0.023913043,32
2955.60117,54,87,0.97,33,0.029393939,32
2955.290392,55,83,0.77,28,0.0275,32
2955.254835,56,88,0.9,32,0.028125,32
2955.004546,54,82,0.78,28,0.027857143,32
2954.83728,42,48,0.21,6,0.035,32
2954.795761,58,74,0.49,16,0.030625,32
2954.761242,69,77,0.21,8,0.02625,32
2954.66213,38,60,0.82,22,0.037272727,32
2954.569066,47,63,0.41,16,0.025625,32
2954.483729,64,67,0.1,3,0.033333333,32
2954.417433,51,85,0.95,34,0.027941176,32
2953.958136,71,97,0.46,26,0.017692308,32
2953.937958,50,74,0.84,24,0.035,32
2953.658772,35,53,0.66,18,0.036666667,32
2953.56781,68,76,0.17,8,0.02125,32
2953.531465,71,94,0.43,23,0.018695652,32
2953.354304,40,67,0.89,27,0.032962963,32
2953.314572,78,88,0.18,10,0.018,32
2953.314572,75,91,0.29,16,0.018125,32
2952.856809,81,87,0.1,6,0.016666667,32
2952.856809,74,95,0.35,21,0.016666667,32
2952.757025,72,93,0.38,21,0.018095238,32
2952.710377,47,58,0.29,11,0.026363636,32
2952.599302,46,51,0.17,5,0.034,32
2952.547037,68,77,0.23,9,0.025555556,32
2952.547037,62,83,0.54,21,0.025714286,32
2952.547037,61,85,0.61,24,0.025416667,32
2952.446507,65,99,0.75,34,0.022058824,32
2952.42819,74,93,0.34,19,0.017894737,32
2952.158976,55,87,0.87,32,0.0271875,32
2952.11054,62,82,0.41,20,0.0205,32
2952.075178,60,69,0.28,9,0.031111111,32
2951.88953,73,98,0.42,25,0.0168,32
2951.811641,40,69,0.92,29,0.031724138,32
2951.741022,70,97,0.49,27,0.018148148,32
2951.711561,40,67,0.88,27,0.032592593,32
2951.641795,78,86,0.15,8,0.01875,32
2951.628842,74,94,0.35,20,0.0175,32
2951.165012,55,88,0.96,33,0.029090909,32
2950.946768,72,91,0.36,19,0.018947368,32
2950.885818,53,88,0.99,35,0.028285714,32
2950.882161,52,79,0.9,27,0.033333333,32
2950.882161,51,80,0.97,29,0.033448276,32
2950.588973,59,86,0.76,27,0.028148148,32
2950.588973,56,90,0.95,34,0.027941176,32
2950.553687,36,59,0.85,23,0.036956522,32
2950.540264,54,90,0.75,36,0.020833333,32
2950.063683,54,92,0.99,38,0.026052632,32
2950.042367,79,93,0.22,14,0.015714286,32
2950.018446,60,87,0.68,27,0.025185185,32
2949.99201,55,84,0.84,29,0.028965517,32
2949.99201,54,85,0.9,31,0.029032258,32
2949.940224,55,89,0.71,34,0.020882353,32
2949.927536,57,74,0.52,17,0.030588235,32
2949.927536,56,75,0.58,19,0.030526316,32
2949.800131,71,93,0.4,22,0.018181818,32
2949.688779,55,83,0.81,28,0.028928571,32
2949.592951,43,62,0.51,19,0.026842105,32
2949.220995,41,64,0.62,23,0.026956522,32
2948.967916,60,71,0.32,11,0.029090909,32
2948.92242,57,87,0.79,30,0.026333333,32
2948.904419,43,56,0.44,13,0.033846154,32
2948.889941,54,91,0.76,37,0.020540541,32
2948.879349,57,81,0.66,24,0.0275,32
2948.879349,56,82,0.72,26,0.027692308,32
2948.879349,54,85,0.85,31,0.027419355,32
2948.879349,53,86,0.9,33,0.027272727,32
2948.852766,55,83,0.78,28,0.027857143,32
2948.852766,52,87,0.97,35,0.027714286,32
2948.321788,54,76,0.68,22,0.030909091,32
2948.00841,60,80,0.55,20,0.0275,32
2947.95809,39,67,0.75,28,0.026785714,32
2947.956211,53,83,0.82,30,0.027333333,32
2947.92202,52,82,0.91,30,0.030333333,32
2947.509571,60,81,0.58,21,0.027619048,32
2947.379424,63,82,0.53,19,0.027894737,32
2947.278639,75,91,0.28,16,0.0175,32
2947.265126,56,79,0.63,23,0.027391304,32
2947.213963,57,79,0.64,22,0.029090909,32
2947.188519,43,50,0.25,7,0.035714286,32
2947.098578,50,81,0.96,31,0.030967742,32
2946.864518,32,55,0.95,23,0.041304348,32
2946.484171,44,53,0.31,9,0.034444444,32
2946.367508,36,53,0.6,17,0.035294118,32
2946.271904,34,55,0.75,21,0.035714286,32
2946.214161,56,73,0.58,17,0.034117647,32
2946.207985,38,61,0.83,23,0.036086957,32
2946.039797,34,60,0.94,26,0.036153846,32
2946.017342,44,61,0.45,17,0.026470588,32
2945.972062,58,71,0.44,13,0.033846154,32
2945.93347,54,81,0.76,27,0.028148148,32
2945.923223,54,86,0.91,32,0.0284375,32
2945.732819,53,86,0.96,33,0.029090909,32
2945.711807,53,79,0.79,26,0.030384615,32
2945.374099,66,76,0.21,10,0.021,32
2945.343295,51,76,0.74,25,0.0296,32
2945.230589,56,89,0.95,33,0.028787879,32
2945.049455,45,55,0.34,10,0.034,32
2945.017748,80,93,0.2,13,0.015384615,32
2944.971786,44,48,0.15,4,0.0375,32
2944.946076,45,60,0.44,15,0.029333333,32
2944.833943,55,90,0.98,35,0.028,32
2944.759174,56,91,0.96,35,0.027428571,32
2944.695474,54,80,0.79,26,0.030384615,32
2944.695474,53,81,0.85,28,0.030357143,32
2944.511661,43,53,0.35,10,0.035,32
2944.363395,56,81,0.75,25,0.03,32
2944.363395,55,82,0.81,27,0.03,32
2944.163236,53,86,0.91,33,0.027575758,32
2943.847792,78,90,0.2,12,0.016666667,32
2943.491475,78,85,0.13,7,0.018571429,32
2943.372593,70,95,0.49,25,0.0196,32
2943.25611,47,64,0.57,17,0.033529412,32
2943.174581,46,68,0.54,22,0.024545455,32
2943.146864,48,58,0.26,10,0.026,32
