% profit,ema1,ema2,threshold,diff,thresh / diff,ID
3532.492274,62,74,0.36,12,0.03,50
3514.011999,67,69,0.06,2,0.03,50
3514.011999,66,70,0.12,4,0.03,50
3514.011999,65,71,0.18,6,0.03,50
3514.011999,64,72,0.24,8,0.03,50
3514.011999,63,73,0.3,10,0.03,50
3300.973618,60,65,0.17,5,0.034,50
3272.329293,59,66,0.24,7,0.034285714,50
3233.538001,58,67,0.31,9,0.034444444,50
3161.083494,72,83,0.2,11,0.018181818,50
3141.542522,59,77,0.55,18,0.030555556,50
3141.542522,58,78,0.61,20,0.0305,50
3139.079343,62,73,0.34,11,0.030909091,50
3137.013471,59,67,0.27,8,0.03375,50
3136.252837,75,80,0.09,5,0.018,50
3134.900964,61,68,0.23,7,0.032857143,50
3129.203304,59,76,0.52,17,0.030588235,50
3128.936436,59,69,0.33,10,0.033,50
3127.59946,57,79,0.67,22,0.030454545,50
3125.686552,63,72,0.28,9,0.031111111,50
3122.914167,60,75,0.47,15,0.031333333,50
3120.143841,52,75,0.78,23,0.033913043,50
3119.939135,56,73,0.56,17,0.032941176,50
3116.680715,53,74,0.71,21,0.033809524,50
3116.429258,56,72,0.53,16,0.033125,50
3113.727161,57,72,0.49,15,0.032666667,50
3109.529462,59,76,0.53,17,0.031176471,50
3104.540355,62,65,0.1,3,0.033333333,50
3104.540355,59,68,0.3,9,0.033333333,50
3103.858251,58,69,0.37,11,0.033636364,50
3103.858251,55,73,0.6,18,0.033333333,50
3102.991752,58,77,0.59,19,0.031052632,50
3101.975378,60,75,0.46,15,0.030666667,50
3098.522893,55,72,0.57,17,0.033529412,50
3096.270214,59,70,0.36,11,0.032727273,50
3092.509526,61,74,0.4,13,0.030769231,50
3091.34008,58,71,0.43,13,0.033076923,50
3089.109284,57,78,0.65,21,0.030952381,50
3086.140403,58,68,0.34,10,0.034,50
3081.824449,54,73,0.64,19,0.033684211,50
3081.804803,57,70,0.44,13,0.033846154,50
3078.609029,55,80,0.78,25,0.0312,50
3077.94181,67,83,0.31,16,0.019375,50
3077.306225,68,82,0.27,14,0.019285714,50
3076.958873,71,85,0.25,14,0.017857143,50
3074.947854,73,74,0.02,1,0.02,50
3074.947854,72,75,0.06,3,0.02,50
3074.947854,71,76,0.1,5,0.02,50
3074.947854,70,77,0.14,7,0.02,50
3070.787711,61,67,0.2,6,0.033333333,50
3068.062217,63,75,0.35,12,0.029166667,50
3068.062217,59,80,0.61,21,0.029047619,50
3066.700135,53,76,0.76,23,0.033043478,50
3065.674194,64,70,0.19,6,0.031666667,50
3063.235229,60,71,0.35,11,0.031818182,50
3061.862769,53,75,0.74,22,0.033636364,50
3058.511597,60,71,0.36,11,0.032727273,50
3058.462321,58,70,0.4,12,0.033333333,50
3058.462321,54,74,0.67,20,0.0335,50
3058.462321,52,77,0.83,25,0.0332,50
3056.083404,59,73,0.44,14,0.031428571,50
3054.714047,57,71,0.47,14,0.033571429,50
3051.321287,55,74,0.63,19,0.033157895,50
3048.396617,57,75,0.57,18,0.031666667,50
3047.73176,56,79,0.72,23,0.031304348,50
3044.748781,16,64,0.23,48,0.004791667,50
3044.026656,59,75,0.5,16,0.03125,50
3040.986423,58,73,0.48,15,0.032,50
3040.256368,63,70,0.22,7,0.031428571,50
3037.161572,69,86,0.31,17,0.018235294,50
3036.633527,62,70,0.25,8,0.03125,50
3032.805502,57,72,0.5,15,0.033333333,50
3032.713627,63,71,0.25,8,0.03125,50
3028.956906,60,73,0.41,13,0.031538462,50
3026.470705,68,80,0.24,12,0.02,50
3026.470705,67,81,0.28,14,0.02,50
3024.161523,54,86,0.93,32,0.0290625,50
3022.983335,62,76,0.41,14,0.029285714,50
3022.983335,57,82,0.73,25,0.0292,50
3022.461397,62,72,0.31,10,0.031,50
3022.316631,58,81,0.67,23,0.029130435,50
3021.441628,56,71,0.51,15,0.034,50
3019.422629,52,76,0.81,24,0.03375,50
3016.673328,60,74,0.44,14,0.031428571,50
3016.673328,57,77,0.63,20,0.0315,50
3015.53932,69,78,0.18,9,0.02,50
3015.462214,60,70,0.32,10,0.032,50
3014.999038,66,82,0.32,16,0.02,50
3014.261981,63,68,0.16,5,0.032,50
3013.544195,58,80,0.66,22,0.03,50
3011.147542,68,79,0.22,11,0.02,50
3010.962879,61,73,0.38,12,0.031666667,50
3010.962879,58,76,0.57,18,0.031666667,50
3009.761819,58,72,0.45,14,0.032142857,50
3008.374688,54,75,0.7,21,0.033333333,50
3008.185444,56,75,0.61,19,0.032105263,50
3007.187911,61,72,0.35,11,0.031818182,50
3004.558289,55,79,0.76,24,0.031666667,50
3003.4618,61,71,0.32,10,0.032,50
3003.048858,60,69,0.3,9,0.033333333,50
2999.062895,56,76,0.65,20,0.0325,50
2998.67005,39,55,0.58,16,0.03625,50
2998.359898,62,71,0.29,9,0.032222222,50
2998.097907,61,69,0.26,8,0.0325,50
2997.632559,58,74,0.51,16,0.031875,50
2997.379526,53,71,0.63,18,0.035,50
2996.644069,70,85,0.28,15,0.018666667,50
2996.387694,56,83,0.8,27,0.02962963,50
2996.387694,55,84,0.86,29,0.029655172,50
2996.214869,64,69,0.16,5,0.032,50
2996.214869,59,74,0.48,15,0.032,50
2996.214869,57,76,0.61,19,0.032105263,50
2993.91897,54,70,0.56,16,0.035,50
2992.155621,57,69,0.41,12,0.034166667,50
2991.624367,58,75,0.54,17,0.031764706,50
2991.398117,59,73,0.45,14,0.032142857,50
2988.606527,63,75,0.36,12,0.03,50
2988.606527,62,76,0.42,14,0.03,50
2988.606527,61,77,0.48,16,0.03,50
2988.185281,61,70,0.29,9,0.032222222,50
2988.185281,59,72,0.42,13,0.032307692,50
2982.144868,57,73,0.52,16,0.0325,50
2981.507041,69,87,0.33,18,0.018333333,50
2980.806237,56,76,0.64,20,0.032,50
2978.450076,52,78,0.86,26,0.033076923,50
2975.674618,49,59,0.26,10,0.026,50
2970.30182,56,78,0.7,22,0.031818182,50
2970.258836,58,80,0.65,22,0.029545455,50
2969.111806,60,72,0.38,12,0.031666667,50
2967.597125,56,79,0.71,23,0.030869565,50
2967.183048,55,75,0.65,20,0.0325,50
2966.963738,46,50,0.14,4,0.035,50
2966.963738,45,51,0.21,6,0.035,50
2966.221215,70,86,0.29,16,0.018125,50
2964.325461,57,74,0.55,17,0.032352941,50
2963.347864,56,77,0.66,21,0.031428571,50
2963.297361,57,77,0.64,20,0.032,50
2963.03255,61,77,0.47,16,0.029375,50
2963.03255,60,78,0.53,18,0.029444444,50
2963.03255,59,79,0.59,20,0.0295,50
2962.294057,58,73,0.49,15,0.032666667,50
2962.015928,60,78,0.54,18,0.03,50
2962.015928,59,79,0.6,20,0.03,50
2961.201039,55,77,0.71,22,0.032272727,50
2960.823392,67,88,0.39,21,0.018571429,50
2959.376191,54,78,0.77,24,0.032083333,50
2957.637324,59,71,0.39,12,0.0325,50
2957.280026,56,83,0.79,27,0.029259259,50
2956.524876,44,49,0.18,5,0.036,50
2956.189631,62,69,0.23,7,0.032857143,50
2955.454684,55,78,0.73,23,0.03173913,50
2954.764825,73,83,0.18,10,0.018,50
2954.602017,55,77,0.72,22,0.032727273,50
2954.253347,56,75,0.62,19,0.032631579,50
2953.762113,68,69,0.03,1,0.03,50
2953.762113,67,70,0.09,3,0.03,50
2953.762113,66,71,0.15,5,0.03,50
2953.762113,65,72,0.21,7,0.03,50
2953.762113,64,73,0.27,9,0.03,50
2953.762113,63,74,0.33,11,0.03,50
2953.762113,62,75,0.39,13,0.03,50
2952.590179,63,67,0.13,4,0.0325,50
2951.105201,55,84,0.85,29,0.029310345,50
2949.993338,41,52,0.4,11,0.036363636,50
2949.303868,54,85,0.93,31,0.03,50
2948.323359,36,59,0.82,23,0.035652174,50
2947.340445,35,60,0.9,25,0.036,50
2947.233911,64,68,0.13,4,0.0325,50
2947.233911,62,70,0.26,8,0.0325,50
2947.233911,60,72,0.39,12,0.0325,50
2947.233911,58,74,0.52,16,0.0325,50
2945.800251,61,66,0.17,5,0.034,50
2945.462933,48,58,0.27,10,0.027,50
2945.40347,58,75,0.53,17,0.031176471,50
2945.143362,57,82,0.74,25,0.0296,50
2943.677138,68,89,0.38,21,0.018095238,50
2941.2126,40,54,0.49,14,0.035,50
2939.638341,55,84,0.87,29,0.03,50
2939.281091,52,80,0.93,28,0.033214286,50
2939.154582,57,81,0.72,24,0.03,50
2937.160555,44,52,0.28,8,0.035,50
2937.159845,59,75,0.51,16,0.031875,50
2937.014084,66,89,0.43,23,0.018695652,50
2936.21986,68,87,0.35,19,0.018421053,50
2935.673985,55,76,0.7,21,0.033333333,50
2934.851973,54,80,0.83,26,0.031923077,50
2934.516467,37,58,0.74,21,0.035238095,50
2932.569989,51,56,0.13,5,0.026,50
2931.81232,50,58,0.21,8,0.02625,50
2931.70085,57,74,0.56,17,0.032941176,50
2931.285366,57,75,0.58,18,0.032222222,50
2931.244781,53,76,0.77,23,0.033478261,50
2931.198227,57,81,0.71,24,0.029583333,50
2930.813698,54,85,0.92,31,0.029677419,50
2929.628312,53,79,0.84,26,0.032307692,50
2929.62292,62,72,0.32,10,0.032,50
2928.823934,55,79,0.77,24,0.032083333,50
2928.39264,56,75,0.63,19,0.033157895,50
2928.140109,61,76,0.45,15,0.03,50
2928.140109,60,77,0.51,17,0.03,50
2925.505489,56,82,0.77,26,0.029615385,50
2924.354644,53,77,0.79,24,0.032916667,50
2924.251894,71,84,0.24,13,0.018461538,50
2923.740469,62,68,0.2,6,0.033333333,50
2923.243326,51,79,0.93,28,0.033214286,50
2922.565613,59,99,0.71,40,0.01775,50
2922.402625,54,79,0.8,25,0.032,50
2922.372131,60,73,0.42,13,0.032307692,50
2922.372131,58,75,0.55,17,0.032352941,50
2922.024139,59,78,0.57,19,0.03,50
2922.024139,58,79,0.63,21,0.03,50
2922.024139,57,80,0.69,23,0.03,50
2921.190379,54,78,0.78,24,0.0325,50
2921.190379,52,80,0.91,28,0.0325,50
2919.867475,56,72,0.54,16,0.03375,50
2919.85939,16,64,0.21,48,0.004375,50
2919.386691,55,78,0.74,23,0.032173913,50
2918.403355,40,56,0.58,16,0.03625,50
2917.738953,52,81,0.95,29,0.032758621,50
2914.504581,58,72,0.46,14,0.032857143,50
2914.363468,52,79,0.88,27,0.032592593,50
2913.655139,56,82,0.78,26,0.03,50
2913.570173,51,77,0.88,26,0.033846154,50
2912.835966,54,79,0.81,25,0.0324,50
2911.909114,57,68,0.34,11,0.030909091,50
2909.616881,53,79,0.86,26,0.033076923,50
2909.548616,40,57,0.6,17,0.035294118,50
2908.827356,60,68,0.27,8,0.03375,50
2908.592518,52,81,0.93,29,0.032068966,50
2908.467198,39,55,0.57,16,0.035625,50
2908.17331,55,76,0.68,21,0.032380952,50
2907.568424,55,83,0.84,28,0.03,50
2907.568424,54,84,0.9,30,0.03,50
2906.883201,70,78,0.16,8,0.02,50
2906.883201,69,79,0.2,10,0.02,50
2905.978622,38,56,0.65,18,0.036111111,50
2905.384238,53,86,0.98,33,0.02969697,50
2905.065917,59,70,0.37,11,0.033636364,50
2902.980562,53,81,0.9,28,0.032142857,50
2902.398036,54,78,0.79,24,0.032916667,50
2902.208163,60,70,0.33,10,0.033,50
2901.251916,56,74,0.59,18,0.032777778,50
2900.749044,54,76,0.72,22,0.032727273,50
2900.669766,62,71,0.28,9,0.031111111,50
2899.168313,55,75,0.66,20,0.033,50
2899.168313,54,77,0.75,23,0.032608696,50
2898.993753,59,74,0.47,15,0.031333333,50
2898.202544,56,73,0.57,17,0.033529412,50
2896.978458,61,73,0.37,12,0.030833333,50
2896.955418,57,77,0.62,20,0.031,50
2896.9025,58,72,0.47,14,0.033571429,50
2896.583809,56,77,0.68,21,0.032380952,50
2895.624173,17,20,0.03,3,0.01,50
2895.257597,53,80,0.87,27,0.032222222,50
2894.386998,53,80,0.86,27,0.031851852,50
2892.923243,49,58,0.24,9,0.026666667,50
2892.727891,52,74,0.68,22,0.030909091,50
2889.522679,55,76,0.69,21,0.032857143,50
2889.458014,43,53,0.35,10,0.035,50
2889.233308,56,78,0.69,22,0.031363636,50
2888.915064,69,88,0.34,19,0.017894737,50
2887.762787,60,74,0.43,14,0.030714286,50
2886.307576,51,81,0.98,30,0.032666667,50
2886.0589,73,81,0.15,8,0.01875,50
2885.648647,57,76,0.6,19,0.031578947,50
2885.121398,59,71,0.4,12,0.033333333,50
2882.093217,53,86,0.99,33,0.03,50
2881.558449,16,21,0.05,5,0.01,50
2881.091259,71,77,0.12,6,0.02,50
2879.450637,58,76,0.56,18,0.031111111,50
2879.166073,42,54,0.43,12,0.035833333,50
2875.862914,64,74,0.3,10,0.03,50
2875.771969,16,62,0.24,46,0.005217391,50
2875.147382,63,69,0.19,6,0.031666667,50
2872.438375,55,74,0.64,19,0.033684211,50
2867.544529,57,73,0.53,16,0.033125,50
2863.560368,52,82,0.96,30,0.032,50
2862.382757,61,78,0.49,17,0.028823529,50
2862.382757,60,79,0.55,19,0.028947368,50
2861.441379,55,84,0.84,29,0.028965517,50
2859.534762,63,66,0.1,3,0.033333333,50
2859.428409,53,79,0.85,26,0.032692308,50
2859.103425,50,85,0.95,35,0.027142857,50
2858.911942,53,78,0.82,25,0.0328,50
2858.732315,59,72,0.43,13,0.033076923,50
2858.609068,52,77,0.84,25,0.0336,50
2857.832437,63,76,0.37,13,0.028461538,50
2856.549421,59,80,0.6,21,0.028571429,50
2856.37188,41,54,0.49,13,0.037692308,50
2856.239628,42,53,0.41,11,0.037272727,50
2855.322473,58,81,0.68,23,0.029565217,50
2854.608125,54,80,0.82,26,0.031538462,50
2853.64592,58,65,0.25,7,0.035714286,50
2853.351707,56,77,0.67,21,0.031904762,50
2851.921761,39,57,0.66,18,0.036666667,50
2851.802894,44,51,0.25,7,0.035714286,50
2851.50354,16,64,0.22,48,0.004583333,50
2851.340636,52,79,0.89,27,0.032962963,50
2851.211134,74,81,0.13,7,0.018571429,50
2850.06218,57,75,0.59,18,0.032777778,50
2849.803586,54,86,0.94,32,0.029375,50
2849.279228,46,49,0.11,3,0.036666667,50
2848.768946,50,56,0.16,6,0.026666667,50
2846.863756,58,81,0.66,23,0.028695652,50
2846.375292,29,86,0.21,57,0.003684211,50
2845.804748,55,73,0.61,18,0.033888889,50
2843.860245,51,79,0.94,28,0.033571429,50
2843.219006,68,88,0.37,20,0.0185,50
2842.089155,52,72,0.71,20,0.0355,50
2842.087903,62,77,0.43,15,0.028666667,50
2841.078418,38,55,0.65,17,0.038235294,50
2840.933508,50,74,0.89,24,0.037083333,50
2840.858071,58,73,0.5,15,0.033333333,50
2839.911971,65,90,0.47,25,0.0188,50
2839.735807,41,55,0.5,14,0.035714286,50
2838.60189,75,81,0.11,6,0.018333333,50
2838.60189,72,84,0.22,12,0.018333333,50
2837.423418,39,58,0.68,19,0.035789474,50
2836.83179,39,58,0.7,19,0.036842105,50
2836.66411,53,80,0.88,27,0.032592593,50
2836.627764,55,78,0.75,23,0.032608696,50
2836.593974,54,85,0.9,31,0.029032258,50
2835.318224,39,56,0.64,17,0.037647059,50
2833.689552,51,73,0.8,22,0.036363636,50
2831.505869,70,85,0.27,15,0.018,50
2827.355677,52,81,0.94,29,0.032413793,50
2827.285218,37,56,0.73,19,0.038421053,50
2826.464989,44,51,0.26,7,0.037142857,50
2826.191234,43,52,0.34,9,0.037777778,50
2825.84998,59,64,0.18,5,0.036,50
2825.789864,49,76,0.95,27,0.035185185,50
2824.996405,39,50,0.4,11,0.036363636,50
2824.975098,51,80,0.95,29,0.032758621,50
2823.927736,53,87,0.99,34,0.029117647,50
2823.144858,54,72,0.55,18,0.030555556,50
2822.605091,53,81,0.89,28,0.031785714,50
2822.534088,57,82,0.72,25,0.0288,50
2821.97315,40,53,0.49,13,0.037692308,50
2821.844251,54,76,0.73,22,0.033181818,50
2821.699183,59,73,0.46,14,0.032857143,50
2821.663022,56,76,0.66,20,0.033,50
2821.332218,55,85,0.87,30,0.029,50
2821.297289,10,38,0.34,28,0.012142857,50
2820.937058,53,86,0.96,33,0.029090909,50
2820.355091,51,73,0.79,22,0.035909091,50
2819.739234,37,61,0.87,24,0.03625,50
2819.661307,63,78,0.34,15,0.022666667,50
2818.738767,50,77,0.82,27,0.03037037,50
2818.654495,55,68,0.47,13,0.036153846,50
2817.940988,54,86,0.92,32,0.02875,50
2817.940988,53,87,0.98,34,0.028823529,50
2817.896295,50,59,0.23,9,0.025555556,50
2816.447672,46,63,0.44,17,0.025882353,50
2816.181072,53,82,0.91,29,0.03137931,50
2816.058872,53,71,0.64,18,0.035555556,50
2814.535448,37,60,0.85,23,0.036956522,50
2813.356168,65,74,0.26,9,0.028888889,50
2813.356168,59,81,0.63,22,0.028636364,50
2813.356168,58,82,0.69,24,0.02875,50
2813.356168,57,83,0.75,26,0.028846154,50
2810.08119,57,68,0.38,11,0.034545455,50
2810.030213,39,57,0.67,18,0.037222222,50
2809.465215,54,69,0.55,15,0.036666667,50
2808.716075,48,80,0.97,32,0.0303125,50
2808.655437,69,87,0.32,18,0.017777778,50
2807.948937,43,52,0.33,9,0.036666667,50
2807.661634,43,49,0.23,6,0.038333333,50
2806.687455,10,37,0.34,27,0.012592593,50
2806.682166,65,73,0.24,8,0.03,50
2806.414153,54,86,0.9,32,0.028125,50
2806.384352,41,53,0.43,12,0.035833333,50
2806.305752,55,86,0.89,31,0.028709677,50
2806.259109,49,76,0.96,27,0.035555556,50
2803.695776,57,86,0.75,29,0.025862069,50
2803.381756,66,73,0.2,7,0.028571429,50
2802.751317,55,85,0.85,30,0.028333333,50
2802.451694,15,21,0.08,6,0.013333333,50
2802.11906,58,85,0.7,27,0.025925926,50
2801.793073,56,83,0.78,27,0.028888889,50
2800.623928,53,73,0.61,20,0.0305,50
2799.600435,39,54,0.57,15,0.038,50
2799.160219,56,81,0.75,25,0.03,50
2798.809087,56,69,0.45,13,0.034615385,50
2798.443681,40,56,0.6,16,0.0375,50
2797.92673,41,52,0.41,11,0.037272727,50
2797.60883,41,55,0.52,14,0.037142857,50
2797.474974,40,55,0.56,15,0.037333333,50
2797.188714,51,78,0.91,27,0.033703704,50
2797.177889,40,52,0.46,12,0.038333333,50
2797.087595,54,86,0.91,32,0.0284375,50
2797.087595,53,87,0.97,34,0.028529412,50
2796.700039,9,38,0.4,29,0.013793103,50
2796.169917,54,89,0.91,35,0.026,50
2795.617669,16,63,0.23,47,0.004893617,50
2795.535459,38,59,0.78,21,0.037142857,50
2795.511774,39,58,0.69,19,0.036315789,50
2795.466502,56,67,0.4,11,0.036363636,50
2795.001416,50,74,0.88,24,0.036666667,50
2794.835705,57,83,0.76,26,0.029230769,50
2794.175455,36,58,0.82,22,0.037272727,50
2794.076401,53,86,0.97,33,0.029393939,50
2794.045798,55,89,0.87,34,0.025588235,50
2793.744173,48,59,0.29,11,0.026363636,50
2793.743728,36,63,0.93,27,0.034444444,50
2792.846982,54,77,0.76,23,0.033043478,50
2792.324244,38,58,0.75,20,0.0375,50
2791.50382,54,88,0.97,34,0.028529412,50
2791.500463,66,91,0.46,25,0.0184,50
2791.43112,54,90,0.92,36,0.025555556,50
2791.012923,55,87,0.91,32,0.0284375,50
2790.617178,51,58,0.18,7,0.025714286,50
2790.478063,61,78,0.5,17,0.029411765,50
2790.453806,37,57,0.73,20,0.0365,50
2788.908523,64,75,0.32,11,0.029090909,50
2788.908523,63,76,0.38,13,0.029230769,50
2788.908523,62,77,0.44,15,0.029333333,50
2788.796236,14,22,0.12,8,0.015,50
2788.484667,56,70,0.42,14,0.03,50
2788.484667,55,71,0.48,16,0.03,50
2788.484667,54,72,0.54,18,0.03,50
2787.112091,10,38,0.33,28,0.011785714,50
2786.935373,55,83,0.83,28,0.029642857,50
2786.935373,54,84,0.89,30,0.029666667,50
2786.935373,54,85,0.91,31,0.029354839,50
2786.935373,53,85,0.95,32,0.0296875,50
2786.706043,58,74,0.53,16,0.033125,50
2786.632357,53,92,0.99,39,0.025384615,50
2785.934665,54,91,0.94,37,0.025405405,50
2785.819659,55,77,0.73,22,0.033181818,50
2785.630775,49,60,0.28,11,0.025454545,50
2785.278129,61,70,0.3,9,0.033333333,50
2785.264114,55,85,0.86,30,0.028666667,50
2785.07223,56,84,0.83,28,0.029642857,50
2784.681598,38,55,0.64,17,0.037647059,50
2784.335905,39,54,0.56,15,0.037333333,50
2784.335905,37,57,0.74,20,0.037,50
2784.208518,63,77,0.4,14,0.028571429,50
2784.208518,57,84,0.77,27,0.028518519,50
2784.208518,56,85,0.83,29,0.02862069,50
2783.998862,53,91,0.97,38,0.025526316,50
2783.962071,68,73,0.11,5,0.022,50
2783.91841,56,85,0.82,29,0.028275862,50
2782.572422,47,62,0.39,15,0.026,50
2782.138774,55,85,0.84,30,0.028,50
2782.033617,60,79,0.56,19,0.029473684,50
2782.033617,59,80,0.62,21,0.02952381,50
2782.028443,53,87,0.96,34,0.028235294,50
2780.988988,51,76,0.75,25,0.03,50
2780.713323,43,53,0.36,10,0.036,50
2779.793484,41,51,0.38,10,0.038,50
2779.762931,54,87,0.95,33,0.028787879,50
2779.754969,28,88,0.22,60,0.003666667,50
2779.184991,55,68,0.48,13,0.036923077,50
2778.289627,48,61,0.33,13,0.025384615,50
2778.081282,57,83,0.73,26,0.028076923,50
2777.366219,70,87,0.31,17,0.018235294,50
2777.324779,38,59,0.77,21,0.036666667,50
2777.046477,67,90,0.42,23,0.01826087,50
2776.405154,54,85,0.89,31,0.028709677,50
2776.405154,53,86,0.95,33,0.028787879,50
2776.355099,58,83,0.71,25,0.0284,50
2776.355099,56,86,0.85,30,0.028333333,50
2775.872921,41,54,0.48,13,0.036923077,50
2775.483676,51,80,0.96,29,0.033103448,50
2774.333897,64,76,0.34,12,0.028333333,50
2774.333897,63,78,0.42,15,0.028,50
2774.131573,53,70,0.63,17,0.037058824,50
2772.985004,56,84,0.81,28,0.028928571,50
2772.719787,15,21,0.09,6,0.015,50
2772.671914,62,78,0.37,16,0.023125,50
2772.229703,11,37,0.28,26,0.010769231,50
2771.410573,26,93,0.32,67,0.004776119,50
2770.953164,55,87,0.9,32,0.028125,50
2770.953164,54,88,0.96,34,0.028235294,50
2770.74431,24,98,0.36,74,0.004864865,50
2769.950584,46,66,0.5,20,0.025,50
2769.838922,67,73,0.17,6,0.028333333,50
2769.786973,56,88,0.82,32,0.025625,50
2768.935758,61,79,0.51,18,0.028333333,50
2768.935758,60,81,0.59,21,0.028095238,50
2768.473921,52,80,0.92,28,0.032857143,50
2768.473921,51,81,0.99,30,0.033,50
2768.435393,46,48,0.07,2,0.035,50
2768.435393,45,49,0.14,4,0.035,50
2767.430373,58,82,0.7,24,0.029166667,50
2767.019331,61,71,0.33,10,0.033,50
2765.872034,38,56,0.66,18,0.036666667,50
2765.546832,55,88,0.86,33,0.026060606,50
2765.546832,53,91,0.98,38,0.025789474,50
2764.94109,61,80,0.54,19,0.028421053,50
2764.94109,58,84,0.73,26,0.028076923,50
2764.94109,57,85,0.79,28,0.028214286,50
2764.94109,57,86,0.81,29,0.027931034,50
2764.854237,54,90,0.93,36,0.025833333,50
2764.430175,53,85,0.96,32,0.03,50
2763.841121,9,38,0.39,29,0.013448276,50
2762.188603,41,55,0.51,14,0.036428571,50
2761.979938,65,74,0.21,9,0.023333333,50
2761.873175,56,87,0.87,31,0.028064516,50
2761.559304,60,80,0.58,20,0.029,50
2761.559304,59,81,0.64,22,0.029090909,50
2760.948409,66,74,0.23,8,0.02875,50
2760.948409,62,78,0.46,16,0.02875,50
2760.948409,61,79,0.52,18,0.028888889,50
2760.948409,59,82,0.66,23,0.028695652,50
2760.717492,59,74,0.49,15,0.032666667,50
2760.717492,54,79,0.82,25,0.0328,50
2760.43732,59,82,0.65,23,0.02826087,50
2760.417377,65,75,0.23,10,0.023,50
2759.560591,54,89,0.98,35,0.028,50
2758.657449,42,52,0.38,10,0.038,50
2758.543694,57,76,0.62,19,0.032631579,50
2758.162839,49,78,0.9,29,0.031034483,50
2757.618119,56,85,0.84,29,0.028965517,50
2757.119612,42,51,0.33,9,0.036666667,50
2757.008066,57,84,0.78,27,0.028888889,50
2756.672322,64,67,0.1,3,0.033333333,50
2756.644203,60,81,0.6,21,0.028571429,50
2756.4279,11,37,0.29,26,0.011153846,50
2755.67809,64,77,0.29,13,0.022307692,50
2755.36375,42,54,0.44,12,0.036666667,50
2755.302427,37,56,0.72,19,0.037894737,50
2755.108923,60,82,0.6,22,0.027272727,50
2755.108923,59,82,0.64,23,0.027826087,50
2755.065279,60,80,0.57,20,0.0285,50
2754.683238,52,72,0.72,20,0.036,50
2754.418018,34,62,0.99,28,0.035357143,50
2754.188266,40,54,0.5,14,0.035714286,50
2753.868785,46,56,0.33,10,0.033,50
2753.421464,70,80,0.19,10,0.019,50
2753.142824,44,48,0.15,4,0.0375,50
2752.72772,9,39,0.37,30,0.012333333,50
2751.799759,62,78,0.45,16,0.028125,50
2751.64319,16,20,0.06,4,0.015,50
2751.331524,34,99,0.18,65,0.002769231,50
2751.158336,58,83,0.72,25,0.0288,50
2750.526569,59,64,0.16,5,0.032,50
2749.507639,40,56,0.59,16,0.036875,50
2749.086477,62,79,0.48,17,0.028235294,50
2749.086477,59,83,0.67,24,0.027916667,50
2749.079754,68,80,0.23,12,0.019166667,50
2748.813501,36,54,0.65,18,0.036111111,50
2748.796651,34,99,0.16,65,0.002461538,50
2748.528966,69,81,0.23,12,0.019166667,50
2748.448619,66,76,0.27,10,0.027,50
2748.400899,56,74,0.6,18,0.033333333,50
2748.14423,69,80,0.21,11,0.019090909,50
2747.636946,63,80,0.44,17,0.025882353,50
2746.827631,63,69,0.2,6,0.033333333,50
2746.827631,60,72,0.4,12,0.033333333,50
2746.743145,50,77,0.83,27,0.030740741,50
2745.884362,51,87,0.97,36,0.026944444,50
2745.635611,57,85,0.8,28,0.028571429,50
2745.635611,56,86,0.86,30,0.028666667,50
2745.635611,55,87,0.92,32,0.02875,50
2744.906926,54,89,0.99,35,0.028285714,50
2744.549462,65,76,0.3,11,0.027272727,50
2744.191038,71,83,0.23,12,0.019166667,50
2743.779223,62,80,0.49,18,0.027222222,50
2743.35334,28,93,0.3,65,0.004615385,50
2743.012375,74,80,0.11,6,0.018333333,50
2742.782841,62,77,0.35,15,0.023333333,50
2742.639882,56,87,0.88,31,0.028387097,50
2742.639882,55,88,0.94,33,0.028484848,50
2742.512455,53,77,0.8,24,0.033333333,50
2742.504738,52,55,0.08,3,0.026666667,50
2742.126707,56,84,0.82,28,0.029285714,50
2742.126707,55,85,0.88,30,0.029333333,50
2741.429363,63,77,0.39,14,0.027857143,50
2741.357092,58,85,0.75,27,0.027777778,50
2741.20535,68,81,0.25,13,0.019230769,50
2740.583422,54,87,0.96,33,0.029090909,50
2739.809166,58,84,0.74,26,0.028461538,50
2739.535372,43,64,0.59,21,0.028095238,50
2739.483861,66,90,0.43,24,0.017916667,50
2739.483861,65,92,0.48,27,0.017777778,50
2739.117112,55,88,0.93,33,0.028181818,50
2738.639112,40,73,0.94,33,0.028484848,50
2738.173271,55,90,0.89,35,0.025428571,50
2738.125842,55,86,0.9,31,0.029032258,50
2737.576728,40,53,0.48,13,0.036923077,50
2737.512615,48,61,0.34,13,0.026153846,50
2737.484831,54,88,0.98,34,0.028823529,50
2736.864921,65,75,0.28,10,0.028,50
2736.722076,16,64,0.2,48,0.004166667,50
2736.437731,38,60,0.76,22,0.034545455,50
2735.750592,61,80,0.53,19,0.027894737,50
2735.750592,58,83,0.7,25,0.028,50
2735.254381,34,99,0.17,65,0.002615385,50
2735.242584,52,79,0.9,27,0.033333333,50
2735.198112,67,82,0.29,15,0.019333333,50
2734.179501,35,61,0.91,26,0.035,50
2733.545881,41,53,0.45,12,0.0375,50
2733.401001,67,81,0.27,14,0.019285714,50
2732.757206,52,86,0.92,34,0.027058824,50
2731.596926,16,21,0.06,5,0.012,50
2731.406742,42,47,0.18,5,0.036,50
2731.067754,66,79,0.27,13,0.020769231,50
2731.020624,72,83,0.21,11,0.019090909,50
2731.020624,66,89,0.44,23,0.019130435,50
2731.020624,65,90,0.48,25,0.0192,50
2730.655807,60,80,0.46,20,0.023,50
2730.312654,73,82,0.17,9,0.018888889,50
2730.240833,55,88,0.92,33,0.027878788,50
2730.217598,57,84,0.76,27,0.028148148,50
2730.217598,57,85,0.78,28,0.027857143,50
2729.563005,61,72,0.36,11,0.032727273,50
2729.151995,37,61,0.83,24,0.034583333,50
2728.991532,56,87,0.81,31,0.026129032,50
2728.979234,38,51,0.48,13,0.036923077,50
2728.765807,53,85,0.86,32,0.026875,50
2728.596217,41,72,0.88,31,0.028387097,50
2728.441993,53,78,0.83,25,0.0332,50
2728.410947,66,75,0.2,9,0.022222222,50
2727.798047,55,75,0.67,20,0.0335,50
2727.333679,62,81,0.39,19,0.020526316,50
2726.527239,35,59,0.9,24,0.0375,50
2726.518764,68,89,0.37,21,0.017619048,50
2726.444935,64,77,0.36,13,0.027692308,50
2725.791613,56,86,0.84,30,0.028,50
2724.84601,36,58,0.81,22,0.036818182,50
2724.827421,66,82,0.31,16,0.019375,50
2724.792436,51,87,0.98,36,0.027222222,50
2724.620293,42,65,0.08,23,0.003478261,50
2723.9697,67,88,0.4,21,0.019047619,50
2723.462083,61,80,0.43,19,0.022631579,50
2723.260776,43,60,0.56,17,0.032941176,50
2722.3534,8,52,0.55,44,0.0125,50
2722.336947,48,54,0.2,6,0.033333333,50
2722.22086,65,83,0.35,18,0.019444444,50
2722.034167,11,37,0.3,26,0.011538462,50
2721.476297,52,86,0.91,34,0.026764706,50
2721.352858,44,50,0.21,6,0.035,50
2721.11452,3,17,0.93,14,0.066428571,50
2720.945389,67,71,0.12,4,0.03,50
2720.945389,66,72,0.18,6,0.03,50
2720.553556,17,19,0.03,2,0.015,50
2720.430675,59,85,0.53,26,0.020384615,50
2720.369429,60,83,0.62,23,0.026956522,50
2720.284728,45,49,0.15,4,0.0375,50
2719.413606,68,70,0.06,2,0.03,50
2719.368622,63,88,0.51,25,0.0204,50
2718.04167,36,57,0.81,21,0.038571429,50
2717.845401,54,84,0.8,30,0.026666667,50
2717.130487,56,84,0.79,28,0.028214286,50
2717.086628,51,88,0.99,37,0.026756757,50
2716.052342,24,99,0.35,75,0.004666667,50
2715.911837,58,86,0.72,28,0.025714286,50
2715.911837,57,87,0.77,30,0.025666667,50
2715.911837,56,89,0.84,33,0.025454545,50
2715.334555,36,62,0.91,26,0.035,50
2714.820715,65,93,0.52,28,0.018571429,50
2714.820715,64,94,0.56,30,0.018666667,50
2714.578251,56,87,0.86,31,0.027741935,50
2714.446362,52,87,0.93,35,0.026571429,50
2714.257753,66,92,0.48,26,0.018461538,50
2714.158501,63,94,0.55,31,0.017741935,50
2714.083753,37,89,0.47,52,0.009038462,50
2714.077577,66,76,0.22,10,0.022,50
2713.170441,62,79,0.47,17,0.027647059,50
2712.595471,58,82,0.56,24,0.023333333,50
2712.595471,58,83,0.58,25,0.0232,50
2712.497548,59,81,0.51,22,0.023181818,50
2712.497548,59,82,0.53,23,0.023043478,50
2712.186133,55,85,0.89,30,0.029666667,50
2712.065419,58,84,0.72,26,0.027692308,50
2711.723791,54,83,0.78,29,0.026896552,50
2711.280066,57,76,0.54,19,0.028421053,50
2711.155608,69,81,0.32,12,0.026666667,50
2711.028707,65,73,0.23,8,0.02875,50
2710.878481,57,73,0.48,16,0.03,50
2710.843868,58,93,0.73,35,0.020857143,50
2710.736844,66,83,0.33,17,0.019411765,50
2710.609196,56,66,0.32,10,0.032,50
2710.060618,49,61,0.3,12,0.025,50
2710.060618,48,62,0.35,14,0.025,50
2709.85039,61,72,0.31,11,0.028181818,50
2709.704998,26,92,0.34,66,0.005151515,50
2709.638391,44,49,0.19,5,0.038,50
2708.442629,62,96,0.6,34,0.017647059,50
2708.121152,43,51,0.28,8,0.035,50
2707.853857,40,68,0.09,28,0.003214286,50
2707.802901,55,89,0.88,34,0.025882353,50
2707.089459,67,77,0.21,10,0.021,50
2707.018734,63,79,0.36,16,0.0225,50
2706.942485,55,89,0.94,34,0.027647059,50
2706.707925,59,81,0.62,22,0.028181818,50
2706.607971,64,78,0.38,14,0.027142857,50
2706.579866,51,88,0.98,37,0.026486486,50
2706.020822,58,86,0.75,28,0.026785714,50
2705.095662,37,52,0.57,15,0.038,50
2704.822626,63,77,0.32,14,0.022857143,50
2704.629494,60,82,0.61,22,0.027727273,50
2703.508,67,75,0.21,8,0.02625,50
2702.816698,53,90,0.97,37,0.026216216,50
2702.281821,55,86,0.91,31,0.029354839,50
2702.248092,60,81,0.48,21,0.022857143,50
2701.569067,29,86,0.22,57,0.003859649,50
2701.119486,64,85,0.41,21,0.01952381,50
2700.944692,40,74,0.94,34,0.027647059,50
2700.906526,66,75,0.25,9,0.027777778,50
2700.906526,61,81,0.55,20,0.0275,50
2700.906526,58,85,0.74,27,0.027407407,50
2700.420497,8,52,0.56,44,0.012727273,50
2700.228168,64,87,0.61,23,0.026521739,50
2700.210078,58,94,0.74,36,0.020555556,50
2699.944571,62,95,0.59,33,0.017878788,50
2699.920211,14,24,0.1,10,0.01,50
2699.882715,55,89,0.95,34,0.027941176,50
2699.296016,41,49,0.3,8,0.0375,50
2699.257931,70,84,0.27,14,0.019285714,50
2699.011053,17,61,0.2,44,0.004545455,50
2699.001589,16,23,0.06,7,0.008571429,50
2698.989187,43,51,0.3,8,0.0375,50
2698.85846,59,83,0.66,24,0.0275,50
2698.84985,68,71,0.07,3,0.023333333,50
2698.843694,41,46,0.19,5,0.038,50
2698.141517,57,83,0.74,26,0.028461538,50
2697.987282,16,63,0.22,47,0.004680851,50
2697.75061,11,37,0.27,26,0.010384615,50
2697.534442,41,47,0.23,6,0.038333333,50
2697.402332,70,87,0.3,17,0.017647059,50
2697.164656,52,58,0.15,6,0.025,50
2697.164656,51,59,0.2,8,0.025,50
2697.136463,58,82,0.68,24,0.028333333,50
2697.12594,53,88,0.98,35,0.028,50
2697.095192,52,78,0.87,26,0.033461538,50
2696.910078,55,68,0.41,13,0.031538462,50
2696.862531,55,69,0.49,14,0.035,50
2696.312985,58,65,0.22,7,0.031428571,50
2696.294128,64,74,0.29,10,0.029,50
2696.096903,74,77,0.06,3,0.02,50
2696.096903,73,78,0.1,5,0.02,50
2695.787975,63,80,0.35,17,0.020588235,50
2695.746532,61,63,0.07,2,0.035,50
2695.746532,60,64,0.14,4,0.035,50
2695.746532,59,65,0.21,6,0.035,50
2695.746532,58,66,0.28,8,0.035,50
2695.746532,57,67,0.35,10,0.035,50
2695.576549,39,61,0.74,22,0.033636364,50
2695.441519,57,86,0.8,29,0.027586207,50
2695.441519,55,89,0.93,34,0.027352941,50
2695.26793,69,85,0.31,16,0.019375,50
2695.26793,68,86,0.35,18,0.019444444,50
2695.26793,64,91,0.52,27,0.019259259,50
2695.208543,55,87,0.87,32,0.0271875,50
2694.957999,11,37,0.32,26,0.012307692,50
2694.514057,29,86,0.2,57,0.003508772,50
2693.977822,63,86,0.45,23,0.019565217,50
2693.956952,24,99,0.33,75,0.0044,50
2693.453902,65,83,0.36,18,0.02,50
2693.213667,42,53,0.4,11,0.036363636,50
2692.903739,64,84,0.4,20,0.02,50
2691.907093,39,50,0.41,11,0.037272727,50
2691.737869,38,57,0.66,19,0.034736842,50
2691.388876,54,87,0.97,33,0.029393939,50
2691.35319,57,84,0.74,27,0.027407407,50
2691.324168,58,82,0.71,24,0.029583333,50
2691.324168,57,83,0.77,26,0.029615385,50
2691.073822,67,90,0.41,23,0.017826087,50
2691.069918,54,90,0.99,36,0.0275,50
2690.769126,16,63,0.21,47,0.004468085,50
2690.720836,54,86,0.95,32,0.0296875,50
2690.667899,25,96,0.35,71,0.004929577,50
2690.44719,43,61,0.59,18,0.032777778,50
2690.034725,38,60,0.75,22,0.034090909,50
2689.51763,41,72,0.87,31,0.028064516,50
2689.425847,68,75,0.2,7,0.028571429,50
2689.297025,60,80,0.59,20,0.0295,50
2689.297025,59,81,0.65,22,0.029545455,50
2689.081005,46,65,0.51,19,0.026842105,50
2688.495571,68,72,0.09,4,0.0225,50
2688.495571,66,74,0.18,8,0.0225,50
2688.495571,64,76,0.27,12,0.0225,50
2688.470289,67,80,0.33,13,0.025384615,50
2688.156022,65,84,0.37,19,0.019473684,50
2687.886545,55,86,0.87,31,0.028064516,50
2687.751975,59,84,0.68,25,0.0272,50
2687.61799,60,91,0.64,31,0.020645161,50
2687.33352,36,62,0.9,26,0.034615385,50
2686.979586,54,56,0.05,2,0.025,50
2686.979586,53,57,0.1,4,0.025,50
2686.82022,66,76,0.21,10,0.021,50
2686.77739,56,85,0.8,29,0.027586207,50
2686.369415,55,70,0.52,15,0.034666667,50
2686.369415,54,71,0.59,17,0.034705882,50
2686.369415,53,72,0.66,19,0.034736842,50
2686.309329,40,74,0.95,34,0.027941176,50
2686.275188,63,76,0.3,13,0.023076923,50
2685.782287,38,49,0.42,11,0.038181818,50
2684.480772,66,78,0.34,12,0.028333333,50
2684.420863,45,50,0.18,5,0.036,50
2684.390909,54,87,0.91,33,0.027575758,50
2684.390909,53,88,0.97,35,0.027714286,50
2684.152893,54,92,0.96,38,0.025263158,50
2683.826604,58,86,0.57,28,0.020357143,50
2683.588188,47,64,0.43,17,0.025294118,50
2683.378998,67,78,0.23,11,0.020909091,50
2683.265327,61,79,0.5,18,0.027777778,50
2683.265327,60,80,0.56,20,0.028,50
2683.265327,58,82,0.67,24,0.027916667,50
2683.265327,57,84,0.75,27,0.027777778,50
2683.265327,56,85,0.81,29,0.027931034,50
2683.265327,54,88,0.94,34,0.027647059,50
2682.958858,47,61,0.37,14,0.026428571,50
2682.686353,72,82,0.19,10,0.019,50
2682.535771,53,90,0.99,37,0.026756757,50
2682.48075,69,77,0.21,8,0.02625,50
2682.192924,27,93,0.33,66,0.005,50
2681.985223,57,77,0.56,20,0.028,50
2680.661801,59,84,0.65,25,0.026,50
2680.510698,58,72,0.29,14,0.020714286,50
2680.477475,58,71,0.44,13,0.033846154,50
2679.714127,39,56,0.59,17,0.034705882,50
2679.665141,53,84,0.84,31,0.027096774,50
2679.626459,52,79,0.81,27,0.03,50
2679.31155,65,76,0.25,11,0.022727273,50
2678.778868,68,88,0.38,20,0.019,50
2678.589844,56,87,0.71,31,0.022903226,50
2678.32608,64,85,0.42,21,0.02,50
2678.306756,70,86,0.3,16,0.01875,50
2678.306756,69,87,0.34,18,0.018888889,50
2678.306756,68,89,0.39,21,0.018571429,50
2678.228482,61,79,0.53,18,0.029444444,50
2678.095895,64,86,0.43,22,0.019545455,50
2677.860005,46,65,0.48,19,0.025263158,50
2677.64431,40,73,0.92,33,0.027878788,50
2677.199873,57,72,0.51,15,0.034,50
2677.199873,56,73,0.58,17,0.034117647,50
2677.199873,55,74,0.65,19,0.034210526,50
2677.163364,13,79,0.32,66,0.004848485,50
2676.923709,37,53,0.58,16,0.03625,50
2676.60111,53,77,0.73,24,0.030416667,50
2676.59222,66,80,0.28,14,0.02,50
2676.474578,50,81,0.94,31,0.030322581,50
2676.216392,55,88,0.88,33,0.026666667,50
2675.962342,46,64,0.46,18,0.025555556,50
2675.879685,72,78,0.16,6,0.026666667,50
2675.816016,48,60,0.31,12,0.025833333,50
2675.511836,36,75,0.11,39,0.002820513,50
2675.189238,63,85,0.45,22,0.020454545,50
2675.119966,54,88,0.99,34,0.029117647,50
2674.839492,66,84,0.35,18,0.019444444,50
2674.623397,56,68,0.42,12,0.035,50
2674.525914,65,80,0.32,15,0.021333333,50
2674.49573,55,79,0.66,24,0.0275,50
2674.49573,53,82,0.79,29,0.027241379,50
2674.452143,52,75,0.7,23,0.030434783,50
2674.430194,44,62,0.51,18,0.028333333,50
2674.37545,56,85,0.85,29,0.029310345,50
2674.119074,37,61,0.84,24,0.035,50
2674.064069,61,90,0.6,29,0.020689655,50
2673.676143,65,85,0.39,20,0.0195,50
2673.40808,58,83,0.68,25,0.0272,50
2673.208888,70,81,0.29,11,0.026363636,50
2673.178873,55,71,0.49,16,0.030625,50
2672.848936,44,63,0.53,19,0.027894737,50
2672.831596,39,74,0.98,35,0.028,50
2671.939456,16,20,0.05,4,0.0125,50
2671.670073,37,62,0.83,25,0.0332,50
2671.542192,53,88,0.96,35,0.027428571,50
2671.263111,28,93,0.29,65,0.004461538,50
2671.188302,53,82,0.8,29,0.027586207,50
2670.97527,57,77,0.55,20,0.0275,50
2670.97527,55,80,0.68,25,0.0272,50
2670.97527,52,83,0.85,31,0.027419355,50
2670.94783,63,95,0.6,32,0.01875,50
2670.874647,57,88,0.79,31,0.025483871,50
2670.766211,24,99,0.34,75,0.004533333,50
2670.72553,54,69,0.56,15,0.037333333,50
2670.700064,40,57,0.59,17,0.034705882,50
2670.396726,34,93,0.54,59,0.009152542,50
2670.215794,68,88,0.36,20,0.018,50
2669.89301,68,87,0.36,19,0.018947368,50
2669.851938,38,59,0.73,21,0.034761905,50
2669.806936,35,64,0.99,29,0.034137931,50
2669.673536,17,61,0.19,44,0.004318182,50
2669.575323,57,85,0.75,28,0.026785714,50
2669.497444,51,79,0.86,28,0.030714286,50
2669.19113,67,90,0.43,23,0.018695652,50
2669.19113,66,91,0.47,25,0.0188,50
2669.094946,39,59,0.67,20,0.0335,50
2668.749412,56,88,0.87,32,0.0271875,50
2668.719324,50,85,0.97,35,0.027714286,50
2668.666182,13,79,0.3,66,0.004545455,50
2668.645241,51,84,0.91,33,0.027575758,50
2668.548118,71,80,0.17,9,0.018888889,50
2668.291265,54,87,0.93,33,0.028181818,50
2668.094022,56,88,0.88,32,0.0275,50
2668.071435,59,83,0.64,24,0.026666667,50
2668.071435,56,87,0.82,31,0.026451613,50
2668.066297,62,79,0.46,17,0.027058824,50
2668.066297,60,81,0.57,21,0.027142857,50
2667.645644,38,54,0.55,16,0.034375,50
2667.588588,25,95,0.35,70,0.005,50
2667.580492,26,93,0.33,67,0.004925373,50
2667.546282,55,79,0.68,24,0.028333333,50
2667.392853,51,80,0.88,29,0.030344828,50
2667.241223,55,87,0.86,32,0.026875,50
2667.146491,55,86,0.88,31,0.028387097,50
2667.018161,45,67,0.56,22,0.025454545,50
2666.83541,67,83,0.43,16,0.026875,50
2666.83541,63,88,0.67,25,0.0268,50
2666.83541,61,91,0.8,30,0.026666667,50
2666.43976,29,87,0.19,58,0.003275862,50
2666.262643,35,61,0.92,26,0.035384615,50
2666.241711,62,79,0.38,17,0.022352941,50
2666.230543,59,84,0.52,25,0.0208,50
2666.157743,50,60,0.25,10,0.025,50
2666.055345,54,80,0.74,26,0.028461538,50
2665.794435,56,77,0.6,21,0.028571429,50
2665.794435,56,78,0.62,22,0.028181818,50
2665.78657,28,91,0.27,63,0.004285714,50
2665.734,59,74,0.42,15,0.028,50
2665.69914,54,72,0.62,18,0.034444444,50
2665.62605,71,83,0.22,12,0.018333333,50
2665.317129,52,73,0.73,21,0.034761905,50
2665.089369,67,84,0.45,17,0.026470588,50
2665.051817,64,81,0.44,17,0.025882353,50
2664.803392,57,87,0.81,30,0.027,50
2664.803392,55,90,0.94,35,0.026857143,50
2664.803148,57,78,0.58,21,0.027619048,50
2664.56811,38,62,0.82,24,0.034166667,50
2664.55889,56,84,0.8,28,0.028571429,50
2664.390106,54,82,0.77,28,0.0275,50
2664.273364,66,80,0.37,14,0.026428571,50
2664.215588,50,85,0.96,35,0.027428571,50
2664.165068,60,85,0.5,25,0.02,50
2664.059746,36,62,0.97,26,0.037307692,50
2663.818211,68,77,0.19,9,0.021111111,50
2663.551717,63,81,0.51,18,0.028333333,50
2663.446279,50,81,0.95,31,0.030645161,50
2663.366118,57,84,0.79,27,0.029259259,50
2663.319437,50,79,0.91,29,0.03137931,50
2663.31202,54,80,0.73,26,0.028076923,50
2663.199633,54,71,0.53,17,0.031176471,50
2663.048297,48,56,0.23,8,0.02875,50
2663.021811,54,81,0.74,27,0.027407407,50
2662.787023,39,51,0.45,12,0.0375,50
2662.787023,35,56,0.78,21,0.037142857,50
2662.700115,53,88,0.99,35,0.028285714,50
2662.428954,64,88,0.63,24,0.02625,50
2662.345398,63,87,0.47,24,0.019583333,50
2662.033838,61,81,0.45,20,0.0225,50
2661.931861,59,72,0.38,13,0.029230769,50
2661.633276,50,80,0.93,30,0.031,50
2661.442999,59,82,0.63,23,0.027391304,50
2661.336294,58,91,0.82,33,0.024848485,50
2661.334565,54,91,0.95,37,0.025675676,50
2661.333921,40,68,0.1,28,0.003571429,50
2660.921165,43,65,0.61,22,0.027727273,50
2660.714019,47,63,0.41,16,0.025625,50
2660.456621,51,80,0.87,29,0.03,50
2660.383733,64,91,0.51,27,0.018888889,50
2660.376936,61,81,0.56,20,0.028,50
2660.261111,73,80,0.13,7,0.018571429,50
2660.116483,64,69,0.14,5,0.028,50
2660.116483,58,76,0.5,18,0.027777778,50
2659.881099,58,67,0.28,9,0.031111111,50
2659.80667,37,53,0.6,16,0.0375,50
2659.559105,58,75,0.48,17,0.028235294,50
2659.559105,55,79,0.67,24,0.027916667,50
2659.552731,45,53,0.27,8,0.03375,50
2659.540333,50,86,0.97,36,0.026944444,50
2659.243153,69,86,0.32,17,0.018823529,50
2659.146847,52,83,0.86,31,0.027741935,50
2659.018706,62,87,0.49,25,0.0196,50
2658.845688,64,82,0.48,18,0.026666667,50
2658.800864,40,64,0.78,24,0.0325,50
2658.717877,46,59,0.37,13,0.028461538,50
2658.691307,67,89,0.41,22,0.018636364,50
2658.437232,68,73,0.14,5,0.028,50
2658.437232,62,80,0.5,18,0.027777778,50
2658.205698,59,82,0.67,23,0.029130435,50
2658.205698,58,83,0.73,25,0.0292,50
2658.06146,56,67,0.35,11,0.031818182,50
2658.06146,53,70,0.54,17,0.031764706,50
2657.928172,54,89,0.94,35,0.026857143,50
2657.204011,52,85,0.9,33,0.027272727,50
2657.066643,66,90,0.45,24,0.01875,50
2657.066643,65,91,0.49,26,0.018846154,50
2657.066643,64,92,0.53,28,0.018928571,50
2657.066643,63,93,0.57,30,0.019,50
2656.99705,54,68,0.45,14,0.032142857,50
2656.916229,58,83,0.69,25,0.0276,50
2656.857888,10,40,0.34,30,0.011333333,50
2656.809699,56,93,0.93,37,0.025135135,50
2656.546079,54,85,0.82,31,0.026451613,50
2656.515232,64,93,0.54,29,0.01862069,50
2656.481463,45,57,0.4,12,0.033333333,50
2656.476092,52,78,0.8,26,0.030769231,50
2656.242716,57,67,0.37,10,0.037,50
2656.193579,54,89,0.93,35,0.026571429,50
2656.147791,62,95,0.63,33,0.019090909,50
2656.09439,63,94,0.59,31,0.019032258,50
2656.083358,53,89,0.99,36,0.0275,50
2656.078145,60,83,0.48,23,0.020869565,50
2655.941032,61,73,0.33,12,0.0275,50
2655.881095,37,50,0.5,13,0.038461538,50
2655.635788,43,69,0.69,26,0.026538462,50
2655.627613,62,93,0.6,31,0.019354839,50
2655.463571,56,86,0.81,30,0.027,50
2655.180451,15,22,0.08,7,0.011428571,50
2654.767957,30,88,0.13,58,0.002241379,50
2654.743329,25,96,0.34,71,0.004788732,50
2654.32279,49,62,0.32,13,0.024615385,50
2654.250207,61,95,0.66,34,0.019411765,50
2654.117107,55,81,0.71,26,0.027307692,50
2654.099523,55,90,0.95,35,0.027142857,50
2654.036921,70,80,0.27,10,0.027,50
2653.894672,15,24,0.08,9,0.008888889,50
2653.775468,28,88,0.26,60,0.004333333,50
2653.6688,52,77,0.78,25,0.0312,50
2653.636231,65,78,0.28,13,0.021538462,50
2653.458497,57,81,0.64,24,0.026666667,50
2653.447715,50,80,0.92,30,0.030666667,50
2653.424018,55,86,0.81,31,0.026129032,50
2653.391128,59,75,0.44,16,0.0275,50
2653.262379,45,61,0.45,16,0.028125,50
2653.220983,53,86,0.88,33,0.026666667,50
2653.199326,45,58,0.43,13,0.033076923,50
2653.009598,58,84,0.59,26,0.022692308,50
2653.007309,64,82,0.46,18,0.025555556,50
2653.007309,59,88,0.74,29,0.025517241,50
2653.007309,58,90,0.81,32,0.0253125,50
2652.820865,59,87,0.55,28,0.019642857,50
2652.662137,64,87,0.62,23,0.026956522,50
2652.662137,62,89,0.73,27,0.027037037,50
2652.382868,64,77,0.37,13,0.028461538,50
2651.745736,35,61,0.93,26,0.035769231,50
2651.699802,63,92,0.56,29,0.019310345,50
2651.512763,51,85,0.92,34,0.027058824,50
2651.510328,48,63,0.37,15,0.024666667,50
2651.318618,13,77,0.31,64,0.00484375,50
2651.295342,56,89,0.66,33,0.02,50
2651.173067,62,79,0.39,17,0.022941176,50
2651.056283,59,84,0.66,25,0.0264,50
2651.056283,55,89,0.9,34,0.026470588,50
2651.040106,71,79,0.21,8,0.02625,50
2650.682781,53,87,0.9,34,0.026470588,50
2650.431019,36,63,0.92,27,0.034074074,50
2650.343406,65,69,0.11,4,0.0275,50
2650.343406,63,71,0.22,8,0.0275,50
2650.066666,51,74,0.8,23,0.034782609,50
2649.864577,18,19,0.01,1,0.01,50
2649.822349,54,88,0.92,34,0.027058824,50
2649.548267,49,81,0.99,32,0.0309375,50
2649.470179,57,87,0.62,30,0.020666667,50
2649.460268,56,86,0.8,30,0.026666667,50
2649.005869,35,63,0.98,28,0.035,50
2648.641417,13,79,0.31,66,0.00469697,50
2648.247295,56,80,0.65,24,0.027083333,50
2648.199901,61,97,0.64,36,0.017777778,50
2647.825375,53,61,0.21,8,0.02625,50
2647.796333,54,80,0.72,26,0.027692308,50
2647.770217,55,86,0.86,31,0.027741935,50
2647.770217,54,87,0.92,33,0.027878788,50
2647.770217,54,88,0.93,34,0.027352941,50
2647.527388,57,75,0.52,18,0.028888889,50
2647.333079,41,47,0.22,6,0.036666667,50
2647.299697,39,58,0.67,19,0.035263158,50
2647.123908,37,89,0.43,52,0.008269231,50
2647.02926,15,23,0.08,8,0.01,50
2646.929156,56,78,0.61,22,0.027727273,50
2646.765776,12,27,0.21,15,0.014,50
2646.651636,54,81,0.75,27,0.027777778,50
2646.51359,53,78,0.75,25,0.03,50
2646.474646,42,63,0.68,21,0.032380952,50
2646.446302,62,71,0.25,9,0.027777778,50
2646.199947,31,86,0.12,55,0.002181818,50
2646.15654,61,75,0.43,14,0.030714286,50
2646.051781,72,79,0.14,7,0.02,50
2646.011903,56,81,0.68,25,0.0272,50
2645.99181,55,83,0.75,28,0.026785714,50
2645.904606,55,76,0.62,21,0.02952381,50
2645.902905,51,83,0.89,32,0.0278125,50
2645.805788,70,82,0.31,12,0.025833333,50
2645.805788,66,86,0.52,20,0.026,50
2645.805788,66,87,0.54,21,0.025714286,50
2645.787555,61,82,0.44,21,0.020952381,50
2645.78659,54,83,0.79,29,0.027241379,50
2645.704509,52,84,0.87,32,0.0271875,50
2645.704509,51,85,0.93,34,0.027352941,50
2645.408443,68,71,0.08,3,0.026666667,50
2645.408443,65,74,0.24,9,0.026666667,50
2645.408443,63,76,0.35,13,0.026923077,50
2645.379862,45,65,0.52,20,0.026,50
2645.100982,65,76,0.31,11,0.028181818,50
2645.087174,40,65,0.81,25,0.0324,50
2644.888397,60,82,0.62,22,0.028181818,50
2644.733866,62,80,0.4,18,0.022222222,50
2644.733446,25,97,0.32,72,0.004444444,50
2644.51336,16,22,0.06,6,0.01,50
2644.31697,53,82,0.81,29,0.027931034,50
2644.31697,52,83,0.87,31,0.028064516,50
2644.299234,55,70,0.53,15,0.035333333,50
2644.286194,37,60,0.81,23,0.035217391,50
2644.279978,16,21,0.07,5,0.014,50
2644.187663,52,88,0.95,36,0.026388889,50
2643.996663,2,23,0.84,21,0.04,50
2643.77582,39,58,0.66,19,0.034736842,50
2643.730545,54,91,0.98,37,0.026486486,50
2643.725841,65,86,0.56,21,0.026666667,50
2643.725841,62,90,0.74,28,0.026428571,50
2643.725841,58,95,0.98,37,0.026486486,50
2643.694941,72,76,0.11,4,0.0275,50
2643.694941,70,78,0.22,8,0.0275,50
2643.694941,69,80,0.3,11,0.027272727,50
2643.694941,67,82,0.41,15,0.027333333,50
2643.694941,65,84,0.52,19,0.027368421,50
2643.677781,55,82,0.74,27,0.027407407,50
2643.621323,40,60,0.67,20,0.0335,50
2643.309116,41,56,0.51,15,0.034,50
2643.309116,40,57,0.58,17,0.034117647,50
2643.220502,10,33,0.38,23,0.016521739,50
2643.085179,54,90,0.96,36,0.026666667,50
2642.8613,56,85,0.79,29,0.027241379,50
2642.838547,51,84,0.93,33,0.028181818,50
2642.736942,62,89,0.55,27,0.02037037,50
2642.736942,61,90,0.59,29,0.020344828,50
2642.736942,59,92,0.68,33,0.020606061,50
2642.736942,59,93,0.69,34,0.020294118,50
2642.594948,42,52,0.35,10,0.035,50
2642.594948,41,53,0.42,12,0.035,50
2642.362011,30,89,0.12,59,0.002033898,50
2642.246645,53,83,0.81,30,0.027,50
2642.016684,61,80,0.44,19,0.023157895,50
2641.811155,54,87,0.87,33,0.026363636,50
2641.516028,66,76,0.29,10,0.029,50
2640.960375,26,99,0.31,73,0.004246575,50
2640.851963,54,88,0.95,34,0.027941176,50
2640.783167,67,87,0.39,20,0.0195,50
2640.783167,66,88,0.43,22,0.019545455,50
2640.783167,65,89,0.47,24,0.019583333,50
2640.519576,42,47,0.19,5,0.038,50
2640.397985,38,57,0.67,19,0.035263158,50
2640.137704,66,92,0.46,26,0.017692308,50
2640.044894,61,83,0.58,22,0.026363636,50
2640.010151,61,75,0.38,14,0.027142857,50
2639.712327,57,80,0.62,23,0.026956522,50
2639.651854,28,89,0.19,61,0.003114754,50
2639.483876,51,87,0.96,36,0.026666667,50
2639.301719,62,80,0.48,18,0.026666667,50
2639.099673,53,73,0.62,20,0.031,50
2639.089582,58,86,0.58,28,0.020714286,50
2639.030612,67,85,0.47,18,0.026111111,50
2638.88287,38,52,0.5,14,0.035714286,50
2638.765313,50,87,0.99,37,0.026756757,50
2638.759989,51,84,0.9,33,0.027272727,50
2638.689618,40,51,0.39,11,0.035454545,50
2638.519969,24,98,0.37,74,0.005,50
2638.422192,40,73,0.93,33,0.028181818,50
2638.364991,53,89,0.98,36,0.027222222,50
2638.260509,42,70,0.81,28,0.028928571,50
2638.184061,55,75,0.42,20,0.021,50
2637.823614,27,94,0.32,67,0.004776119,50
2637.762631,51,86,0.96,35,0.027428571,50
2637.665099,56,83,0.81,27,0.03,50
2637.350829,68,86,0.34,18,0.018888889,50
2637.196384,15,20,0.08,5,0.016,50
2637.124416,38,87,0.4,49,0.008163265,50
2637.080281,37,88,0.44,51,0.008627451,50
2636.780394,65,75,0.29,10,0.029,50
2636.759281,59,78,0.58,19,0.030526316,50
2636.686201,57,87,0.79,30,0.026333333,50
2636.676834,53,84,0.83,31,0.026774194,50
2636.57158,50,86,0.98,36,0.027222222,50
2636.365139,39,66,0.88,27,0.032592593,50
2636.351117,47,59,0.34,12,0.028333333,50
2636.214732,65,79,0.3,14,0.021428571,50
2636.196138,67,74,0.2,7,0.028571429,50
2636.196138,63,78,0.43,15,0.028666667,50
2636.188394,59,85,0.67,26,0.025769231,50
2636.162273,62,79,0.49,17,0.028823529,50
2636.009822,25,96,0.32,71,0.004507042,50
2635.729755,55,71,0.55,16,0.034375,50
2635.64764,54,91,0.97,37,0.026216216,50
2635.495478,59,83,0.68,24,0.028333333,50
2635.485433,67,86,0.49,19,0.025789474,50
2635.48372,61,85,0.51,24,0.02125,50
2635.381432,38,87,0.42,49,0.008571429,50
2635.220712,49,78,0.89,29,0.030689655,50
2635.132374,63,90,0.7,27,0.025925926,50
2635.024354,58,79,0.57,21,0.027142857,50
2635.024354,56,82,0.7,26,0.026923077,50
2634.889401,59,93,0.91,34,0.026764706,50
2634.820272,41,63,0.72,22,0.032727273,50
2634.54131,40,64,0.79,24,0.032916667,50
2634.538243,57,87,0.61,30,0.020333333,50
2634.492016,35,60,0.94,25,0.0376,50
2634.382381,73,75,0.04,2,0.02,50
2634.382381,72,76,0.08,4,0.02,50
2634.375646,56,79,0.63,23,0.027391304,50
2634.375646,54,82,0.76,28,0.027142857,50
2634.326517,64,80,0.45,16,0.028125,50
2634.304334,49,56,0.2,7,0.028571429,50
2634.18841,59,83,0.54,24,0.0225,50
2634.157157,35,97,0.16,62,0.002580645,50
2634.071731,50,57,0.18,7,0.025714286,50
2633.935859,54,87,0.94,33,0.028484848,50
2633.924473,61,75,0.42,14,0.03,50
2633.880833,60,95,0.84,35,0.024,50
2633.818916,30,88,0.14,58,0.002413793,50
2633.5981,56,88,0.66,32,0.020625,50
2633.498573,17,20,0.04,3,0.013333333,50
2633.473827,60,73,0.36,13,0.027692308,50
2633.34452,56,71,0.45,15,0.03,50
2633.219312,53,78,0.74,25,0.0296,50
2633.196207,64,78,0.31,14,0.022142857,50
2633.021594,65,92,0.51,27,0.018888889,50
2632.993832,53,83,0.83,30,0.027666667,50
2632.945142,57,84,0.8,27,0.02962963,50
2632.945142,56,85,0.86,29,0.029655172,50
2632.846041,35,55,0.74,20,0.037,50
2632.83583,64,93,0.55,29,0.018965517,50
2632.709187,63,83,0.42,20,0.021,50
2632.702353,36,58,0.84,22,0.038181818,50
2632.523305,31,86,0.13,55,0.002363636,50
2632.367302,65,77,0.32,12,0.026666667,50
2632.367302,58,85,0.72,27,0.026666667,50
2632.352736,66,77,0.29,11,0.026363636,50
2632.21899,38,72,0.08,34,0.002352941,50
2632.063552,68,74,0.13,6,0.021666667,50
2632.017441,54,74,0.43,20,0.0215,50
2631.893305,71,78,0.19,7,0.027142857,50
2631.893305,65,85,0.54,20,0.027,50
2631.893305,63,87,0.65,24,0.027083333,50
2631.893305,61,90,0.78,29,0.026896552,50
2631.610751,55,87,0.94,32,0.029375,50
2631.521509,52,84,0.89,32,0.0278125,50
2631.460122,67,77,0.28,10,0.028,50
2631.432451,40,49,0.34,9,0.037777778,50
2631.429421,53,81,0.8,28,0.028571429,50
2631.126628,58,84,0.69,26,0.026538462,50
2630.967817,63,80,0.37,17,0.021764706,50
2630.906766,36,63,0.91,27,0.033703704,50
2630.904157,55,83,0.76,28,0.027142857,50
2630.807381,58,77,0.52,19,0.027368421,50
2630.682339,41,58,0.57,17,0.033529412,50
2630.608611,29,87,0.2,58,0.003448276,50
2630.512222,40,55,0.52,15,0.034666667,50
2630.469839,55,78,0.66,23,0.028695652,50
2630.270804,57,86,0.77,29,0.026551724,50
2630.215156,51,75,0.74,24,0.030833333,50
2629.726723,35,65,0.99,30,0.033,50
2629.451873,9,39,0.38,30,0.012666667,50
2629.402182,54,69,0.48,15,0.032,50
2629.353265,36,94,0.05,58,0.000862069,50
2629.269049,36,60,0.81,24,0.03375,50
2629.186545,53,84,0.85,31,0.027419355,50
2629.008873,56,87,0.83,31,0.026774194,50
2628.79003,60,76,0.48,16,0.03,50
2628.735722,71,81,0.26,10,0.026,50
2628.704325,60,77,0.52,17,0.030588235,50
2628.596821,60,76,0.44,16,0.0275,50
2628.590955,52,88,0.96,36,0.026666667,50
2628.576511,53,73,0.69,20,0.0345,50
2628.431568,60,83,0.61,23,0.026521739,50
2628.273177,11,37,0.31,26,0.011923077,50
2627.993221,54,84,0.81,30,0.027,50
2627.877799,56,70,0.48,14,0.034285714,50
2627.872274,35,62,0.95,27,0.035185185,50
2627.812979,61,79,0.42,18,0.023333333,50
2627.597683,67,76,0.26,9,0.028888889,50
2627.567631,68,76,0.17,8,0.02125,50
2627.388295,50,86,0.99,36,0.0275,50
2627.32032,58,79,0.64,21,0.03047619,50
2627.256049,74,82,0.15,8,0.01875,50
2627.219017,57,71,0.3,14,0.021428571,50
2627.213847,63,92,0.73,29,0.025172414,50
2627.16414,37,67,0.98,30,0.032666667,50
2626.937244,27,94,0.33,67,0.004925373,50
2626.93415,42,71,0.77,29,0.026551724,50
2626.807374,55,72,0.51,17,0.03,50
2626.609591,58,70,0.43,12,0.035833333,50
2626.370667,62,88,0.51,26,0.019615385,50
2626.106202,25,96,0.33,71,0.004647887,50
2626.051789,65,88,0.59,23,0.025652174,50
2626.018087,52,81,0.82,29,0.028275862,50
2626.018087,51,82,0.88,31,0.028387097,50
2625.944505,40,49,0.33,9,0.036666667,50
2625.888269,58,73,0.44,15,0.029333333,50
2625.755534,53,81,0.79,28,0.028214286,50
2625.474194,42,61,0.63,19,0.033157895,50
2625.455057,55,89,0.71,34,0.020882353,50
2625.348935,57,83,0.69,26,0.026538462,50
2625.318853,53,86,0.89,33,0.026969697,50
2625.164364,50,84,0.95,34,0.027941176,50
2625.037534,36,90,0.5,54,0.009259259,50
2624.983903,64,79,0.4,15,0.026666667,50
2624.874549,40,50,0.38,10,0.038,50
2624.788112,54,74,0.72,20,0.036,50
2624.733244,61,83,0.44,22,0.02,50
2624.623301,57,86,0.61,29,0.021034483,50
2624.57958,58,72,0.42,14,0.03,50
2624.423324,59,86,0.54,27,0.02,50
2624.34308,57,85,0.77,28,0.0275,50
2624.061134,57,89,0.64,32,0.02,50
2623.999048,34,98,0.19,64,0.00296875,50
2623.958913,56,88,0.85,32,0.0265625,50
2623.874901,54,87,0.86,33,0.026060606,50
2623.590617,58,66,0.29,8,0.03625,50
2623.574099,51,82,0.89,31,0.028709677,50
2623.574099,50,83,0.95,33,0.028787879,50
2623.455123,56,76,0.58,20,0.029,50
2623.431202,55,88,0.87,33,0.026363636,50
2623.374475,69,84,0.28,15,0.018666667,50
2623.296165,58,94,0.98,36,0.027222222,50
2623.142253,64,76,0.28,12,0.023333333,50
2623.062381,57,86,0.82,29,0.028275862,50
2622.689368,64,80,0.34,16,0.02125,50
2622.689368,63,82,0.4,19,0.021052632,50
2622.657339,59,77,0.49,18,0.027222222,50
2622.5035,64,78,0.39,14,0.027857143,50
2622.382663,62,77,0.4,15,0.026666667,50
2622.318928,27,93,0.34,66,0.005151515,50
2622.27213,53,79,0.75,26,0.028846154,50
2622.260643,56,88,0.84,32,0.02625,50
2622.238684,68,82,0.38,14,0.027142857,50
2622.238684,66,84,0.49,18,0.027222222,50
2622.192071,37,61,0.82,24,0.034166667,50
2622.033924,51,86,0.94,35,0.026857143,50
2621.99596,52,77,0.89,25,0.0356,50
2621.99596,51,78,0.96,27,0.035555556,50
2621.95237,57,86,0.76,29,0.026206897,50
2621.893982,62,81,0.51,19,0.026842105,50
2621.81192,60,76,0.49,16,0.030625,50
2621.81192,57,80,0.7,23,0.030434783,50
2621.81192,56,80,0.74,24,0.030833333,50
2621.81192,56,81,0.76,25,0.0304,50
2621.81192,55,82,0.82,27,0.03037037,50
2621.706893,59,91,0.68,32,0.02125,50
2621.60876,36,89,0.49,53,0.009245283,50
2621.524668,68,74,0.16,6,0.026666667,50
2621.446182,64,86,0.6,22,0.027272727,50
2621.399168,40,59,0.65,19,0.034210526,50
2621.18365,56,86,0.87,30,0.029,50
2621.18365,55,87,0.93,32,0.0290625,50
2621.168907,54,84,0.82,30,0.027333333,50
2621.160957,58,88,0.6,30,0.02,50
2621.106172,53,76,0.81,23,0.035217391,50
2621.106172,52,77,0.88,25,0.0352,50
2621.085376,63,81,0.36,18,0.02,50
2620.777397,58,84,0.7,26,0.026923077,50
2620.421579,54,87,0.98,33,0.02969697,50
2620.279835,27,96,0.31,69,0.004492754,50
2619.957395,58,78,0.55,20,0.0275,50
2619.853253,65,91,0.47,26,0.018076923,50
2619.853253,64,93,0.52,29,0.017931034,50
2619.725307,56,69,0.4,13,0.030769231,50
2619.618836,52,76,0.52,24,0.021666667,50
2619.600791,51,77,0.93,26,0.035769231,50
2619.293122,37,52,0.55,15,0.036666667,50
2619.010393,36,63,0.94,27,0.034814815,50
2618.995238,34,80,0.08,46,0.00173913,50
2618.744504,60,98,0.67,38,0.017631579,50
2618.625768,39,60,0.72,21,0.034285714,50
2618.622262,38,87,0.41,49,0.008367347,50
2618.619492,40,73,0.95,33,0.028787879,50
2618.491709,42,70,0.82,28,0.029285714,50
2618.399793,64,80,0.32,16,0.02,50
2618.168817,52,80,0.81,28,0.028928571,50
2618.101294,62,85,0.58,23,0.025217391,50
2618.101294,61,86,0.63,25,0.0252,50
2618.034341,71,85,0.26,14,0.018571429,50
2618.001138,61,97,0.63,36,0.0175,50
2617.932082,64,90,0.66,26,0.025384615,50
2617.930656,54,89,0.92,35,0.026285714,50
2617.930656,53,91,0.99,38,0.026052632,50
2617.843046,53,75,0.78,22,0.035454545,50
2617.629806,36,54,0.68,18,0.037777778,50
2617.539393,68,76,0.21,8,0.02625,50
2617.476304,60,84,0.49,24,0.020416667,50
2617.413529,58,66,0.25,8,0.03125,50
2617.348512,67,74,0.19,7,0.027142857,50
2617.348512,63,79,0.43,16,0.026875,50
2617.348512,61,81,0.54,20,0.027,50
2617.348512,60,82,0.59,22,0.026818182,50
2617.338587,45,66,0.54,21,0.025714286,50
2617.337232,37,89,0.42,52,0.008076923,50
2617.335781,72,79,0.18,7,0.025714286,50
2617.204616,63,85,0.44,22,0.02,50
2617.204616,62,86,0.48,24,0.02,50
2617.176302,42,56,0.48,14,0.034285714,50
2617.176302,41,57,0.55,16,0.034375,50
2617.176302,40,58,0.62,18,0.034444444,50
2616.963003,36,59,0.83,23,0.036086957,50
2616.731475,53,85,0.87,32,0.0271875,50
2616.716638,55,82,0.73,27,0.027037037,50
2616.641287,60,83,0.64,23,0.027826087,50
2616.641287,57,87,0.83,30,0.027666667,50
2616.594731,61,82,0.46,21,0.021904762,50
2616.561129,38,59,0.74,21,0.035238095,50
2616.439626,41,61,0.67,20,0.0335,50
2616.394631,62,64,0.06,2,0.03,50
2616.135005,51,86,0.95,35,0.027142857,50
2616.036274,68,78,0.26,10,0.026,50
2616.036274,67,78,0.29,11,0.026363636,50
2615.880895,59,93,0.92,34,0.027058824,50
2615.829526,55,80,0.69,25,0.0276,50
2615.783328,61,66,0.18,5,0.036,50
2615.616523,64,81,0.36,17,0.021176471,50
2615.455163,62,92,0.77,30,0.025666667,50
2615.352739,61,78,0.4,17,0.023529412,50
2615.134247,62,74,0.37,12,0.030833333,50
2615.053757,55,72,0.58,17,0.034117647,50
2614.802668,36,90,0.45,54,0.008333333,50
2614.737253,29,90,0.25,61,0.004098361,50
2614.648667,56,72,0.57,16,0.035625,50
2614.648667,55,73,0.64,18,0.035555556,50
2614.622349,73,78,0.13,5,0.026,50
2614.590198,54,90,0.95,36,0.026388889,50
2614.470646,60,92,0.86,32,0.026875,50
2614.267249,63,78,0.41,15,0.027333333,50
2614.267249,61,80,0.52,19,0.027368421,50
2614.267249,59,83,0.65,24,0.027083333,50
2614.20755,38,71,0.1,33,0.003030303,50
2614.157989,59,85,0.68,26,0.026153846,50
2614.157989,56,89,0.86,33,0.026060606,50
2614.129854,52,76,0.86,24,0.035833333,50
2613.951313,58,82,0.64,24,0.026666667,50
2613.951313,56,84,0.75,28,0.026785714,50
2613.739518,50,84,0.96,34,0.028235294,50
2613.719992,51,86,0.97,35,0.027714286,50
2613.638374,62,80,0.51,18,0.028333333,50
2613.532288,58,85,0.73,27,0.027037037,50
2613.386458,52,78,0.81,26,0.031153846,50
2613.330937,47,60,0.34,13,0.026153846,50
2613.286964,51,78,0.95,27,0.035185185,50
2613.248848,54,74,0.71,20,0.0355,50
2613.199716,69,75,0.17,6,0.028333333,50
2612.977067,63,79,0.45,16,0.028125,50
2612.93659,56,89,0.87,33,0.026363636,50
2612.804384,29,91,0.12,62,0.001935484,50
2612.773084,61,96,0.63,35,0.018,50
2612.594605,57,80,0.63,23,0.027391304,50
2612.56859,66,80,0.36,14,0.025714286,50
2612.56859,66,81,0.38,15,0.025333333,50
2612.56859,65,81,0.41,16,0.025625,50
2612.56859,65,82,0.43,17,0.025294118,50
2612.56859,64,83,0.48,19,0.025263158,50
2612.56859,62,85,0.59,23,0.025652174,50
2612.56859,61,86,0.64,25,0.0256,50
2612.56859,60,87,0.69,27,0.025555556,50
2612.56859,59,89,0.76,30,0.025333333,50
2612.458706,60,79,0.51,19,0.026842105,50
2612.454519,59,89,0.75,30,0.025,50
2612.446163,53,83,0.82,30,0.027333333,50
2612.40138,8,51,0.59,43,0.01372093,50
2612.400536,52,84,0.88,32,0.0275,50
2612.36564,38,66,0.92,28,0.032857143,50
2612.280981,51,85,0.95,34,0.027941176,50
2612.197375,52,82,0.85,30,0.028333333,50
2612.016113,62,88,0.71,26,0.027307692,50
2611.919162,65,92,0.5,27,0.018518519,50
2611.811742,75,76,0.02,1,0.02,50
2611.577228,52,82,0.83,30,0.027666667,50
2611.458115,55,90,0.91,35,0.026,50
2611.408978,54,90,0.94,36,0.026111111,50
2611.358574,57,70,0.47,13,0.036153846,50
2611.290053,55,87,0.88,32,0.0275,50
2611.282376,68,77,0.23,9,0.025555556,50
2611.258647,53,81,0.78,28,0.027857143,50
2611.231774,53,84,0.95,31,0.030645161,50
2611.07011,53,88,0.92,35,0.026285714,50
2611.049396,50,81,0.93,31,0.03,50
2611.027271,64,66,0.06,2,0.03,50
2611.027271,63,67,0.12,4,0.03,50
2611.027271,62,68,0.18,6,0.03,50
2611.027271,61,69,0.24,8,0.03,50
2611.027271,60,70,0.3,10,0.03,50
2611.027271,59,71,0.36,12,0.03,50
2610.975432,53,90,0.98,37,0.026486486,50
2610.935425,64,82,0.47,18,0.026111111,50
2610.935425,61,85,0.63,24,0.02625,50
2610.935425,61,86,0.65,25,0.026,50
2610.935425,58,89,0.81,31,0.026129032,50
2610.787598,49,52,0.1,3,0.033333333,50
2610.781281,45,59,0.46,14,0.032857143,50
2610.671792,28,92,0.31,64,0.00484375,50
2610.483006,56,86,0.83,30,0.027666667,50
2610.483006,55,88,0.9,33,0.027272727,50
2610.483006,54,89,0.96,35,0.027428571,50
2610.483006,54,90,0.97,36,0.026944444,50
2610.398205,60,82,0.5,22,0.022727273,50
2610.398205,57,86,0.66,29,0.022758621,50
2610.368722,38,65,0.9,27,0.033333333,50
2610.221051,40,61,0.71,21,0.033809524,50
2610.09865,52,57,0.13,5,0.026,50
2609.949182,54,83,0.8,29,0.027586207,50
2609.864317,54,85,0.83,31,0.026774194,50
2609.864317,52,87,0.94,35,0.026857143,50
2609.817813,60,81,0.58,21,0.027619048,50
2609.817813,58,84,0.71,26,0.027307692,50
2609.817813,57,85,0.76,28,0.027142857,50
2609.817813,57,86,0.78,29,0.026896552,50
2609.817813,56,86,0.82,30,0.027333333,50
2609.817813,56,87,0.84,31,0.027096774,50
2609.817813,55,88,0.89,33,0.026969697,50
2609.817813,54,89,0.95,35,0.027142857,50
2609.708732,55,90,0.92,35,0.026285714,50
2609.626349,55,86,0.92,31,0.029677419,50
2609.550123,40,56,0.56,16,0.035,50
2609.309904,69,88,0.35,19,0.018421053,50
2609.185125,61,85,0.67,24,0.027916667,50
2609.167324,59,86,0.55,27,0.02037037,50
2609.084478,27,96,0.32,69,0.004637681,50
2608.808236,62,82,0.4,20,0.02,50
2608.763675,36,58,0.83,22,0.037727273,50
2608.763675,35,59,0.91,24,0.037916667,50
2608.628107,45,52,0.24,7,0.034285714,50
2608.458776,59,77,0.5,18,0.027777778,50
2608.43435,59,81,0.58,22,0.026363636,50
2608.42549,29,91,0.13,62,0.002096774,50
2608.408514,30,85,0.2,55,0.003636364,50
2608.38638,36,90,0.46,54,0.008518519,50
2608.296262,39,51,0.43,12,0.035833333,50
2608.251255,51,73,0.78,22,0.035454545,50
2608.154841,47,66,0.46,19,0.024210526,50
2608.121939,60,88,0.71,28,0.025357143,50
2608.121939,57,92,0.88,35,0.025142857,50
2608.081502,57,91,0.88,34,0.025882353,50
2608.066446,39,74,0.99,35,0.028285714,50
2607.944135,67,84,0.44,17,0.025882353,50
2607.941401,39,64,0.83,25,0.0332,50
2607.899816,38,64,0.86,26,0.033076923,50
2607.886712,48,62,0.36,14,0.025714286,50
2607.831965,66,90,0.44,24,0.018333333,50
2607.817433,24,98,0.35,74,0.00472973,50
2607.716493,70,83,0.33,13,0.025384615,50
2607.716493,69,84,0.38,15,0.025333333,50
2607.594787,53,75,0.79,22,0.035909091,50
2607.512553,59,92,0.69,33,0.020909091,50
2607.479983,38,60,0.74,22,0.033636364,50
2607.476151,54,79,0.71,25,0.0284,50
2607.465845,54,91,0.76,37,0.020540541,50
2607.391084,47,62,0.38,15,0.025333333,50
2607.380301,11,38,0.3,27,0.011111111,50
2607.363274,59,79,0.49,20,0.0245,50
2607.363274,58,80,0.54,22,0.024545455,50
2607.102491,57,90,0.89,33,0.026969697,50
2606.882825,26,99,0.3,73,0.004109589,50
2606.86947,69,76,0.18,7,0.025714286,50
2606.86947,63,83,0.51,20,0.0255,50
2606.86947,62,84,0.56,22,0.025454545,50
2606.85108,54,88,0.91,34,0.026764706,50
2606.796602,50,83,0.94,33,0.028484848,50
2606.763307,35,55,0.73,20,0.0365,50
2606.742085,65,81,0.42,16,0.02625,50
2606.673802,60,83,0.51,23,0.022173913,50
2606.542535,53,76,0.72,23,0.031304348,50
2606.535911,37,89,0.41,52,0.007884615,50
2606.183071,41,62,0.69,21,0.032857143,50
2606.124631,60,67,0.25,7,0.035714286,50
2606.068915,59,85,0.69,26,0.026538462,50
2605.971307,62,81,0.5,19,0.026315789,50
2605.971307,60,84,0.63,24,0.02625,50
2605.971307,58,86,0.74,28,0.026428571,50
2605.878221,34,97,0.2,63,0.003174603,50
2605.86122,15,23,0.11,8,0.01375,50
2605.824065,72,73,0.02,1,0.02,50
2605.824065,71,74,0.06,3,0.02,50
2605.824065,70,75,0.1,5,0.02,50
2605.824065,69,76,0.14,7,0.02,50
2605.824065,68,77,0.18,9,0.02,50
2605.808103,41,50,0.32,9,0.035555556,50
2605.741566,64,78,0.41,14,0.029285714,50
2605.741566,63,79,0.47,16,0.029375,50
2605.701847,70,75,0.13,5,0.026,50
2605.701847,67,79,0.31,12,0.025833333,50
2605.701847,62,84,0.57,22,0.025909091,50
2605.686391,49,66,0.44,17,0.025882353,50
2605.563013,49,57,0.21,8,0.02625,50
2605.221373,68,83,0.4,15,0.026666667,50
2605.174784,53,80,0.77,27,0.028518519,50
2605.152553,10,36,0.35,26,0.013461538,50
2605.051139,58,90,0.82,32,0.025625,50
2605.051139,57,91,0.87,34,0.025588235,50
2605.051139,56,93,0.94,37,0.025405405,50
2604.879209,67,89,0.42,22,0.019090909,50
2604.879209,66,90,0.46,24,0.019166667,50
2604.747538,60,87,0.53,27,0.01962963,50
2604.356619,28,93,0.31,65,0.004769231,50
2604.340178,46,51,0.17,5,0.034,50
2604.305945,36,75,0.1,39,0.002564103,50
2604.272975,63,84,0.53,21,0.025238095,50
2604.272975,62,86,0.6,24,0.025,50
2604.272975,61,87,0.65,26,0.025,50
2604.272975,60,88,0.7,28,0.025,50
2604.069211,56,71,0.54,15,0.036,50
2604.011522,64,84,0.39,20,0.0195,50
2603.969321,37,59,0.83,22,0.037727273,50
2603.836888,57,71,0.5,14,0.035714286,50
2603.799068,55,78,0.65,23,0.02826087,50
2603.674974,29,87,0.21,58,0.00362069,50
2603.645074,14,25,0.1,11,0.009090909,50
2603.629912,49,75,0.96,26,0.036923077,50
2603.49644,59,84,0.67,25,0.0268,50
2603.39514,52,82,0.84,30,0.028,50
2603.39514,51,83,0.9,32,0.028125,50
2603.375827,61,84,0.46,23,0.02,50
2603.258029,60,83,0.6,23,0.026086957,50
2603.2165,61,89,0.59,28,0.021071429,50
2603.204442,24,97,0.37,73,0.005068493,50
2603.131143,37,66,0.96,29,0.033103448,50
2603.014191,63,69,0.17,6,0.028333333,50
2603.014191,60,72,0.34,12,0.028333333,50
2603.014191,56,77,0.59,21,0.028095238,50
2602.975022,59,93,0.7,34,0.020588235,50
2602.876887,61,90,0.79,29,0.027241379,50
2602.838872,36,62,0.96,26,0.036923077,50
2602.695764,62,93,0.79,31,0.025483871,50
2602.654717,53,72,0.67,19,0.035263158,50
2602.636708,37,88,0.47,51,0.009215686,50
2602.603916,67,91,0.42,24,0.0175,50
2602.488988,37,89,0.44,52,0.008461538,50
2602.399614,66,85,0.49,19,0.025789474,50
2602.199304,56,80,0.66,24,0.0275,50
2602.158281,58,88,0.59,30,0.019666667,50
2602.058066,68,75,0.15,7,0.021428571,50
2602.032644,63,70,0.2,7,0.028571429,50
2601.811787,54,69,0.54,15,0.036,50
2601.808278,62,84,0.61,22,0.027727273,50
2601.791727,37,88,0.42,51,0.008235294,50
2601.729054,25,96,0.36,71,0.005070423,50
2601.603455,55,87,0.89,32,0.0278125,50
2601.529251,65,80,0.42,15,0.028,50
2601.381541,59,63,0.15,4,0.0375,50
2601.381541,57,65,0.3,8,0.0375,50
2601.381541,55,67,0.45,12,0.0375,50
2601.359629,61,85,0.62,24,0.025833333,50
2601.339367,57,90,0.67,33,0.02030303,50
2601.137839,36,61,0.88,25,0.0352,50
2601.107249,62,84,0.58,22,0.026363636,50
2601.097242,52,81,0.83,29,0.02862069,50
2601.026533,58,81,0.62,23,0.026956522,50
2601.026533,55,85,0.8,30,0.026666667,50
2600.998963,52,82,0.86,30,0.028666667,50
2600.769677,64,79,0.43,15,0.028666667,50
2600.621255,9,40,0.38,31,0.012258065,50
2600.580307,62,82,0.43,20,0.0215,50
2600.549259,55,77,0.63,22,0.028636364,50
2600.453289,43,49,0.22,6,0.036666667,50
2600.351487,37,60,0.86,23,0.037391304,50
2600.350738,60,91,0.84,31,0.027096774,50
2599.727214,57,86,0.79,29,0.027241379,50
2599.727214,56,88,0.86,32,0.026875,50
2599.727214,55,89,0.92,34,0.027058824,50
2599.64636,12,33,0.29,21,0.013809524,50
2599.556371,57,89,0.65,32,0.0203125,50
2599.337235,49,75,0.95,26,0.036538462,50
2599.271044,52,73,0.66,21,0.031428571,50
2599.16921,30,85,0.19,55,0.003454545,50
2599.122711,69,75,0.16,6,0.026666667,50
2599.122711,67,77,0.27,10,0.027,50
2599.121265,63,80,0.45,17,0.026470588,50
2599.121265,61,82,0.56,21,0.026666667,50
2599.117587,57,79,0.68,22,0.030909091,50
2599.064661,55,89,0.91,34,0.026764706,50
2598.904648,38,63,0.84,25,0.0336,50
2598.90269,60,96,0.9,36,0.025,50
2598.873449,27,95,0.32,68,0.004705882,50
2598.814535,59,88,0.76,29,0.026206897,50
2598.679496,63,79,0.44,16,0.0275,50
2598.67844,52,86,0.93,34,0.027352941,50
2598.620378,39,65,0.85,26,0.032692308,50
2598.542243,23,93,0.39,70,0.005571429,50
2598.508335,44,63,0.49,19,0.025789474,50
2598.486987,41,54,0.46,13,0.035384615,50
2598.486987,41,55,0.49,14,0.035,50
2598.351574,58,74,0.46,16,0.02875,50
2598.253781,54,78,0.69,24,0.02875,50
2598.203426,63,83,0.52,20,0.026,50
2598.203426,63,84,0.54,21,0.025714286,50
2598.203426,60,86,0.68,26,0.026153846,50
2598.203426,60,87,0.7,27,0.025925926,50
2598.203426,59,88,0.75,29,0.025862069,50
2598.203426,59,89,0.77,30,0.025666667,50
2598.021001,35,63,0.97,28,0.034642857,50
2597.903316,55,90,0.71,35,0.020285714,50
2597.755549,25,97,0.31,72,0.004305556,50
2597.693051,57,87,0.84,30,0.028,50
2597.693051,56,88,0.9,32,0.028125,50
2597.491495,51,84,0.92,33,0.027878788,50
2597.481319,38,50,0.45,12,0.0375,50
2597.197456,64,94,0.53,30,0.017666667,50
2597.149018,52,83,0.88,31,0.028387097,50
2597.099619,10,34,0.39,24,0.01625,50
2597.050703,64,79,0.31,15,0.020666667,50
2596.979328,59,73,0.4,14,0.028571429,50
2596.864096,36,53,0.63,17,0.037058824,50
2596.810598,51,72,0.78,21,0.037142857,50
2596.757837,54,77,0.68,23,0.029565217,50
2596.75577,67,83,0.42,16,0.02625,50
2596.615124,65,76,0.24,11,0.021818182,50
2596.558779,60,73,0.37,13,0.028461538,50
2596.405234,37,57,0.76,20,0.038,50
2596.303769,64,74,0.27,10,0.027,50
2596.232462,11,37,0.33,26,0.012692308,50
2596.231197,56,81,0.69,25,0.0276,50
2596.221021,63,82,0.5,19,0.026315789,50
2596.034438,64,81,0.45,17,0.026470588,50
2596.003124,37,53,0.57,16,0.035625,50
2595.915692,61,86,0.68,25,0.0272,50
2595.856445,23,93,0.38,70,0.005428571,50
2595.786643,73,80,0.17,7,0.024285714,50
2595.586047,70,75,0.14,5,0.028,50
2595.405015,60,74,0.39,14,0.027857143,50
2595.274879,56,90,0.69,34,0.020294118,50
2595.248753,63,80,0.47,17,0.027647059,50
2595.206162,62,73,0.3,11,0.027272727,50
2595.206162,60,75,0.41,15,0.027333333,50
2595.040029,66,76,0.28,10,0.028,50
2595.006673,62,81,0.53,19,0.027894737,50
2595.006673,59,84,0.7,25,0.028,50
2595.006673,58,85,0.76,27,0.028148148,50
2595.002597,30,89,0.11,59,0.001864407,50
2594.926239,58,84,0.6,26,0.023076923,50
2594.793031,48,63,0.38,15,0.025333333,50
2594.565543,61,95,0.86,34,0.025294118,50
2594.565543,60,96,0.91,36,0.025277778,50
2594.565543,59,98,0.98,39,0.025128205,50
2594.561718,49,62,0.33,13,0.025384615,50
2594.521261,65,80,0.39,15,0.026,50
2594.475116,60,94,0.88,34,0.025882353,50
2594.475116,59,96,0.95,37,0.025675676,50
2594.40376,42,66,0.67,24,0.027916667,50
2594.322052,37,58,0.73,21,0.034761905,50
2594.191632,52,73,0.74,21,0.035238095,50
2594.191632,51,74,0.81,23,0.035217391,50
2594.191632,50,75,0.88,25,0.0352,50
2594.178041,36,63,0.9,27,0.033333333,50
2594.146281,64,89,0.65,25,0.026,50
2594.103241,41,59,0.6,18,0.033333333,50
2594.064059,51,74,0.83,23,0.036086957,50
2593.990523,10,37,0.36,27,0.013333333,50
2593.941102,38,65,0.89,27,0.032962963,50
2593.866116,56,84,0.74,28,0.026428571,50
2593.830235,38,51,0.47,13,0.036153846,50
2593.807667,66,77,0.24,11,0.021818182,50
2593.782101,44,68,0.64,24,0.026666667,50
2593.697985,57,81,0.59,24,0.024583333,50
2593.658378,60,78,0.44,18,0.024444444,50
