% profit,ema1,ema2,threshold,diff,thresh / diff,ID
3828.983679,41,49,0.27,8,0.03375,11
3758.272912,38,53,0.5,15,0.033333333,11
3700.253771,37,54,0.57,17,0.033529412,11
3648.874203,44,47,0.1,3,0.033333333,11
3646.352932,36,56,0.66,20,0.033,11
3639.355471,35,57,0.73,22,0.033181818,11
3635.052599,34,61,0.86,27,0.031851852,11
3631.868242,41,50,0.3,9,0.033333333,11
3622.252269,35,55,0.68,20,0.034,11
3614.541476,34,58,0.79,24,0.032916667,11
3614.526189,38,54,0.53,16,0.033125,11
3614.526189,36,57,0.69,21,0.032857143,11
3608.105765,34,60,0.84,26,0.032307692,11
3601.123345,37,56,0.62,19,0.032631579,11
3598.001906,38,50,0.41,12,0.034166667,11
3595.279217,40,50,0.34,10,0.034,11
3583.556856,35,58,0.75,23,0.032608696,11
3573.125639,34,60,0.85,26,0.032692308,11
3572.608781,33,62,0.93,29,0.032068966,11
3571.973604,33,61,0.91,28,0.0325,11
3571.095089,35,58,0.76,23,0.033043478,11
3559.056699,34,59,0.82,25,0.0328,11
3550.914461,40,51,0.37,11,0.033636364,11
3545.046851,39,53,0.46,14,0.032857143,11
3535.267979,38,52,0.47,14,0.033571429,11
3529.229824,37,53,0.54,16,0.03375,11
3520.874256,42,47,0.17,5,0.034,11
3519.750947,38,49,0.4,11,0.036363636,11
3505.873268,36,54,0.61,18,0.033888889,11
3499.852313,36,53,0.6,17,0.035294118,11
3492.733984,33,60,0.89,27,0.032962963,11
3482.938149,34,56,0.76,22,0.034545455,11
3482.853579,38,56,0.58,18,0.032222222,11
3473.001327,32,63,0.99,31,0.031935484,11
3471.467761,35,59,0.78,24,0.0325,11
3471.267769,41,52,0.36,11,0.032727273,11
3467.854021,38,53,0.51,15,0.034,11
3462.182716,32,62,0.97,30,0.032333333,11
3458.113949,37,51,0.5,14,0.035714286,11
3454.201646,40,54,0.45,14,0.032142857,11
3449.621175,37,51,0.49,14,0.035,11
3434.421899,32,61,0.95,29,0.032758621,11
3431.085243,33,60,0.88,27,0.032592593,11
3429.779909,37,54,0.58,17,0.034117647,11
3429.687019,35,57,0.74,22,0.033636364,11
3416.063054,33,58,0.84,25,0.0336,11
3416.063054,32,60,0.93,28,0.033214286,11
3413.933087,41,46,0.18,5,0.036,11
3412.867403,33,64,0.97,31,0.031290323,11
3411.279949,36,58,0.71,22,0.032272727,11
3410.485164,37,57,0.65,20,0.0325,11
3409.808021,34,62,0.89,28,0.031785714,11
3406.141325,36,56,0.65,20,0.0325,11
3406.060101,34,57,0.77,23,0.033478261,11
3405.469777,39,52,0.44,13,0.033846154,11
3400.395285,32,62,0.99,30,0.033,11
3396.474454,39,54,0.49,15,0.032666667,11
3395.079052,39,51,0.41,12,0.034166667,11
3394.057848,35,61,0.82,26,0.031538462,11
3393.772001,41,47,0.21,6,0.035,11
3391.163236,33,62,0.94,29,0.032413793,11
3389.918421,34,58,0.8,24,0.033333333,11
3389.802399,38,50,0.43,12,0.035833333,11
3388.598344,38,51,0.44,13,0.033846154,11
3387.538198,40,44,0.15,4,0.0375,11
3385.151236,36,55,0.66,19,0.034736842,11
3384.464263,33,63,0.95,30,0.031666667,11
3380.902284,35,60,0.8,25,0.032,11
3378.950671,40,48,0.28,8,0.035,11
3376.700512,36,55,0.65,19,0.034210526,11
3368.563841,40,49,0.31,9,0.034444444,11
3365.301693,43,45,0.07,2,0.035,11
3363.02919,36,52,0.57,16,0.035625,11
3360.353461,41,48,0.24,7,0.034285714,11
3359.579845,36,56,0.68,20,0.034,11
3356.800624,39,49,0.35,10,0.035,11
3356.800624,38,50,0.42,12,0.035,11
3354.443146,32,62,0.98,30,0.032666667,11
3352.721706,34,54,0.72,20,0.036,11
3352.56381,35,56,0.7,21,0.033333333,11
3349.534885,36,51,0.55,15,0.036666667,11
3345.862934,40,51,0.36,11,0.032727273,11
3342.039702,36,53,0.58,17,0.034117647,11
3335.607514,41,51,0.33,10,0.033,11
3333.853174,33,59,0.88,26,0.033846154,11
3331.897667,32,61,0.96,29,0.033103448,11
3331.176277,36,55,0.63,19,0.033157895,11
3327.743329,33,61,0.92,28,0.032857143,11
3327.031675,42,48,0.2,6,0.033333333,11
3327.009076,39,55,0.52,16,0.0325,11
3323.822508,45,48,0.11,3,0.036666667,11
3323.203606,35,53,0.64,18,0.035555556,11
3320.424074,39,49,0.36,10,0.036,11
3317.84793,35,54,0.67,19,0.035263158,11
3315.829684,33,59,0.89,26,0.034230769,11
3312.67494,43,50,0.23,7,0.032857143,11
3312.345215,34,55,0.75,21,0.035714286,11
3310.25413,34,56,0.77,22,0.035,11
3309.070233,33,55,0.79,22,0.035909091,11
3308.325494,37,55,0.6,18,0.033333333,11
3307.717883,33,56,0.8,23,0.034782609,11
3306.117603,33,56,0.82,23,0.035652174,11
3304.984504,35,56,0.72,21,0.034285714,11
3304.273145,32,57,0.89,25,0.0356,11
3303.843008,34,59,0.83,25,0.0332,11
3301.094361,36,99,0.09,63,0.001428571,11
3299.981057,32,57,0.88,25,0.0352,11
3297.07042,37,52,0.52,15,0.034666667,11
3289.9276,35,55,0.67,20,0.0335,11
3288.468655,36,58,0.72,22,0.032727273,11
3287.602028,62,68,0.19,6,0.031666667,11
3285.901216,60,69,0.29,9,0.032222222,11
3284.17184,33,60,0.91,27,0.033703704,11
3284.169266,36,56,0.67,20,0.0335,11
3282.606968,36,57,0.67,21,0.031904762,11
3281.280961,58,71,0.42,13,0.032307692,11
3280.70473,36,52,0.58,16,0.03625,11
3278.900107,38,54,0.52,16,0.0325,11
3277.928221,34,54,0.71,20,0.0355,11
3277.760935,37,52,0.51,15,0.034,11
3260.965792,33,60,0.9,27,0.033333333,11
3260.938655,36,98,0.11,62,0.001774194,11
3260.172139,35,57,0.75,22,0.034090909,11
3259.413606,33,56,0.81,23,0.035217391,11
3258.026837,37,56,0.61,19,0.032105263,11
3257.32323,37,58,0.67,21,0.031904762,11
3256.446405,38,52,0.49,14,0.035,11
3256.1401,35,58,0.77,23,0.033478261,11
3255.897496,34,60,0.86,26,0.033076923,11
3253.774434,35,59,0.76,24,0.031666667,11
3253.72201,34,55,0.74,21,0.035238095,11
3253.662563,60,70,0.32,10,0.032,11
3253.662563,58,72,0.45,14,0.032142857,11
3253.662563,56,74,0.58,18,0.032222222,11
3253.662563,54,76,0.71,22,0.032272727,11
3252.52642,34,58,0.81,24,0.03375,11
3250.102232,34,61,0.87,27,0.032222222,11
3249.784357,35,52,0.63,17,0.037058824,11
3248.370866,33,59,0.86,26,0.033076923,11
3248.075141,42,49,0.23,7,0.032857143,11
3244.649305,35,99,0.12,64,0.001875,11
3244.341794,32,61,0.98,29,0.033793103,11
3242.896289,57,72,0.49,15,0.032666667,11
3241.780973,36,53,0.59,17,0.034705882,11
3240.811999,33,62,0.91,29,0.03137931,11
3239.585602,38,51,0.46,13,0.035384615,11
3238.211819,55,76,0.67,21,0.031904762,11
3236.745533,34,59,0.84,25,0.0336,11
3234.768574,35,53,0.65,18,0.036111111,11
3234.684966,35,99,0.13,64,0.00203125,11
3233.869695,35,54,0.68,19,0.035789474,11
3232.28118,35,54,0.66,19,0.034736842,11
3231.749467,39,50,0.38,11,0.034545455,11
3231.749467,38,51,0.45,13,0.034615385,11
3231.272823,55,74,0.62,19,0.032631579,11
3230.50595,36,52,0.56,16,0.035,11
3228.737343,42,46,0.14,4,0.035,11
3228.428528,35,98,0.14,63,0.002222222,11
3227.750366,35,99,0.14,64,0.0021875,11
3226.877132,34,55,0.76,21,0.036190476,11
3224.894373,37,50,0.48,13,0.036923077,11
3224.35042,59,70,0.36,11,0.032727273,11
3224.025381,56,73,0.55,17,0.032352941,11
3223.350072,37,54,0.56,17,0.032941176,11
3220.074647,36,55,0.64,19,0.033684211,11
3215.575926,35,58,0.74,23,0.032173913,11
3215.461019,42,52,0.36,10,0.036,11
3214.349642,36,58,0.7,22,0.031818182,11
3213.512623,32,57,0.91,25,0.0364,11
3212.810463,53,77,0.78,24,0.0325,11
3207.92051,37,52,0.53,15,0.035333333,11
3203.263867,37,54,0.59,17,0.034705882,11
3200.884668,39,48,0.33,9,0.036666667,11
3196.715641,39,52,0.43,13,0.033076923,11
3196.576746,35,53,0.66,18,0.036666667,11
3194.031908,33,63,0.96,30,0.032,11
3193.006015,32,60,0.95,28,0.033928571,11
3192.891356,34,56,0.74,22,0.033636364,11
3187.571509,33,56,0.84,23,0.036521739,11
3186.841804,34,61,0.85,27,0.031481481,11
3185.518465,43,50,0.26,7,0.037142857,11
3185.197754,40,52,0.39,12,0.0325,11
3184.847751,32,60,0.96,28,0.034285714,11
3183.780386,39,51,0.42,12,0.035,11
3183.521481,31,58,0.97,27,0.035925926,11
3180.612705,38,55,0.56,17,0.032941176,11
3179.007893,35,56,0.73,21,0.034761905,11
3178.724128,37,55,0.59,18,0.032777778,11
3178.697406,32,58,0.9,26,0.034615385,11
3177.809362,57,74,0.54,17,0.031764706,11
3175.669357,59,72,0.41,13,0.031538462,11
3175.643204,56,76,0.63,20,0.0315,11
3175.627598,39,49,0.34,10,0.034,11
3173.808721,32,56,0.88,24,0.036666667,11
3173.655285,37,50,0.47,13,0.036153846,11
3173.560179,33,57,0.83,24,0.034583333,11
3168.93732,34,56,0.75,22,0.034090909,11
3166.659975,34,57,0.8,23,0.034782609,11
3162.113716,31,58,0.98,27,0.036296296,11
3160.260255,39,51,0.4,12,0.033333333,11
3160.093144,35,54,0.65,19,0.034210526,11
3160.060204,32,61,0.99,29,0.034137931,11
3158.303519,33,57,0.85,24,0.035416667,11
3158.288673,62,69,0.22,7,0.031428571,11
3158.248873,33,58,0.86,25,0.0344,11
3157.989532,33,61,0.9,28,0.032142857,11
3157.383109,32,56,0.89,24,0.037083333,11
3157.017832,34,58,0.82,24,0.034166667,11
3156.056598,34,55,0.73,21,0.034761905,11
3155.378377,54,75,0.69,21,0.032857143,11
3154.699698,54,78,0.76,24,0.031666667,11
3154.050231,36,57,0.7,21,0.033333333,11
3154.038803,36,59,0.74,23,0.032173913,11
3153.801045,33,56,0.83,23,0.036086957,11
3153.141932,33,58,0.85,25,0.034,11
3152.208056,38,97,0.08,59,0.001355932,11
3152.182927,32,60,0.94,28,0.033571429,11
3151.838447,32,61,0.97,29,0.033448276,11
3151.269712,34,57,0.78,23,0.033913043,11
3150.372719,32,59,0.93,27,0.034444444,11
3148.546031,34,54,0.73,20,0.0365,11
3148.104337,41,50,0.31,9,0.034444444,11
3145.273536,33,55,0.81,22,0.036818182,11
3145.059876,35,57,0.72,22,0.032727273,11
3142.625338,40,51,0.38,11,0.034545455,11
3140.852292,39,50,0.39,11,0.035454545,11
3140.241235,43,51,0.26,8,0.0325,11
3140.176093,31,59,0.98,28,0.035,11
3139.318372,34,57,0.79,23,0.034347826,11
3139.128765,34,54,0.77,20,0.0385,11
3138.302592,39,52,0.45,13,0.034615385,11
3134.583068,32,58,0.87,26,0.033461538,11
3134.561182,37,55,0.61,18,0.033888889,11
3134.155572,36,98,0.1,62,0.001612903,11
3134.04036,38,53,0.52,15,0.034666667,11
3133.732106,40,50,0.35,10,0.035,11
3133.266459,33,62,0.92,29,0.031724138,11
3131.479531,36,97,0.13,61,0.002131148,11
3130.247985,32,59,0.92,27,0.034074074,11
3129.69608,56,73,0.56,17,0.032941176,11
3127.370177,54,77,0.74,23,0.032173913,11
3126.456623,49,68,0.53,19,0.027894737,11
3126.23786,36,57,0.68,21,0.032380952,11
3126.143424,34,54,0.74,20,0.037,11
3123.651573,33,58,0.87,25,0.0348,11
3123.485663,33,61,0.93,28,0.033214286,11
3122.770911,35,60,0.79,25,0.0316,11
3122.394893,36,60,0.76,24,0.031666667,11
3118.060631,35,52,0.64,17,0.037647059,11
3116.999642,35,99,0.15,64,0.00234375,11
3115.682283,36,98,0.13,62,0.002096774,11
3115.240927,33,57,0.82,24,0.034166667,11
3114.947954,38,49,0.39,11,0.035454545,11
3113.764224,34,60,0.83,26,0.031923077,11
3113.667052,34,59,0.81,25,0.0324,11
3113.097089,52,79,0.88,27,0.032592593,11
3112.717586,55,75,0.65,20,0.0325,11
3112.717586,54,76,0.72,22,0.032727273,11
3112.717586,53,78,0.81,25,0.0324,11
3112.717586,52,78,0.85,26,0.032692308,11
3110.747571,51,80,0.95,29,0.032758621,11
3109.702228,37,53,0.56,16,0.035,11
3108.854624,38,48,0.36,10,0.036,11
3108.462805,35,98,0.15,63,0.002380952,11
3108.089545,34,99,0.17,65,0.002615385,11
3107.98139,44,76,0.85,32,0.0265625,11
3107.198177,40,52,0.4,12,0.033333333,11
3105.687854,33,55,0.8,22,0.036363636,11
3105.161441,51,81,0.97,30,0.032333333,11
3105.081778,38,96,0.09,58,0.001551724,11
3105.028386,43,49,0.2,6,0.033333333,11
3103.050729,42,48,0.21,6,0.035,11
3102.848734,40,49,0.34,9,0.037777778,11
3102.678537,41,53,0.39,12,0.0325,11
3101.477034,43,47,0.14,4,0.035,11
3101.467793,45,49,0.13,4,0.0325,11
3099.477276,36,98,0.12,62,0.001935484,11
3098.122951,38,52,0.48,14,0.034285714,11
3097.973612,35,59,0.77,24,0.032083333,11
3097.858848,33,55,0.85,22,0.038636364,11
3096.941946,31,58,0.99,27,0.036666667,11
3096.134718,38,54,0.54,16,0.03375,11
3095.623875,36,99,0.1,63,0.001587302,11
3095.341678,36,51,0.56,15,0.037333333,11
3094.92226,32,56,0.87,24,0.03625,11
3094.427702,36,54,0.6,18,0.033333333,11
3094.290543,37,97,0.11,60,0.001833333,11
3094.236196,32,57,0.9,25,0.036,11
3093.997815,55,74,0.63,19,0.033157895,11
3093.997815,53,77,0.79,24,0.032916667,11
3092.400934,35,52,0.66,17,0.038823529,11
3091.000143,35,55,0.69,20,0.0345,11
3090.570127,61,71,0.31,10,0.031,11
3087.584268,32,59,0.94,27,0.034814815,11
3086.814395,32,63,0.98,31,0.031612903,11
3086.536611,41,49,0.28,8,0.035,11
3085.008891,41,44,0.11,3,0.036666667,11
3084.994684,54,75,0.7,21,0.033333333,11
3083.755349,36,54,0.62,18,0.034444444,11
3082.630262,37,53,0.55,16,0.034375,11
3082.05013,41,53,0.44,12,0.036666667,11
3081.665636,58,74,0.5,16,0.03125,11
3080.438011,34,53,0.74,19,0.038947368,11
3079.569884,38,56,0.57,18,0.031666667,11
3079.286007,35,55,0.7,20,0.035,11
3078.877844,45,74,0.79,29,0.027241379,11
3078.301637,42,50,0.29,8,0.03625,11
3075.355094,42,45,0.11,3,0.036666667,11
3075.22237,43,48,0.17,5,0.034,11
3075.084865,40,47,0.25,7,0.035714286,11
3073.871935,48,69,0.59,21,0.028095238,11
3072.805689,52,80,0.9,28,0.032142857,11
3071.982084,33,59,0.87,26,0.033461538,11
3069.930464,45,73,0.78,28,0.027857143,11
3069.905778,37,96,0.12,59,0.002033898,11
3069.747735,35,56,0.71,21,0.033809524,11
3068.732053,39,55,0.51,16,0.031875,11
3068.628067,40,53,0.43,13,0.033076923,11
3064.17717,44,48,0.13,4,0.0325,11
3063.864133,52,78,0.86,26,0.033076923,11
3063.75469,42,51,0.3,9,0.033333333,11
3062.781205,37,96,0.13,59,0.00220339,11
3061.216833,47,70,0.65,23,0.02826087,11
3060.809202,32,59,0.95,27,0.035185185,11
3059.454254,39,50,0.42,11,0.038181818,11
3058.550194,36,99,0.11,63,0.001746032,11
3058.403497,33,63,0.94,30,0.031333333,11
3058.197169,53,76,0.76,23,0.033043478,11
3057.308666,42,47,0.19,5,0.038,11
3057.291078,44,74,0.84,30,0.028,11
3057.13937,46,73,0.73,27,0.027037037,11
3056.608561,32,60,0.97,28,0.034642857,11
3055.963942,48,70,0.6,22,0.027272727,11
3055.784939,37,51,0.51,14,0.036428571,11
3054.93492,36,97,0.14,61,0.002295082,11
3054.402477,39,66,0.11,27,0.004074074,11
3053.68994,44,47,0.11,3,0.036666667,11
3052.064564,46,72,0.72,26,0.027692308,11
3051.425226,47,71,0.66,24,0.0275,11
3049.180898,34,55,0.71,21,0.033809524,11
3047.532391,39,53,0.51,14,0.036428571,11
3047.222832,37,47,0.38,10,0.038,11
3046.746224,36,98,0.14,62,0.002258065,11
3046.332926,32,57,0.96,25,0.0384,11
3045.926103,32,58,0.91,26,0.035,11
3045.692197,41,47,0.23,6,0.038333333,11
3045.528038,37,53,0.6,16,0.0375,11
3045.030562,31,59,0.94,28,0.033571429,11
3044.891981,56,74,0.59,18,0.032777778,11
3044.736342,42,50,0.27,8,0.03375,11
3044.620183,40,53,0.42,13,0.032307692,11
3041.594544,51,79,0.92,28,0.032857143,11
3041.559163,35,57,0.71,22,0.032272727,11
3041.4662,53,79,0.83,26,0.031923077,11
3041.398293,35,95,0.25,60,0.004166667,11
3039.755988,38,47,0.33,9,0.036666667,11
3039.698109,40,55,0.48,15,0.032,11
3037.573686,32,99,0.31,67,0.004626866,11
3036.59775,45,60,0.44,15,0.029333333,11
3036.434514,31,59,0.99,28,0.035357143,11
3036.266629,39,52,0.49,13,0.037692308,11
3035.390865,44,75,0.85,31,0.027419355,11
3034.831636,31,57,0.95,26,0.036538462,11
3034.03445,46,71,0.71,25,0.0284,11
3033.017777,44,46,0.07,2,0.035,11
3032.946198,51,79,0.93,28,0.033214286,11
3032.405847,33,59,0.97,26,0.037307692,11
3032.298921,36,51,0.58,15,0.038666667,11
3032.020483,36,53,0.61,17,0.035882353,11
3032.020319,42,49,0.26,7,0.037142857,11
3032.020319,40,51,0.41,11,0.037272727,11
3031.089766,33,57,0.84,24,0.035,11
3028.672575,38,45,0.27,7,0.038571429,11
3026.914426,58,73,0.48,15,0.032,11
3026.379369,42,77,0.97,35,0.027714286,11
3024.002896,63,68,0.16,5,0.032,11
3023.580863,38,52,0.52,14,0.037142857,11
3023.281572,46,59,0.38,13,0.029230769,11
3023.015316,33,57,0.86,24,0.035833333,11
3022.939582,52,81,0.92,29,0.031724138,11
3022.71174,34,98,0.25,64,0.00390625,11
3022.440287,33,56,0.78,23,0.033913043,11
3022.314959,32,57,0.92,25,0.0368,11
3022.105555,37,55,0.58,18,0.032222222,11
3021.782005,60,71,0.35,11,0.031818182,11
3021.592289,36,55,0.7,19,0.036842105,11
3021.488265,53,62,0.25,9,0.027777778,11
3020.526207,39,46,0.26,7,0.037142857,11
3020.462954,36,99,0.12,63,0.001904762,11
3020.458595,36,94,0.24,58,0.004137931,11
3020.29324,52,77,0.83,25,0.0332,11
3018.873718,35,95,0.26,60,0.004333333,11
3018.295048,37,51,0.54,14,0.038571429,11
3018.258648,34,59,0.8,25,0.032,11
3016.054159,33,61,0.94,28,0.033571429,11
3014.579326,40,49,0.32,9,0.035555556,11
3014.544709,59,69,0.33,10,0.033,11
3012.864493,51,64,0.36,13,0.027692308,11
3012.546423,34,99,0.16,65,0.002461538,11
3012.23341,37,96,0.1,59,0.001694915,11
3011.317184,32,99,0.3,67,0.004477612,11
3010.822427,36,52,0.59,16,0.036875,11
3009.994851,35,97,0.23,62,0.003709677,11
3009.575038,38,56,0.59,18,0.032777778,11
3009.508323,37,95,0.13,58,0.002241379,11
3009.227831,37,97,0.09,60,0.0015,11
3008.460439,32,57,0.85,25,0.034,11
3007.076459,42,50,0.26,8,0.0325,11
3006.446263,34,57,0.87,23,0.037826087,11
3005.188557,33,63,0.93,30,0.031,11
3004.884156,42,71,0.95,29,0.032758621,11
3004.447544,63,72,0.25,9,0.027777778,11
3004.447544,58,78,0.55,20,0.0275,11
3004.253012,40,52,0.44,12,0.036666667,11
3003.783528,33,65,0.99,32,0.0309375,11
3003.61435,61,68,0.23,7,0.032857143,11
3003.589797,34,56,0.78,22,0.035454545,11
3002.8267,31,59,0.95,28,0.033928571,11
3002.753726,38,98,0.08,60,0.001333333,11
3001.106893,35,55,0.76,20,0.038,11
3000.555994,57,75,0.57,18,0.031666667,11
3000.131107,38,49,0.41,11,0.037272727,11
2999.630368,39,48,0.32,9,0.035555556,11
2998.440472,50,80,0.99,30,0.033,11
2997.872696,46,71,0.72,25,0.0288,11
2997.570404,40,47,0.27,7,0.038571429,11
2997.4432,63,67,0.13,4,0.0325,11
2997.4432,61,69,0.26,8,0.0325,11
2997.329095,33,59,0.96,26,0.036923077,11
2996.587891,31,57,0.96,26,0.036923077,11
2996.277357,38,98,0.09,60,0.0015,11
2996.212656,35,53,0.63,18,0.035,11
2995.541463,38,54,0.58,16,0.03625,11
2995.114424,38,97,0.09,59,0.001525424,11
2994.912894,35,56,0.78,21,0.037142857,11
2993.10332,40,47,0.26,7,0.037142857,11
2992.898608,39,54,0.48,15,0.032,11
2992.848109,36,54,0.63,18,0.035,11
2990.459804,33,60,0.92,27,0.034074074,11
2988.327305,37,48,0.41,11,0.037272727,11
2988.263733,44,61,0.5,17,0.029411765,11
2987.355185,37,50,0.46,13,0.035384615,11
2987.298667,57,73,0.52,16,0.0325,11
2986.923467,55,77,0.7,22,0.031818182,11
2986.452111,42,47,0.18,5,0.036,11
2986.189472,39,47,0.29,8,0.03625,11
2984.644451,35,53,0.69,18,0.038333333,11
2983.964208,43,78,0.92,35,0.026285714,11
2983.885847,43,76,0.91,33,0.027575758,11
2983.409102,58,71,0.43,13,0.033076923,11
2983.133908,35,59,0.79,24,0.032916667,11
2982.548212,59,85,0.56,26,0.021538462,11
2982.244314,61,67,0.2,6,0.033333333,11
2982.181915,34,99,0.23,65,0.003538462,11
2981.555486,36,54,0.68,18,0.037777778,11
2981.544588,53,76,0.77,23,0.033478261,11
2980.579525,47,61,0.4,14,0.028571429,11
2979.938001,35,60,0.81,25,0.0324,11
2979.404886,57,78,0.64,21,0.03047619,11
2978.819977,60,68,0.27,8,0.03375,11
2978.04854,44,76,0.87,32,0.0271875,11
2977.815673,37,51,0.48,14,0.034285714,11
2976.58467,37,98,0.09,61,0.00147541,11
2976.536957,35,98,0.16,63,0.002539683,11
2976.05504,51,85,0.94,34,0.027647059,11
2975.472386,56,72,0.53,16,0.033125,11
2974.549011,35,95,0.27,60,0.0045,11
2973.451816,32,56,0.9,24,0.0375,11
2972.892413,43,74,0.91,31,0.029354839,11
2970.761093,35,57,0.76,22,0.034545455,11
2970.375779,35,58,0.78,23,0.033913043,11
2970.141284,67,68,0.03,1,0.03,11
2970.141284,66,69,0.09,3,0.03,11
2970.141284,65,70,0.15,5,0.03,11
2970.141284,64,71,0.21,7,0.03,11
2970.141284,63,72,0.27,9,0.03,11
2970.141284,62,73,0.33,11,0.03,11
2969.695699,40,46,0.22,6,0.036666667,11
2969.164051,38,54,0.59,16,0.036875,11
2968.950237,57,72,0.5,15,0.033333333,11
2968.851152,37,52,0.54,15,0.036,11
2968.659212,36,97,0.1,61,0.001639344,11
2968.443709,38,96,0.1,58,0.001724138,11
2968.344529,34,99,0.15,65,0.002307692,11
2968.209505,37,56,0.69,19,0.036315789,11
2968.209242,34,98,0.16,64,0.0025,11
2967.754445,35,97,0.15,62,0.002419355,11
2966.571229,38,68,0.13,30,0.004333333,11
2966.485375,38,55,0.55,17,0.032352941,11
2965.393303,38,94,0.12,56,0.002142857,11
2965.217133,37,57,0.73,20,0.0365,11
2965.199254,59,73,0.44,14,0.031428571,11
2964.861476,33,58,0.95,25,0.038,11
2964.547296,36,58,0.73,22,0.033181818,11
2964.504926,35,99,0.16,64,0.0025,11
2964.20008,34,57,0.86,23,0.037391304,11
2964.166287,48,68,0.55,20,0.0275,11
2964.00551,38,50,0.46,12,0.038333333,11
2963.494698,38,50,0.44,12,0.036666667,11
2962.359915,35,55,0.71,20,0.0355,11
2962.191689,37,49,0.47,12,0.039166667,11
2962.108969,39,54,0.5,15,0.033333333,11
2961.532657,51,79,0.94,28,0.033571429,11
2961.207329,45,72,0.78,27,0.028888889,11
2961.159973,34,96,0.28,62,0.004516129,11
2960.323768,33,64,0.96,31,0.030967742,11
2960.200998,37,55,0.67,18,0.037222222,11
2959.807976,36,99,0.08,63,0.001269841,11
2959.527275,40,65,0.09,25,0.0036,11
2959.456379,62,70,0.25,8,0.03125,11
2959.139666,37,57,0.64,20,0.032,11
2959.043939,33,55,0.82,22,0.037272727,11
2958.250702,40,50,0.33,10,0.033,11
2957.817139,37,97,0.1,60,0.001666667,11
2957.749281,33,54,0.79,21,0.037619048,11
2957.69989,34,62,0.88,28,0.031428571,11
2957.032047,34,58,0.83,24,0.034583333,11
2956.376645,34,59,0.85,25,0.034,11
2955.264195,34,98,0.24,64,0.00375,11
2954.804088,51,82,0.99,31,0.031935484,11
2954.527508,37,99,0.09,62,0.001451613,11
2954.320919,34,60,0.87,26,0.033461538,11
2952.743814,33,98,0.29,65,0.004461538,11
2950.624249,36,94,0.23,58,0.003965517,11
2949.829364,38,53,0.49,15,0.032666667,11
2949.659957,36,59,0.73,23,0.03173913,11
2948.510465,61,70,0.29,9,0.032222222,11
2948.510465,59,72,0.42,13,0.032307692,11
2948.409113,39,52,0.53,13,0.040769231,11
2948.259903,45,48,0.1,3,0.033333333,11
2948.154868,36,52,0.61,16,0.038125,11
2947.457171,36,93,0.24,57,0.004210526,11
2947.301765,39,45,0.23,6,0.038333333,11
2947.24457,38,67,0.14,29,0.004827586,11
2946.785291,35,54,0.69,19,0.036315789,11
2946.705142,34,97,0.25,63,0.003968254,11
2946.515636,33,58,0.94,25,0.0376,11
2946.08475,58,72,0.46,14,0.032857143,11
2945.572528,41,51,0.34,10,0.034,11
2945.439732,35,52,0.65,17,0.038235294,11
2945.342928,55,75,0.66,20,0.033,11
2945.190827,39,53,0.52,14,0.037142857,11
2945.107552,45,69,0.76,24,0.031666667,11
2944.685024,42,51,0.29,9,0.032222222,11
2944.577585,36,48,0.46,12,0.038333333,11
2944.193363,42,52,0.32,10,0.032,11
2943.961563,36,59,0.82,23,0.035652174,11
2943.787134,40,51,0.45,11,0.040909091,11
2943.595826,32,58,0.93,26,0.035769231,11
2943.463233,37,58,0.75,21,0.035714286,11
2943.361646,34,53,0.72,19,0.037894737,11
2943.232441,55,76,0.68,21,0.032380952,11
2942.095195,37,58,0.66,21,0.031428571,11
2941.892616,41,48,0.25,7,0.035714286,11
2941.891248,52,62,0.28,10,0.028,11
2941.807572,53,68,0.38,15,0.025333333,11
2941.641701,36,96,0.14,60,0.002333333,11
2941.349016,34,63,0.91,29,0.03137931,11
2941.189685,39,53,0.47,14,0.033571429,11
2940.556393,50,65,0.42,15,0.028,11
2939.251721,33,55,0.86,22,0.039090909,11
2939.235688,45,46,0.04,1,0.04,11
2939.235688,44,47,0.12,3,0.04,11
2939.235688,43,48,0.2,5,0.04,11
2937.832042,34,60,0.82,26,0.031538462,11
2936.677573,36,94,0.25,58,0.004310345,11
2936.576282,36,56,0.74,20,0.037,11
2936.077203,37,50,0.49,13,0.037692308,11
2935.972952,26,90,0.53,64,0.00828125,11
2935.438934,46,63,0.48,17,0.028235294,11
2935.029725,46,85,0.87,39,0.022307692,11
2934.880474,54,78,0.77,24,0.032083333,11
2934.857712,43,71,0.89,28,0.031785714,11
2934.316397,39,49,0.38,10,0.038,11
2934.241778,33,64,0.98,31,0.031612903,11
2933.740298,54,76,0.73,22,0.033181818,11
2933.319472,34,99,0.18,65,0.002769231,11
2933.158096,57,74,0.55,17,0.032352941,11
2931.505115,56,75,0.61,19,0.032105263,11
2931.210855,44,73,0.85,29,0.029310345,11
2931.175828,35,58,0.84,23,0.036521739,11
2931.000983,31,57,0.97,26,0.037307692,11
2930.627993,34,99,0.19,65,0.002923077,11
2929.787797,35,96,0.24,61,0.003934426,11
2929.73728,45,79,0.82,34,0.024117647,11
2929.051322,36,93,0.25,57,0.004385965,11
2928.632649,38,58,0.63,20,0.0315,11
2927.924305,54,61,0.19,7,0.027142857,11
2927.299729,59,71,0.39,12,0.0325,11
2927.21845,38,96,0.08,58,0.00137931,11
2927.170774,47,84,0.82,37,0.022162162,11
2927.088144,37,46,0.35,9,0.038888889,11
2926.969624,33,99,0.26,66,0.003939394,11
2926.943834,33,99,0.29,66,0.004393939,11
2926.832284,36,51,0.57,15,0.038,11
2926.756785,50,79,0.66,29,0.022758621,11
2925.705495,38,55,0.61,17,0.035882353,11
2925.39041,35,99,0.11,64,0.00171875,11
2925.004967,60,74,0.43,14,0.030714286,11
2924.758001,32,59,0.96,27,0.035555556,11
2924.29089,31,59,0.97,28,0.034642857,11
2924.201484,41,52,0.37,11,0.033636364,11
2924.009271,34,96,0.27,62,0.004354839,11
2923.497748,37,56,0.63,19,0.033157895,11
2923.170702,37,55,0.66,18,0.036666667,11
2923.158828,42,49,0.28,7,0.04,11
2923.158828,41,50,0.36,9,0.04,11
2923.017525,34,62,0.87,28,0.031071429,11
2922.237722,41,51,0.37,10,0.037,11
2922.217647,36,57,0.76,21,0.036190476,11
2922.185422,32,55,0.87,23,0.037826087,11
2921.590249,34,98,0.26,64,0.0040625,11
2921.11759,36,97,0.15,61,0.002459016,11
2920.98603,54,82,0.77,28,0.0275,11
2920.98603,53,83,0.83,30,0.027666667,11
2920.827326,37,96,0.09,59,0.001525424,11
2920.33236,40,57,0.6,17,0.035294118,11
2920.242867,33,55,0.83,22,0.037727273,11
2920.062337,52,87,0.94,35,0.026857143,11
2919.997074,39,98,0.03,59,0.000508475,11
2919.390156,55,60,0.14,5,0.028,11
2919.22892,49,81,0.72,32,0.0225,11
2919.000791,41,50,0.33,9,0.036666667,11
2918.614789,33,98,0.27,65,0.004153846,11
2918.350284,40,53,0.44,13,0.033846154,11
2918.123663,52,78,0.87,26,0.033461538,11
2918.123663,51,80,0.96,29,0.033103448,11
2917.805378,47,83,0.81,36,0.0225,11
2917.583806,52,85,0.9,33,0.027272727,11
2917.255727,36,58,0.69,22,0.031363636,11
2917.226458,52,63,0.3,11,0.027272727,11
2916.469758,36,56,0.69,20,0.0345,11
2916.345096,36,54,0.64,18,0.035555556,11
2915.913107,37,97,0.12,60,0.002,11
2915.512382,51,77,0.59,26,0.022692308,11
2915.242405,35,73,0.09,38,0.002368421,11
2915.183885,37,69,0.12,32,0.00375,11
2915.171181,37,57,0.66,20,0.033,11
2915.103137,39,55,0.58,16,0.03625,11
2914.073102,35,59,0.81,24,0.03375,11
2913.700692,32,58,0.88,26,0.033846154,11
2913.649123,37,55,0.62,18,0.034444444,11
2912.976319,38,56,0.65,18,0.036111111,11
2912.640277,36,47,0.43,11,0.039090909,11
2912.58109,60,62,0.07,2,0.035,11
2912.545223,48,81,0.75,33,0.022727273,11
2912.468988,56,73,0.57,17,0.033529412,11
2912.468988,55,74,0.64,19,0.033684211,11
2912.468988,53,77,0.8,24,0.033333333,11
2912.109542,34,75,0.1,41,0.002439024,11
2911.733745,38,59,0.75,21,0.035714286,11
2911.704672,46,84,0.86,38,0.022631579,11
2911.682967,35,99,0.1,64,0.0015625,11
2911.310464,38,57,0.61,19,0.032105263,11
2911.061065,47,68,0.63,21,0.03,11
2911.056626,38,48,0.37,10,0.037,11
2910.611602,47,58,0.04,11,0.003636364,11
2910.304663,40,48,0.29,8,0.03625,11
2910.09521,45,74,0.8,29,0.027586207,11
2909.664035,33,56,0.85,23,0.036956522,11
2909.307885,63,66,0.1,3,0.033333333,11
2909.307885,60,69,0.3,9,0.033333333,11
2908.647809,54,77,0.75,23,0.032608696,11
2908.470948,34,99,0.22,65,0.003384615,11
2908.275224,41,55,0.51,14,0.036428571,11
2908.25115,36,72,0.06,36,0.001666667,11
2907.627324,59,69,0.34,10,0.034,11
2907.627324,54,75,0.71,21,0.033809524,11
2907.217397,54,86,0.9,32,0.028125,11
2907.217397,53,87,0.96,34,0.028235294,11
2907.217397,53,88,0.98,35,0.028,11
2907.002399,49,65,0.45,16,0.028125,11
2906.872492,59,63,0.14,4,0.035,11
2906.872492,58,64,0.21,6,0.035,11
2906.542275,53,86,0.94,33,0.028484848,11
2906.5338,32,63,0.97,31,0.031290323,11
2905.791579,38,44,0.24,6,0.04,11
2905.4437,56,75,0.62,19,0.032631579,11
2905.295836,33,98,0.28,65,0.004307692,11
2905.159198,43,71,0.83,28,0.029642857,11
2904.541852,53,79,0.84,26,0.032307692,11
2903.984684,45,86,0.92,41,0.022439024,11
2903.226525,37,98,0.1,61,0.001639344,11
2902.643074,56,79,0.64,23,0.027826087,11
2902.573608,43,53,0.36,10,0.036,11
2902.572857,34,99,0.24,65,0.003692308,11
2902.176818,36,95,0.24,59,0.004067797,11
2901.76322,35,98,0.11,63,0.001746032,11
2901.189153,58,77,0.58,19,0.030526316,11
2901.113055,39,53,0.45,14,0.032142857,11
2900.903181,44,52,0.29,8,0.03625,11
2900.552189,49,67,0.49,18,0.027222222,11
2900.334819,38,52,0.46,14,0.032857143,11
2900.228158,44,72,0.83,28,0.029642857,11
2900.03562,36,56,0.75,20,0.0375,11
2899.062221,54,85,0.88,31,0.028387097,11
2898.986072,34,54,0.75,20,0.0375,11
2898.024602,36,50,0.51,14,0.036428571,11
2897.877633,34,53,0.71,19,0.037368421,11
2897.213967,35,98,0.18,63,0.002857143,11
2896.722627,35,96,0.25,61,0.004098361,11
2896.627289,52,77,0.84,25,0.0336,11
2896.439064,39,50,0.37,11,0.033636364,11
2896.293296,39,58,0.68,19,0.035789474,11
2896.090892,48,57,0.03,9,0.003333333,11
2895.883471,54,67,0.33,13,0.025384615,11
2895.866893,37,98,0.08,61,0.001311475,11
2895.798337,39,54,0.54,15,0.036,11
2895.462217,34,57,0.85,23,0.036956522,11
2894.602234,43,77,0.92,34,0.027058824,11
2894.2738,36,59,0.83,23,0.036086957,11
2894.2738,35,60,0.91,25,0.0364,11
2893.934408,55,76,0.69,21,0.032857143,11
2893.90263,48,82,0.76,34,0.022352941,11
2893.58079,60,70,0.33,10,0.033,11
2893.42104,41,51,0.32,10,0.032,11
2892.947467,35,98,0.13,63,0.002063492,11
2892.828493,51,86,0.96,35,0.027428571,11
2892.577121,41,76,0.89,35,0.025428571,11
2891.986672,35,96,0.27,61,0.00442623,11
2891.860284,35,60,0.78,25,0.0312,11
2891.754232,40,46,0.23,6,0.038333333,11
2891.456874,57,80,0.63,23,0.027391304,11
2891.260621,53,85,0.93,32,0.0290625,11
2891.260621,52,86,0.99,34,0.029117647,11
2890.664175,61,73,0.37,12,0.030833333,11
2890.606772,50,66,0.43,16,0.026875,11
2890.110446,38,94,0.09,56,0.001607143,11
2889.802763,49,79,0.69,30,0.023,11
2889.582304,40,42,0.08,2,0.04,11
2889.582304,39,43,0.16,4,0.04,11
2889.348172,37,98,0.11,61,0.001803279,11
2889.336161,38,61,0.8,23,0.034782609,11
2888.983124,36,94,0.22,58,0.003793103,11
2888.341767,53,89,0.99,36,0.0275,11
2888.325053,57,73,0.53,16,0.033125,11
2888.279992,39,54,0.51,15,0.034,11
2887.59213,50,78,0.64,28,0.022857143,11
2887.21041,54,76,0.74,22,0.033636364,11
2887.209473,55,73,0.6,18,0.033333333,11
2887.195699,51,63,0.34,12,0.028333333,11
2887.059018,50,79,0.65,29,0.022413793,11
2886.966899,38,97,0.1,59,0.001694915,11
2886.629288,37,96,0.14,59,0.002372881,11
2886.568392,53,90,0.97,37,0.026216216,11
2885.984116,40,97,0.04,57,0.000701754,11
2885.952329,45,80,0.83,35,0.023714286,11
2885.019134,42,51,0.33,9,0.036666667,11
2884.412351,35,72,0.16,37,0.004324324,11
2884.028196,58,70,0.4,12,0.033333333,11
2883.55978,33,54,0.73,21,0.034761905,11
2883.421208,44,75,0.86,31,0.027741935,11
2883.326105,52,80,0.91,28,0.0325,11
2883.195033,49,81,0.71,32,0.0221875,11
2882.990712,36,59,0.71,23,0.030869565,11
2882.686249,44,73,0.84,29,0.028965517,11
2882.657899,38,56,0.6,18,0.033333333,11
2882.475922,44,81,0.89,37,0.024054054,11
2881.982094,37,69,0.14,32,0.004375,11
2881.934772,39,55,0.59,16,0.036875,11
2881.781461,43,77,0.91,34,0.026764706,11
2881.681762,34,51,0.64,17,0.037647059,11
2881.568062,43,78,0.91,35,0.026,11
2881.078579,36,97,0.23,61,0.003770492,11
2880.961493,35,58,0.83,23,0.036086957,11
2880.795596,36,54,0.67,18,0.037222222,11
2880.654313,57,65,0.28,8,0.035,11
2880.559732,52,64,0.33,12,0.0275,11
2880.531288,34,55,0.7,21,0.033333333,11
2880.382374,38,55,0.57,17,0.033529412,11
2880.301046,33,58,0.88,25,0.0352,11
2879.74911,35,98,0.17,63,0.002698413,11
2879.702552,34,99,0.21,65,0.003230769,11
2879.49165,48,58,0.29,10,0.029,11
2879.489711,40,67,0.78,27,0.028888889,11
2879.215232,34,97,0.26,63,0.004126984,11
2878.989819,44,74,0.85,30,0.028333333,11
2878.652239,36,96,0.23,60,0.003833333,11
2878.591173,33,55,0.78,22,0.035454545,11
2878.555466,37,53,0.53,16,0.033125,11
2878.489039,35,48,0.51,13,0.039230769,11
2878.408236,45,73,0.79,28,0.028214286,11
2878.261654,40,49,0.3,9,0.033333333,11
2878.250406,33,59,0.9,26,0.034615385,11
2878.002425,43,63,0.58,20,0.029,11
2878.002425,42,64,0.64,22,0.029090909,11
2877.887357,57,71,0.47,14,0.033571429,11
2877.867108,62,71,0.28,9,0.031111111,11
2877.685449,52,79,0.9,27,0.033333333,11
2877.107547,43,70,0.86,27,0.031851852,11
2877.04129,48,68,0.58,20,0.029,11
2877.04129,47,69,0.64,22,0.029090909,11
2876.734364,38,98,0.07,60,0.001166667,11
2876.632936,37,57,0.67,20,0.0335,11
2876.212456,51,78,0.91,27,0.033703704,11
2876.088929,41,74,0.98,33,0.02969697,11
2875.520314,42,71,0.96,29,0.033103448,11
2875.113863,32,99,0.35,67,0.005223881,11
2873.833617,50,66,0.44,16,0.0275,11
2873.824696,54,88,0.94,34,0.027647059,11
2873.608839,33,97,0.33,64,0.00515625,11
2873.566797,31,58,0.96,27,0.035555556,11
2873.510967,43,76,0.92,33,0.027878788,11
2873.435292,36,55,0.71,19,0.037368421,11
2872.899689,51,80,0.97,29,0.033448276,11
2872.56508,39,97,0.05,58,0.000862069,11
2872.301316,44,64,0.57,20,0.0285,11
2872.033626,46,72,0.73,26,0.028076923,11
2871.999997,55,87,0.88,32,0.0275,11
2871.899135,38,59,0.76,21,0.036190476,11
2871.643387,44,76,0.86,32,0.026875,11
2871.474663,39,51,0.45,12,0.0375,11
2871.428651,52,79,0.89,27,0.032962963,11
2870.734646,37,99,0.08,62,0.001290323,11
2870.559832,34,61,0.84,27,0.031111111,11
2870.417369,42,73,0.98,31,0.031612903,11
2870.032043,42,72,0.96,30,0.032,11
2869.894955,37,59,0.69,22,0.031363636,11
2869.54727,35,53,0.68,18,0.037777778,11
2869.391945,33,65,0.98,32,0.030625,11
2869.345598,56,78,0.68,22,0.030909091,11
2869.25539,32,78,0.05,46,0.001086957,11
2869.1965,45,72,0.79,27,0.029259259,11
2868.371634,51,53,0.06,2,0.03,11
2868.162524,49,80,0.71,31,0.022903226,11
2867.176968,36,96,0.15,60,0.0025,11
2866.87206,50,80,0.67,30,0.022333333,11
2866.863584,35,54,0.73,19,0.038421053,11
2866.526054,35,95,0.24,60,0.004,11
2866.192087,43,75,0.91,32,0.0284375,11
2864.789653,46,79,0.78,33,0.023636364,11
2864.751801,35,56,0.79,21,0.037619048,11
2864.580856,37,53,0.61,16,0.038125,11
2864.394458,59,75,0.49,16,0.030625,11
2864.393324,37,69,0.15,32,0.0046875,11
2863.944657,53,78,0.82,25,0.0328,11
2863.930789,39,66,0.13,27,0.004814815,11
2863.894883,43,47,0.15,4,0.0375,11
2863.894883,41,49,0.3,8,0.0375,11
2863.59822,48,67,0.53,19,0.027894737,11
2863.572717,36,97,0.11,61,0.001803279,11
2863.295729,35,50,0.56,15,0.037333333,11
2863.183227,45,64,0.63,19,0.033157895,11
2862.39233,62,74,0.36,12,0.03,11
2862.39233,61,75,0.42,14,0.03,11
2862.39233,60,76,0.48,16,0.03,11
2862.27943,37,95,0.1,58,0.001724138,11
2862.275821,53,84,0.85,31,0.027419355,11
2862.095346,35,98,0.12,63,0.001904762,11
2861.807501,32,57,0.94,25,0.0376,11
2861.772563,57,77,0.57,20,0.0285,11
2861.772563,56,78,0.63,22,0.028636364,11
2861.38017,42,72,0.9,30,0.03,11
2861.177236,36,98,0.16,62,0.002580645,11
2861.093472,58,75,0.53,17,0.031176471,11
2860.875226,35,94,0.26,59,0.00440678,11
2860.534142,43,74,0.9,31,0.029032258,11
2859.999936,42,52,0.33,10,0.033,11
2859.753346,34,98,0.29,64,0.00453125,11
2859.04287,37,63,0.79,26,0.030384615,11
2859.012203,47,59,0.04,12,0.003333333,11
2858.667585,59,77,0.54,18,0.03,11
2858.660284,32,98,0.35,66,0.00530303,11
2858.613549,67,69,0.06,2,0.03,11
2858.613549,66,70,0.12,4,0.03,11
2858.613549,65,71,0.18,6,0.03,11
2858.613549,64,72,0.24,8,0.03,11
2858.613549,63,73,0.3,10,0.03,11
2858.433375,33,98,0.3,65,0.004615385,11
2858.238615,29,83,0.46,54,0.008518519,11
2857.015396,47,79,0.75,32,0.0234375,11
2856.786148,38,54,0.6,16,0.0375,11
2856.479768,32,56,0.91,24,0.037916667,11
2856.479768,31,57,0.99,26,0.038076923,11
2856.351887,35,97,0.24,62,0.003870968,11
2856.215235,33,54,0.81,21,0.038571429,11
2856.136671,38,92,0.13,54,0.002407407,11
2856.051451,43,66,0.76,23,0.033043478,11
2855.907766,24,99,0.44,75,0.005866667,11
2855.789441,34,99,0.25,65,0.003846154,11
2855.645185,53,86,0.95,33,0.028787879,11
2855.442905,38,48,0.39,10,0.039,11
2855.335059,43,85,0.97,42,0.023095238,11
2855.307705,36,95,0.25,59,0.004237288,11
2855.10495,38,99,0.08,61,0.001311475,11
2855.075391,54,88,0.95,34,0.027941176,11
2854.876518,33,62,0.95,29,0.032758621,11
2854.853003,39,97,0.04,58,0.000689655,11
2854.692027,37,58,0.65,21,0.030952381,11
2854.48107,51,54,0.01,3,0.003333333,11
2854.420065,42,49,0.24,7,0.034285714,11
2854.1063,47,70,0.66,23,0.028695652,11
2853.922692,43,72,0.91,29,0.03137931,11
2853.913694,45,68,0.68,23,0.029565217,11
2853.758318,50,67,0.46,17,0.027058824,11
2853.704767,34,55,0.8,21,0.038095238,11
2853.503305,46,58,0.05,12,0.004166667,11
2853.419525,35,61,0.81,26,0.031153846,11
2853.411159,46,49,0.11,3,0.036666667,11
2853.285561,34,98,0.27,64,0.00421875,11
2852.628457,41,63,0.65,22,0.029545455,11
2852.628457,40,64,0.71,24,0.029583333,11
2852.357449,44,80,0.9,36,0.025,11
2852.198169,40,67,0.09,27,0.003333333,11
2852.001297,34,55,0.77,21,0.036666667,11
2851.886835,53,89,0.95,36,0.026388889,11
2851.690643,48,85,0.79,37,0.021351351,11
2851.339037,46,60,0.05,14,0.003571429,11
2851.295488,57,84,0.76,27,0.028148148,11
2851.176143,32,57,0.97,25,0.0388,11
2850.844454,37,58,0.68,21,0.032380952,11
2850.100108,31,56,0.96,25,0.0384,11
2849.774462,38,55,0.54,17,0.031764706,11
2849.521197,40,57,0.61,17,0.035882353,11
2849.463031,48,56,0.03,8,0.00375,11
2849.399084,44,84,0.92,40,0.023,11
2849.176728,58,71,0.44,13,0.033846154,11
2848.750197,43,49,0.22,6,0.036666667,11
2848.65333,51,52,0.03,1,0.03,11
2848.65333,50,53,0.09,3,0.03,11
2848.47163,38,93,0.1,55,0.001818182,11
2848.214601,54,74,0.67,20,0.0335,11
2848.149334,42,67,0.84,25,0.0336,11
2848.09442,26,91,0.53,65,0.008153846,11
2848.026662,39,56,0.54,17,0.031764706,11
2847.660454,62,73,0.34,11,0.030909091,11
2847.40426,31,58,0.93,27,0.034444444,11
2847.241377,52,86,0.92,34,0.027058824,11
2847.235431,38,51,0.47,13,0.036153846,11
2846.650067,36,96,0.22,60,0.003666667,11
2846.641547,34,62,0.9,28,0.032142857,11
2846.504804,40,53,0.49,13,0.037692308,11
2846.391855,46,63,0.56,17,0.032941176,11
2846.081899,37,99,0.1,62,0.001612903,11
2845.876177,62,78,0.45,16,0.028125,11
2845.876177,58,83,0.7,25,0.028,11
2845.673626,46,59,0.05,13,0.003846154,11
2845.471653,34,53,0.69,19,0.036315789,11
2845.082603,33,99,0.25,66,0.003787879,11
2844.883164,45,71,0.77,26,0.029615385,11
2844.870502,58,76,0.55,18,0.030555556,11
2844.798418,55,61,0.16,6,0.026666667,11
2844.571483,45,79,0.84,34,0.024705882,11
2844.553825,46,67,0.67,21,0.031904762,11
2844.40421,35,94,0.25,59,0.004237288,11
2844.353246,35,97,0.2,62,0.003225806,11
2844.289343,58,77,0.53,19,0.027894737,11
2844.270247,42,55,0.46,13,0.035384615,11
2844.270247,41,56,0.53,15,0.035333333,11
2844.245323,36,51,0.53,15,0.035333333,11
2844.033402,36,95,0.23,59,0.003898305,11
2843.867834,38,95,0.11,57,0.001929825,11
2843.724566,41,63,0.1,22,0.004545455,11
2843.519531,44,64,0.05,20,0.0025,11
2843.30562,41,69,0.91,28,0.0325,11
2843.300757,56,81,0.69,25,0.0276,11
2843.300757,55,82,0.75,27,0.027777778,11
2843.246934,50,72,0.56,22,0.025454545,11
2843.241679,49,73,0.61,24,0.025416667,11
2843.232437,36,96,0.12,60,0.002,11
2843.203067,37,95,0.15,58,0.002586207,11
2842.77832,34,97,0.29,63,0.004603175,11
2842.637333,25,92,0.55,67,0.008208955,11
2842.575983,37,68,0.15,31,0.00483871,11
2842.174431,37,57,0.74,20,0.037,11
2842.014812,55,87,0.89,32,0.0278125,11
2841.8044,52,63,0.31,11,0.028181818,11
2841.745893,39,59,0.72,20,0.036,11
2841.642707,47,83,0.82,36,0.022777778,11
2841.443119,43,78,0.93,35,0.026571429,11
2841.318535,43,46,0.1,3,0.033333333,11
2841.237567,38,97,0.07,59,0.001186441,11
2841.073332,38,99,0.04,61,0.000655738,11
2840.927251,44,83,0.9,39,0.023076923,11
2840.530181,43,67,0.79,24,0.032916667,11
2840.360654,61,79,0.51,18,0.028333333,11
2840.187418,24,92,0.57,68,0.008382353,11
2839.924936,53,75,0.5,22,0.022727273,11
2839.634901,36,51,0.54,15,0.036,11
2839.615568,41,69,0.92,28,0.032857143,11
2839.337817,59,70,0.37,11,0.033636364,11
2839.275187,48,85,0.8,37,0.021621622,11
2839.093526,37,63,0.92,26,0.035384615,11
2838.95342,43,77,0.93,34,0.027352941,11
2838.822673,32,58,0.94,26,0.036153846,11
2838.354096,34,58,0.84,24,0.035,11
2838.122978,37,97,0.08,60,0.001333333,11
2837.954935,55,84,0.82,29,0.028275862,11
2837.511668,35,53,0.67,18,0.037222222,11
2837.509072,37,52,0.57,15,0.038,11
2837.482673,35,97,0.25,62,0.004032258,11
2837.187204,34,98,0.28,64,0.004375,11
2837.183007,54,84,0.87,30,0.029,11
2837.105983,56,74,0.6,18,0.033333333,11
2837.105983,54,77,0.76,23,0.033043478,11
2837.105983,53,78,0.83,25,0.0332,11
2836.819234,35,99,0.24,64,0.00375,11
2836.803136,37,99,0.07,62,0.001129032,11
2836.649395,53,64,0.29,11,0.026363636,11
2836.170067,45,81,0.84,36,0.023333333,11
2835.548879,33,58,0.93,25,0.0372,11
2835.532461,35,98,0.19,63,0.003015873,11
2835.433552,57,70,0.44,13,0.033846154,11
2834.658775,46,65,0.58,19,0.030526316,11
2834.455349,32,62,0.95,30,0.031666667,11
2834.439594,45,61,0.06,16,0.00375,11
2834.415216,41,71,0.98,30,0.032666667,11
2834.296603,36,98,0.15,62,0.002419355,11
2833.879903,26,89,0.54,63,0.008571429,11
2833.332466,56,65,0.22,9,0.024444444,11
2833.213007,52,79,0.59,27,0.021851852,11
2832.947511,39,97,0.07,58,0.001206897,11
2832.68716,36,70,0.16,34,0.004705882,11
2832.621004,37,95,0.11,58,0.001896552,11
2831.706948,46,66,0.66,20,0.033,11
2831.534962,35,96,0.23,61,0.003770492,11
2831.056088,36,97,0.12,61,0.001967213,11
2830.896088,46,85,0.88,39,0.022564103,11
2830.746892,34,49,0.6,15,0.04,11
2830.728972,35,97,0.26,62,0.004193548,11
2830.541206,43,62,0.56,19,0.029473684,11
2830.41968,34,59,0.92,25,0.0368,11
2830.325196,33,99,0.3,66,0.004545455,11
2830.301146,31,57,0.98,26,0.037692308,11
2829.816839,52,77,0.56,25,0.0224,11
2829.600149,60,73,0.4,13,0.030769231,11
2829.5415,49,66,0.47,17,0.027647059,11
2829.481844,38,52,0.53,14,0.037857143,11
2829.357117,44,65,0.69,21,0.032857143,11
2829.250264,55,85,0.84,30,0.028,11
2828.965392,35,97,0.17,62,0.002741935,11
2828.959375,52,70,0.44,18,0.024444444,11
2828.874391,55,66,0.27,11,0.024545455,11
2828.833239,49,58,0.26,9,0.028888889,11
2828.811231,56,80,0.66,24,0.0275,11
2828.763305,42,78,0.98,36,0.027222222,11
2828.660767,59,76,0.52,17,0.030588235,11
2828.558673,39,52,0.48,13,0.036923077,11
2828.545461,34,63,0.89,29,0.030689655,11
2828.521921,33,60,0.94,27,0.034814815,11
2828.457718,41,54,0.41,13,0.031538462,11
2828.450254,33,59,0.95,26,0.036538462,11
2828.313094,42,67,0.83,25,0.0332,11
2828.104215,32,58,0.99,26,0.038076923,11
2828.024516,35,52,0.67,17,0.039411765,11
2827.749942,35,61,0.83,26,0.031923077,11
2827.745221,49,54,0.15,5,0.03,11
2827.745221,48,55,0.21,7,0.03,11
2827.216253,45,78,0.83,33,0.025151515,11
2827.080151,32,55,0.8,23,0.034782609,11
2826.6766,45,68,0.74,23,0.032173913,11
2826.537913,43,66,0.65,23,0.02826087,11
2826.399645,39,99,0.02,60,0.000333333,11
2826.315389,38,95,0.12,57,0.002105263,11
2826.158402,48,82,0.77,34,0.022647059,11
2826.028043,45,86,0.93,41,0.022682927,11
2825.98242,39,53,0.55,14,0.039285714,11
2825.98242,38,54,0.63,16,0.039375,11
2825.781918,35,99,0.2,64,0.003125,11
2825.530034,41,48,0.26,7,0.037142857,11
2825.343395,59,82,0.64,23,0.027826087,11
2825.343395,56,86,0.83,30,0.027666667,11
2824.954429,36,70,0.17,34,0.005,11
2824.916478,51,81,0.98,30,0.032666667,11
2824.690072,35,55,0.75,20,0.0375,11
2824.539988,33,61,0.95,28,0.033928571,11
2824.442297,39,56,0.55,17,0.032352941,11
2824.173931,46,66,0.6,20,0.03,11
2823.588458,36,64,0.97,28,0.034642857,11
2823.332569,61,72,0.34,11,0.030909091,11
2823.332569,57,76,0.59,19,0.031052632,11
2823.332569,55,78,0.72,23,0.031304348,11
2823.145102,46,84,0.87,38,0.022894737,11
2823.126365,37,70,0.12,33,0.003636364,11
2822.996619,35,99,0.17,64,0.00265625,11
2822.794324,44,70,0.83,26,0.031923077,11
2822.780602,41,66,0.72,25,0.0288,11
2822.703566,47,71,0.67,24,0.027916667,11
2822.695119,33,57,0.92,24,0.038333333,11
2822.686092,38,67,0.12,29,0.004137931,11
2822.60255,59,71,0.4,12,0.033333333,11
2822.60255,55,75,0.67,20,0.0335,11
2822.403084,32,55,0.88,23,0.03826087,11
2822.363252,38,98,0.06,60,0.001,11
2822.341966,33,59,0.98,26,0.037692308,11
2822.333421,34,63,0.9,29,0.031034483,11
2822.131984,35,73,0.1,38,0.002631579,11
2821.811174,47,69,0.61,22,0.027727273,11
2821.784199,44,83,0.91,39,0.023333333,11
2821.783388,41,53,0.43,12,0.035833333,11
2821.756839,45,63,0.04,18,0.002222222,11
2821.674868,47,77,0.71,30,0.023666667,11
2821.551999,40,54,0.46,14,0.032857143,11
2821.117479,35,73,0.08,38,0.002105263,11
2820.888822,41,54,0.42,13,0.032307692,11
2820.343931,33,56,0.88,23,0.03826087,11
2820.224585,33,61,0.96,28,0.034285714,11
2819.961954,35,57,0.82,22,0.037272727,11
2819.935598,33,54,0.8,21,0.038095238,11
2819.620807,39,66,0.12,27,0.004444444,11
2819.552532,41,68,0.9,27,0.033333333,11
2819.552532,40,69,0.97,29,0.033448276,11
2819.447682,49,65,0.46,16,0.02875,11
2819.422848,61,74,0.4,13,0.030769231,11
2819.325661,57,79,0.61,22,0.027727273,11
2819.029335,34,52,0.67,18,0.037222222,11
2818.854444,37,54,0.63,17,0.037058824,11
2818.836318,43,84,0.96,41,0.023414634,11
2818.76282,34,58,0.9,24,0.0375,11
2818.390141,62,72,0.31,10,0.031,11
2818.217296,64,70,0.19,6,0.031666667,11
2818.171775,40,65,0.73,25,0.0292,11
2817.992979,42,65,0.66,23,0.028695652,11
2817.840903,41,68,0.91,27,0.033703704,11
2817.82885,34,54,0.76,20,0.038,11
2817.742495,56,85,0.82,29,0.028275862,11
2817.725293,47,82,0.8,35,0.022857143,11
2817.646716,60,80,0.57,20,0.0285,11
2817.534861,42,66,0.81,24,0.03375,11
2817.534861,41,67,0.88,26,0.033846154,11
2817.508885,39,55,0.53,16,0.033125,11
2817.466191,37,63,0.9,26,0.034615385,11
2817.33978,35,59,0.8,24,0.033333333,11
2817.240987,48,79,0.72,31,0.023225806,11
2817.228822,56,84,0.79,28,0.028214286,11
2817.228822,56,85,0.81,29,0.027931034,11
2817.228822,55,86,0.87,31,0.028064516,11
2817.036014,34,97,0.28,63,0.004444444,11
2816.900162,33,57,0.91,24,0.037916667,11
2816.849409,40,69,0.98,29,0.033793103,11
2816.76469,40,53,0.48,13,0.036923077,11
2816.660228,43,73,0.9,30,0.03,11
2816.6277,38,60,0.78,22,0.035454545,11
2816.600408,44,69,0.75,25,0.03,11
2816.591872,32,59,0.91,27,0.033703704,11
2816.583465,33,60,0.93,27,0.034444444,11
2816.579196,33,99,0.27,66,0.004090909,11
2816.233515,42,62,0.59,20,0.0295,11
2816.080761,48,76,0.67,28,0.023928571,11
2815.847305,56,71,0.51,15,0.034,11
2815.82165,42,50,0.31,8,0.03875,11
2815.81266,45,65,0.63,20,0.0315,11
2815.758077,29,84,0.46,55,0.008363636,11
2815.581536,34,53,0.77,19,0.040526316,11
2815.568786,34,57,0.76,23,0.033043478,11
2815.503115,43,85,0.98,42,0.023333333,11
2815.348169,42,74,0.83,32,0.0259375,11
2815.137837,61,73,0.38,12,0.031666667,11
2815.137837,58,76,0.57,18,0.031666667,11
2815.092002,51,78,0.61,27,0.022592593,11
2815.020252,57,84,0.75,27,0.027777778,11
2814.993875,38,53,0.56,15,0.037333333,11
2814.835213,43,84,0.97,41,0.023658537,11
2814.727438,40,77,0.94,37,0.025405405,11
2814.392937,37,50,0.5,13,0.038461538,11
2814.170856,34,99,0.2,65,0.003076923,11
2814.134218,36,59,0.75,23,0.032608696,11
2813.945539,40,96,0.05,56,0.000892857,11
2813.801353,39,51,0.44,12,0.036666667,11
2813.592414,53,91,0.99,38,0.026052632,11
2813.443136,37,62,0.88,25,0.0352,11
2813.373534,50,64,0.4,14,0.028571429,11
2813.373534,49,66,0.48,17,0.028235294,11
2813.373534,48,67,0.54,19,0.028421053,11
2813.28905,42,54,0.43,12,0.035833333,11
2813.28905,41,55,0.5,14,0.035714286,11
2813.282483,46,83,0.84,37,0.022702703,11
2813.035765,39,59,0.7,20,0.035,11
2812.924931,36,96,0.2,60,0.003333333,11
2812.826762,47,57,0.3,10,0.03,11
2812.762596,48,61,0.36,13,0.027692308,11
2812.460441,59,73,0.42,14,0.03,11
2812.424156,33,59,0.91,26,0.035,11
2812.415834,32,60,0.98,28,0.035,11
2812.415834,32,60,0.99,28,0.035357143,11
2812.082442,37,93,0.14,56,0.0025,11
2812.057118,37,95,0.14,58,0.002413793,11
2812.030424,54,60,0.17,6,0.028333333,11
2811.974642,44,69,0.81,25,0.0324,11
2811.80863,38,99,0.09,61,0.00147541,11
2811.793347,40,96,0.04,56,0.000714286,11
2811.776175,37,62,0.89,25,0.0356,11
2811.700074,43,63,0.07,20,0.0035,11
2811.507803,33,56,0.79,23,0.034347826,11
2811.505606,53,74,0.48,21,0.022857143,11
2811.496751,42,67,0.82,25,0.0328,11
2811.442968,51,96,0.93,45,0.020666667,11
2811.328811,34,98,0.17,64,0.00265625,11
2811.32678,42,77,0.98,35,0.028,11
2811.261554,38,67,0.13,29,0.004482759,11
2811.212941,39,99,0.03,60,0.0005,11
2811.199881,49,68,0.52,19,0.027368421,11
2810.877733,42,65,0.07,23,0.003043478,11
2810.755634,46,84,0.85,38,0.022368421,11
2810.586855,39,57,0.65,18,0.036111111,11
2810.561703,54,87,0.92,33,0.027878788,11
2810.097524,57,82,0.71,25,0.0284,11
2810.097524,55,85,0.85,30,0.028333333,11
2810.097524,54,87,0.93,33,0.028181818,11
2809.947586,36,53,0.65,17,0.038235294,11
2809.936054,36,58,0.79,22,0.035909091,11
2809.838008,43,54,0.39,11,0.035454545,11
2809.296969,44,62,0.07,18,0.003888889,11
2809.224881,60,74,0.44,14,0.031428571,11
2808.755393,55,61,0.17,6,0.028333333,11
2808.753116,34,62,0.91,28,0.0325,11
2808.634426,34,59,0.86,25,0.0344,11
2808.583342,35,62,0.84,27,0.031111111,11
2808.177033,41,66,0.08,25,0.0032,11
2807.878853,40,50,0.38,10,0.038,11
2807.81254,51,58,0.23,7,0.032857143,11
2807.811084,25,98,0.32,73,0.004383562,11
2807.703399,40,70,0.99,30,0.033,11
2807.679325,48,64,0.52,16,0.0325,11
2807.669216,38,57,0.6,19,0.031578947,11
2807.634148,38,94,0.1,56,0.001785714,11
2807.474216,36,96,0.11,60,0.001833333,11
2807.395439,36,61,0.78,25,0.0312,11
2807.322068,25,90,0.55,65,0.008461538,11
2806.871567,36,98,0.09,62,0.001451613,11
2806.862519,44,79,0.89,35,0.025428571,11
2806.771713,51,84,0.98,33,0.02969697,11
2806.757413,50,56,0.02,6,0.003333333,11
2806.681321,36,57,0.77,21,0.036666667,11
2806.54478,51,76,0.57,25,0.0228,11
2806.40979,43,49,0.23,6,0.038333333,11
2806.153514,36,59,0.72,23,0.031304348,11
2806.132607,60,75,0.46,15,0.030666667,11
2806.086039,40,67,0.1,27,0.003703704,11
2805.920495,32,58,0.92,26,0.035384615,11
2805.850826,60,72,0.36,12,0.03,11
2805.833046,54,89,0.96,35,0.027428571,11
2805.792566,45,74,0.81,29,0.027931034,11
2805.73056,36,96,0.18,60,0.003,11
2805.715342,34,97,0.22,63,0.003492063,11
2805.583552,39,97,0.06,58,0.001034483,11
2805.520214,63,75,0.35,12,0.029166667,11
2805.487405,45,50,0.18,5,0.036,11
2805.378508,36,69,0.17,33,0.005151515,11
2805.334323,38,46,0.3,8,0.0375,11
2805.057688,34,60,0.95,26,0.036538462,11
2804.812364,25,88,0.59,63,0.009365079,11
2804.753863,59,81,0.62,22,0.028181818,11
2804.029655,51,76,0.58,25,0.0232,11
2804.016537,40,83,0.09,43,0.002093023,11
2803.785417,39,60,0.75,21,0.035714286,11
2803.743213,47,84,0.81,37,0.021891892,11
2803.723453,36,95,0.22,59,0.003728814,11
2803.529709,56,86,0.81,30,0.027,11
2803.255382,36,64,0.98,28,0.035,11
2803.254903,24,97,0.43,73,0.005890411,11
2803.174548,38,49,0.42,11,0.038181818,11
2803.055983,56,87,0.81,31,0.026129032,11
2802.903017,40,52,0.43,12,0.035833333,11
2802.82968,40,64,0.12,24,0.005,11
2802.797716,36,63,0.96,27,0.035555556,11
2802.642773,34,56,0.84,22,0.038181818,11
2802.616947,43,46,0.11,3,0.036666667,11
2802.550655,37,63,0.93,26,0.035769231,11
2802.354256,34,62,0.99,28,0.035357143,11
2802.264469,45,68,0.75,23,0.032608696,11
2802.177264,37,62,0.87,25,0.0348,11
2801.987901,37,49,0.44,12,0.036666667,11
2801.911842,50,54,0.12,4,0.03,11
2801.911842,49,55,0.18,6,0.03,11
2801.911842,48,56,0.24,8,0.03,11
2801.613457,35,96,0.26,61,0.004262295,11
2801.610922,37,55,0.72,18,0.04,11
2801.355593,35,98,0.23,63,0.003650794,11
2801.310615,32,56,0.95,24,0.039583333,11
2801.267504,43,82,0.97,39,0.024871795,11
2801.153484,45,84,0.9,39,0.023076923,11
2800.856799,37,96,0.15,59,0.002542373,11
2800.808713,37,56,0.64,19,0.033684211,11
2800.755209,35,52,0.61,17,0.035882353,11
2800.736465,47,59,0.35,12,0.029166667,11
2800.028253,41,72,0.99,31,0.031935484,11
2799.896656,43,52,0.33,9,0.036666667,11
2799.514171,39,60,0.73,21,0.034761905,11
2799.315333,60,79,0.54,19,0.028421053,11
2799.315333,59,80,0.6,21,0.028571429,11
2799.315333,58,82,0.68,24,0.028333333,11
2799.315333,56,83,0.77,27,0.028518519,11
2799.315333,55,84,0.83,29,0.02862069,11
2799.315333,54,86,0.91,32,0.0284375,11
2799.315333,53,87,0.97,34,0.028529412,11
2799.309078,55,66,0.28,11,0.025454545,11
2799.15401,34,58,0.78,24,0.0325,11
2799.018668,52,64,0.32,12,0.026666667,11
2798.434324,35,98,0.24,63,0.003809524,11
2798.249491,41,83,0.06,42,0.001428571,11
2798.175138,40,58,0.63,18,0.035,11
2797.996008,37,69,0.11,32,0.0034375,11
2797.806787,38,92,0.12,54,0.002222222,11
2797.788237,38,58,0.73,20,0.0365,11
2797.586761,54,80,0.81,26,0.031153846,11
2797.578739,40,84,0.08,44,0.001818182,11
2797.527932,36,97,0.17,61,0.002786885,11
2797.397968,43,69,0.84,26,0.032307692,11
2797.169374,44,83,0.92,39,0.023589744,11
2797.051479,56,64,0.01,8,0.00125,11
2796.859071,46,67,0.68,21,0.032380952,11
2796.691139,42,69,0.89,27,0.032962963,11
2796.480349,57,78,0.65,21,0.030952381,11
2796.454797,32,56,0.92,24,0.038333333,11
2795.968473,35,54,0.72,19,0.037894737,11
2795.902799,48,69,0.56,21,0.026666667,11
2795.739111,55,70,0.35,15,0.023333333,11
2795.573616,32,57,0.86,25,0.0344,11
2795.504416,40,66,0.1,26,0.003846154,11
2795.502191,42,71,0.93,29,0.032068966,11
2795.415878,43,69,0.8,26,0.030769231,11
2795.374668,34,53,0.75,19,0.039473684,11
2795.331431,38,68,0.12,30,0.004,11
2795.315641,36,64,0.99,28,0.035357143,11
2795.269394,65,74,0.26,9,0.028888889,11
2795.108604,38,53,0.55,15,0.036666667,11
2795.010821,48,76,0.7,28,0.025,11
2794.942456,36,60,0.75,24,0.03125,11
2794.918233,59,64,0.12,5,0.024,11
2794.850309,45,52,0.25,7,0.035714286,11
2794.816519,49,80,0.7,31,0.022580645,11
2794.787486,50,73,0.55,23,0.023913043,11
2794.573105,45,86,0.91,41,0.022195122,11
2794.491477,54,68,0.34,14,0.024285714,11
2794.279608,44,82,0.9,38,0.023684211,11
2794.133642,40,56,0.57,16,0.035625,11
2793.979177,41,72,0.95,31,0.030645161,11
2793.771226,44,68,0.73,24,0.030416667,11
2793.690371,65,70,0.14,5,0.028,11
2793.673153,34,75,0.08,41,0.00195122,11
2793.582761,42,70,0.91,28,0.0325,11
2793.561248,58,76,0.51,18,0.028333333,11
2793.442511,34,75,0.09,41,0.002195122,11
2793.430227,47,81,0.78,34,0.022941176,11
2793.430227,46,82,0.83,36,0.023055556,11
2793.138223,32,58,0.86,26,0.033076923,11
2793.096044,41,71,0.96,30,0.032,11
2793.048287,41,52,0.41,11,0.037272727,11
2792.764304,42,64,0.08,22,0.003636364,11
2792.754478,56,77,0.62,21,0.02952381,11
2792.711359,50,55,0.17,5,0.034,11
2792.688412,58,82,0.69,24,0.02875,11
2792.409535,33,96,0.29,63,0.004603175,11
2792.371177,43,70,0.88,27,0.032592593,11
2792.301517,36,62,0.92,26,0.035384615,11
2792.174134,36,97,0.22,61,0.003606557,11
2792.167447,66,73,0.2,7,0.028571429,11
2792.073544,24,98,0.57,74,0.007702703,11
2791.78462,43,68,0.78,25,0.0312,11
2791.732476,36,58,0.74,22,0.033636364,11
2791.660375,38,93,0.11,55,0.002,11
2791.416426,44,70,0.76,26,0.029230769,11
2791.377739,48,69,0.57,21,0.027142857,11
2791.329403,33,97,0.32,64,0.005,11
2791.27965,32,60,0.92,28,0.032857143,11
2791.266564,38,48,0.4,10,0.04,11
2791.266564,34,53,0.76,19,0.04,11
2790.568603,45,69,0.7,24,0.029166667,11
2790.485696,56,72,0.54,16,0.03375,11
2790.214154,44,75,0.87,31,0.028064516,11
2790.140863,62,72,0.29,10,0.029,11
2790.134244,37,95,0.12,58,0.002068966,11
2789.981791,41,57,0.57,16,0.035625,11
2789.68277,42,56,0.49,14,0.035,11
2789.65929,40,68,0.78,28,0.027857143,11
2789.652353,57,83,0.75,26,0.028846154,11
2789.652353,56,85,0.83,29,0.02862069,11
2789.585218,42,69,0.85,27,0.031481481,11
2789.53442,36,96,0.16,60,0.002666667,11
2789.52275,47,83,0.8,36,0.022222222,11
2789.47493,47,70,0.63,23,0.027391304,11
2789.182699,37,53,0.59,16,0.036875,11
2789.143829,44,69,0.82,25,0.0328,11
2789.143829,43,70,0.89,27,0.032962963,11
2788.945683,56,79,0.65,23,0.02826087,11
2788.945683,55,80,0.71,25,0.0284,11
2788.865171,33,98,0.25,65,0.003846154,11
2788.497322,49,79,0.68,30,0.022666667,11
2788.3553,51,65,0.4,14,0.028571429,11
2788.194542,44,66,0.72,22,0.032727273,11
2788.034882,63,71,0.25,8,0.03125,11
2788.034882,59,75,0.5,16,0.03125,11
2787.989407,46,68,0.64,22,0.029090909,11
2787.979681,42,53,0.4,11,0.036363636,11
2787.936801,55,80,0.7,25,0.028,11
2787.617472,33,55,0.84,22,0.038181818,11
2787.281725,44,56,0.42,12,0.035,11
2787.234346,56,79,0.71,23,0.030869565,11
2787.073952,33,58,0.89,25,0.0356,11
2787.065481,58,74,0.48,16,0.03,11
2786.976696,38,67,0.15,29,0.005172414,11
2786.741878,25,93,0.55,68,0.008088235,11
2786.618528,25,88,0.57,63,0.009047619,11
2786.406096,48,81,0.74,33,0.022424242,11
2786.397479,44,80,0.89,36,0.024722222,11
2786.379676,35,59,0.87,24,0.03625,11
2786.295492,42,51,0.34,9,0.037777778,11
2786.268195,36,50,0.53,14,0.037857143,11
2786.097159,38,60,0.79,22,0.035909091,11
2785.858697,33,64,0.99,31,0.031935484,11
2785.850105,47,65,0.59,18,0.032777778,11
2785.82519,45,85,0.91,40,0.02275,11
2785.708165,44,70,0.84,26,0.032307692,11
2785.615678,35,62,0.83,27,0.030740741,11
2785.591127,56,77,0.66,21,0.031428571,11
2785.502458,43,64,0.04,21,0.001904762,11
2785.17598,55,79,0.76,24,0.031666667,11
2785.134588,46,79,0.77,33,0.023333333,11
2784.885697,37,51,0.53,14,0.037857143,11
2784.493291,25,89,0.55,64,0.00859375,11
2784.476437,41,51,0.39,10,0.039,11
2784.314521,51,77,0.6,26,0.023076923,11
2783.476429,55,86,0.89,31,0.028709677,11
2783.473765,29,84,0.47,55,0.008545455,11
2783.330209,57,78,0.59,21,0.028095238,11
2783.330209,56,80,0.67,24,0.027916667,11
2783.313807,39,47,0.31,8,0.03875,11
2783.181343,43,81,0.96,38,0.025263158,11
2782.967903,43,77,0.94,34,0.027647059,11
2782.889523,65,73,0.23,8,0.02875,11
2782.889523,61,77,0.46,16,0.02875,11
2782.889523,60,78,0.52,18,0.028888889,11
2782.889523,59,79,0.58,20,0.029,11
2782.889523,58,80,0.64,22,0.029090909,11
2782.889523,58,81,0.66,23,0.028695652,11
2782.889523,57,82,0.72,25,0.0288,11
2782.88589,49,83,0.74,34,0.021764706,11
2782.728904,57,75,0.54,18,0.03,11
2782.728904,56,76,0.6,20,0.03,11
2782.583694,57,77,0.62,20,0.031,11
2782.46902,55,67,0.29,12,0.024166667,11
2782.293437,52,73,0.49,21,0.023333333,11
2782.145799,55,86,0.88,31,0.028387097,11
2782.051189,59,81,0.63,22,0.028636364,11
2781.900667,43,81,0.97,38,0.025526316,11
2781.440823,53,75,0.74,22,0.033636364,11
2781.432849,48,74,0.66,26,0.025384615,11
2781.432849,47,76,0.73,29,0.025172414,11
2781.403526,43,77,0.95,34,0.027941176,11
2781.308187,41,67,0.74,26,0.028461538,11
2781.308187,40,68,0.8,28,0.028571429,11
2781.271518,34,98,0.2,64,0.003125,11
2781.193744,37,49,0.45,12,0.0375,11
2781.018927,43,55,0.42,12,0.035,11
2780.911363,43,57,0.49,14,0.035,11
2780.877266,60,72,0.38,12,0.031666667,11
2780.536626,41,70,0.96,29,0.033103448,11
2780.526141,53,60,0.2,7,0.028571429,11
2780.484195,34,53,0.73,19,0.038421053,11
2780.255816,34,74,0.11,40,0.00275,11
2780.254575,48,66,0.51,18,0.028333333,11
2780.22334,34,59,0.91,25,0.0364,11
2780.011407,45,67,0.73,22,0.033181818,11
2779.668401,55,81,0.73,26,0.028076923,11
2779.613322,58,76,0.56,18,0.031111111,11
2779.448482,51,78,0.9,27,0.033333333,11
2779.448482,50,79,0.97,29,0.033448276,11
2779.435052,64,69,0.16,5,0.032,11
2779.3974,42,76,0.97,34,0.028529412,11
2779.227981,47,64,0.52,17,0.030588235,11
2779.080046,45,62,0.49,17,0.028823529,11
2779.024748,32,99,0.28,67,0.004179104,11
2778.826496,36,62,0.94,26,0.036153846,11
2778.819573,51,70,0.49,19,0.025789474,11
2778.688557,35,98,0.2,63,0.003174603,11
2778.650244,59,74,0.47,15,0.031333333,11
2778.598214,57,85,0.74,28,0.026428571,11
2778.598214,55,87,0.85,32,0.0265625,11
2778.218473,48,82,0.75,34,0.022058824,11
2778.193026,34,56,0.79,22,0.035909091,11
2778.1865,55,78,0.68,23,0.029565217,11
2778.080174,32,56,0.96,24,0.04,11
2778.016028,58,83,0.67,25,0.0268,11
2778.016028,56,85,0.78,29,0.026896552,11
2778.016028,54,87,0.89,33,0.026969697,11
2778.016028,53,88,0.95,35,0.027142857,11
2777.975472,35,49,0.54,14,0.038571429,11
2777.901046,36,95,0.2,59,0.003389831,11
2777.879316,37,60,0.83,23,0.036086957,11
2777.85781,41,56,0.54,15,0.036,11
2777.65743,38,52,0.5,14,0.035714286,11
2777.582121,62,67,0.16,5,0.032,11
2777.396575,55,80,0.77,25,0.0308,11
2777.355031,45,76,0.05,31,0.001612903,11
2777.288949,37,61,0.86,24,0.035833333,11
2777.214679,52,64,0.34,12,0.028333333,11
2777.090166,35,97,0.22,62,0.003548387,11
2776.83688,33,54,0.84,21,0.04,11
2776.794815,42,79,0.99,37,0.026756757,11
2776.749554,46,85,0.86,39,0.022051282,11
2776.718891,35,58,0.85,23,0.036956522,11
2776.592801,46,64,0.59,18,0.032777778,11
2776.581054,53,72,0.58,19,0.030526316,11
2776.577429,46,70,0.71,24,0.029583333,11
2776.302606,36,96,0.17,60,0.002833333,11
2776.28377,25,89,0.57,64,0.00890625,11
2776.118823,35,99,0.18,64,0.0028125,11
2776.025852,46,51,0.18,5,0.036,11
2775.943948,49,84,0.75,35,0.021428571,11
2775.729587,50,67,0.45,17,0.026470588,11
2775.666989,56,60,0.11,4,0.0275,11
2775.666989,54,62,0.22,8,0.0275,11
2775.635609,47,81,0.79,34,0.023235294,11
2775.538844,40,54,0.51,14,0.036428571,11
2775.517769,46,78,0.77,32,0.0240625,11
2775.37924,37,94,0.18,57,0.003157895,11
2775.369714,63,69,0.19,6,0.031666667,11
2775.330848,39,56,0.62,17,0.036470588,11
2774.973488,41,69,0.93,28,0.033214286,11
2774.878542,37,54,0.64,17,0.037647059,11
2774.680353,45,82,0.86,37,0.023243243,11
2774.668121,46,83,0.85,37,0.022972973,11
2774.592363,44,53,0.32,9,0.035555556,11
2774.569934,51,82,0.93,31,0.03,11
2774.258657,48,62,0.44,14,0.031428571,11
2774.140977,48,78,0.7,30,0.023333333,11
2774.062319,56,86,0.79,30,0.026333333,11
2774.062319,54,88,0.9,34,0.026470588,11
2774.062319,54,89,0.92,35,0.026285714,11
2773.956179,37,69,0.13,32,0.0040625,11
2773.770564,40,52,0.47,12,0.039166667,11
2773.766393,34,58,0.88,24,0.036666667,11
2773.73141,32,99,0.33,67,0.004925373,11
2773.719941,47,71,0.65,24,0.027083333,11
2773.667951,41,47,0.22,6,0.036666667,11
2773.666064,49,74,0.6,25,0.024,11
2773.538497,33,98,0.26,65,0.004,11
2773.406705,53,88,0.97,35,0.027714286,11
2773.402951,35,53,0.7,18,0.038888889,11
2773.373069,59,77,0.5,18,0.027777778,11
2773.042409,61,76,0.41,15,0.027333333,11
2772.895913,56,67,0.27,11,0.024545455,11
2772.753848,50,97,0.98,47,0.020851064,11
2772.717141,46,82,0.84,36,0.023333333,11
2772.677064,37,70,0.08,33,0.002424242,11
2772.490027,37,96,0.11,59,0.001864407,11
2772.250402,40,56,0.58,16,0.03625,11
2772.110113,49,77,0.65,28,0.023214286,11
2772.076979,32,97,0.35,65,0.005384615,11
2771.811943,31,60,0.97,29,0.033448276,11
2771.675837,40,50,0.37,10,0.037,11
2771.617196,43,59,0.07,16,0.004375,11
2771.59438,46,71,0.68,25,0.0272,11
2771.569651,25,88,0.58,63,0.009206349,11
2771.530725,57,83,0.72,26,0.027692308,11
2771.530725,56,84,0.78,28,0.027857143,11
2771.530725,54,86,0.89,32,0.0278125,11
2771.530725,53,87,0.95,34,0.027941176,11
2771.529907,35,60,0.83,25,0.0332,11
2771.456854,59,78,0.52,19,0.027368421,11
2771.44827,36,96,0.19,60,0.003166667,11
2771.412032,43,84,0.99,41,0.024146341,11
2771.357288,54,81,0.84,27,0.031111111,11
2771.262574,41,53,0.4,12,0.033333333,11
2771.252566,46,77,0.78,31,0.02516129,11
2771.167299,33,53,0.76,20,0.038,11
2771.010173,43,61,0.53,18,0.029444444,11
2770.842944,34,60,0.94,26,0.036153846,11
2770.776061,35,98,0.26,63,0.004126984,11
2770.591128,40,51,0.4,11,0.036363636,11
2770.134869,47,75,0.72,28,0.025714286,11
2769.831838,43,86,0.98,43,0.022790698,11
2769.816286,35,96,0.18,61,0.00295082,11
2769.806574,36,63,0.95,27,0.035185185,11
2769.783809,38,68,0.1,30,0.003333333,11
2769.727771,55,82,0.74,27,0.027407407,11
2769.70459,45,72,0.74,27,0.027407407,11
2769.557453,34,97,0.2,63,0.003174603,11
2769.552483,37,70,0.07,33,0.002121212,11
2769.499574,36,55,0.72,19,0.037894737,11
2769.455851,34,75,0.11,41,0.002682927,11
2769.41346,43,71,0.91,28,0.0325,11
2769.218353,42,71,0.77,29,0.026551724,11
2769.146175,43,76,0.93,33,0.028181818,11
2769.085807,32,98,0.36,66,0.005454545,11
2769.046281,32,61,0.94,29,0.032413793,11
2768.917497,40,77,0.95,37,0.025675676,11
2768.894371,43,74,0.92,31,0.029677419,11
2768.804092,38,96,0.11,58,0.001896552,11
2768.780547,50,66,0.46,16,0.02875,11
2768.780547,49,67,0.52,18,0.028888889,11
2768.772372,39,96,0.05,57,0.000877193,11
2768.391908,38,51,0.43,13,0.033076923,11
2768.199739,25,88,0.56,63,0.008888889,11
2768.056703,63,76,0.37,13,0.028461538,11
2768.056703,57,83,0.74,26,0.028461538,11
2767.962555,64,74,0.29,10,0.029,11
2767.962555,62,77,0.43,15,0.028666667,11
2767.962555,61,78,0.49,17,0.028823529,11
2767.923121,35,97,0.18,62,0.002903226,11
2767.646874,42,56,0.5,14,0.035714286,11
2767.547702,42,73,0.99,31,0.031935484,11
2767.411066,59,82,0.63,23,0.027391304,11
2767.287562,41,68,0.07,27,0.002592593,11
2767.023857,46,81,0.81,35,0.023142857,11
2766.747175,41,57,0.56,16,0.035,11
2766.515025,44,88,0.97,44,0.022045455,11
2766.459593,47,67,0.57,20,0.0285,11
2766.398373,34,56,0.83,22,0.037727273,11
2766.24864,33,97,0.29,64,0.00453125,11
2766.055595,32,55,0.89,23,0.038695652,11
2765.971774,35,97,0.21,62,0.003387097,11
2765.904756,36,53,0.64,17,0.037647059,11
2765.776467,29,83,0.47,54,0.008703704,11
2765.540082,36,55,0.68,19,0.035789474,11
2765.38071,38,56,0.66,18,0.036666667,11
2765.321277,43,59,0.48,16,0.03,11
2765.266205,58,84,0.69,26,0.026538462,11
2765.266205,55,88,0.87,33,0.026363636,11
2765.266205,54,89,0.93,35,0.026571429,11
2765.116552,35,57,0.81,22,0.036818182,11
2765.099898,39,72,0.92,33,0.027878788,11
2765.086808,43,44,0.04,1,0.04,11
2765.086808,42,45,0.12,3,0.04,11
2765.086808,41,46,0.2,5,0.04,11
2764.994949,43,87,0.99,44,0.0225,11
2764.935175,33,53,0.77,20,0.0385,11
2764.928779,40,72,0.86,32,0.026875,11
2764.91908,45,78,0.85,33,0.025757576,11
2764.908697,25,93,0.41,68,0.006029412,11
2764.895675,58,73,0.49,15,0.032666667,11
2764.611401,44,79,0.9,35,0.025714286,11
2764.593201,35,68,0.98,33,0.02969697,11
2764.533985,34,57,0.81,23,0.035217391,11
2764.294656,37,56,0.67,19,0.035263158,11
2764.250352,56,82,0.76,26,0.029230769,11
2764.249273,34,99,0.14,65,0.002153846,11
2764.157391,32,78,0.06,46,0.001304348,11
2764.097922,36,97,0.26,61,0.004262295,11
2763.94345,53,88,0.99,35,0.028285714,11
2763.884575,34,58,0.89,24,0.037083333,11
2763.853579,50,62,0.39,12,0.0325,11
2763.666883,38,46,0.31,8,0.03875,11
2763.263517,60,82,0.5,22,0.022727273,11
2763.232824,40,74,0.9,34,0.026470588,11
2763.208288,57,68,0.33,11,0.03,11
2763.12445,39,54,0.52,15,0.034666667,11
2763.110668,50,82,0.69,32,0.0215625,11
2762.702719,33,61,0.89,28,0.031785714,11
2762.679185,35,74,0.06,39,0.001538462,11
2762.634602,39,58,0.69,19,0.036315789,11
2762.593486,61,74,0.37,13,0.028461538,11
2762.545449,35,52,0.68,17,0.04,11
2762.474712,33,99,0.28,66,0.004242424,11
2762.415401,51,71,0.51,20,0.0255,11
2762.356335,35,56,0.69,21,0.032857143,11
2762.206626,47,56,0.27,9,0.03,11
2762.156073,42,78,0.99,36,0.0275,11
2762.128914,54,79,0.79,25,0.0316,11
2761.843265,62,73,0.31,11,0.028181818,11
2761.320417,39,68,0.12,29,0.004137931,11
2760.851785,53,89,0.96,36,0.026666667,11
2760.747454,54,87,0.95,33,0.028787879,11
2760.603976,40,85,0.07,45,0.001555556,11
2760.444242,58,65,0.17,7,0.024285714,11
2760.211048,42,60,0.54,18,0.03,11
2760.179737,37,56,0.7,19,0.036842105,11
2760.032228,42,81,0.06,39,0.001538462,11
2759.935519,42,55,0.47,13,0.036153846,11
2759.864137,45,62,0.06,17,0.003529412,11
2759.822026,36,70,0.15,34,0.004411765,11
2759.816748,39,59,0.71,20,0.0355,11
2759.681401,47,63,0.52,16,0.0325,11
2759.681401,45,65,0.65,20,0.0325,11
2759.580385,54,69,0.35,15,0.023333333,11
2759.546718,42,69,0.9,27,0.033333333,11
2759.543506,60,80,0.56,20,0.028,11
2759.543506,57,83,0.73,26,0.028076923,11
2759.295224,39,53,0.48,14,0.034285714,11
2759.287179,36,72,0.07,36,0.001944444,11
2759.153693,38,55,0.59,17,0.034705882,11
2759.152454,42,75,0.99,33,0.03,11
2759.151948,52,82,0.88,30,0.029333333,11
2759.124827,43,68,0.81,25,0.0324,11
2759.076645,44,63,0.06,19,0.003157895,11
2759.008108,56,69,0.31,13,0.023846154,11
2758.900799,35,59,0.86,24,0.035833333,11
2758.407336,52,84,0.89,32,0.0278125,11
2758.407336,52,85,0.91,33,0.027575758,11
2758.407336,51,85,0.95,34,0.027941176,11
2758.363169,38,99,0.06,61,0.000983607,11
2758.349032,55,83,0.82,28,0.029285714,11
2758.240085,49,62,0.4,13,0.030769231,11
2758.240085,48,63,0.46,15,0.030666667,11
2758.229857,49,74,0.63,25,0.0252,11
2758.060365,54,89,0.94,35,0.026857143,11
2758.027574,53,63,0.27,10,0.027,11
2757.978055,54,79,0.74,25,0.0296,11
2757.950883,39,67,0.07,28,0.0025,11
2757.89014,33,55,0.87,22,0.039545455,11
2757.884557,36,55,0.67,19,0.035263158,11
2757.693458,58,83,0.69,25,0.0276,11
2757.549777,43,68,0.82,25,0.0328,11
2757.518677,43,67,0.78,24,0.0325,11
2757.489698,31,59,0.96,28,0.034285714,11
2757.406962,43,80,0.96,37,0.025945946,11
2757.31375,32,99,0.36,67,0.005373134,11
2757.114419,61,66,0.17,5,0.034,11
2756.971296,35,98,0.27,63,0.004285714,11
2756.892477,38,54,0.64,16,0.04,11
2756.889754,33,60,0.87,27,0.032222222,11
2756.873105,34,96,0.29,62,0.004677419,11
2756.70074,45,47,0.07,2,0.035,11
2756.626899,34,67,0.99,33,0.03,11
2756.591013,32,58,0.96,26,0.036923077,11
2756.503242,43,70,0.82,27,0.03037037,11
2756.194404,57,85,0.75,28,0.026785714,11
2756.194404,55,88,0.88,33,0.026666667,11
2756.043002,44,84,0.91,40,0.02275,11
2755.993411,42,54,0.38,12,0.031666667,11
2755.803619,83,93,0.06,10,0.006,11
2755.793465,25,97,0.33,72,0.004583333,11
2755.783895,31,59,0.93,28,0.033214286,11
2755.724133,47,76,0.7,29,0.024137931,11
2755.58855,38,51,0.49,13,0.037692308,11
2755.541352,45,70,0.76,25,0.0304,11
2755.482173,40,97,0.07,57,0.00122807,11
2755.243162,48,80,0.74,32,0.023125,11
2755.190061,43,71,0.9,28,0.032142857,11
2755.064202,38,52,0.51,14,0.036428571,11
2755.029624,38,93,0.12,55,0.002181818,11
2754.962263,44,67,0.75,23,0.032608696,11
2754.741036,34,48,0.57,14,0.040714286,11
2754.508313,57,84,0.73,27,0.027037037,11
2754.508313,56,84,0.77,28,0.0275,11
2754.508313,56,86,0.8,30,0.026666667,11
2754.508313,55,86,0.84,31,0.027096774,11
2754.508313,55,87,0.86,32,0.026875,11
2754.508313,54,87,0.9,33,0.027272727,11
2754.508313,54,88,0.91,34,0.026764706,11
2754.508313,53,88,0.96,35,0.027428571,11
2754.508313,53,89,0.97,36,0.026944444,11
2754.508313,53,90,0.99,37,0.026756757,11
2754.253735,40,55,0.46,15,0.030666667,11
2754.219702,36,96,0.13,60,0.002166667,11
2754.142484,56,65,0.23,9,0.025555556,11
2754.047544,55,65,0.02,10,0.002,11
2754.03345,55,72,0.39,17,0.022941176,11
2753.826631,42,78,0.97,36,0.026944444,11
2753.822979,44,48,0.14,4,0.035,11
2753.7169,47,60,0.04,13,0.003076923,11
2753.504819,36,49,0.49,13,0.037692308,11
