% profit,ema1,ema2,threshold,diff,thresh / diff,ID
3765.801416,58,65,0.25,7,0.035714286,30
3686.266197,50,73,0.83,23,0.036086957,30
3664.011549,53,70,0.61,17,0.035882353,30
3636.617301,55,70,0.53,15,0.035333333,30
3631.155953,52,74,0.77,22,0.035,30
3630.986217,55,71,0.56,16,0.035,30
3630.986217,54,71,0.6,17,0.035294118,30
3630.986217,54,72,0.63,18,0.035,30
3630.986217,53,73,0.7,20,0.035,30
3623.290895,63,69,0.19,6,0.031666667,30
3612.038027,58,74,0.51,16,0.031875,30
3611.348484,63,68,0.16,5,0.032,30
3610.196235,58,69,0.37,11,0.033636364,30
3603.482173,52,84,0.96,32,0.03,30
3583.009894,61,71,0.32,10,0.032,30
3564.856111,54,73,0.66,19,0.034736842,30
3564.856111,53,74,0.73,21,0.034761905,30
3564.856111,52,75,0.8,23,0.034782609,30
3564.856111,51,76,0.87,25,0.0348,30
3563.983214,58,70,0.4,12,0.033333333,30
3555.47911,61,65,0.14,4,0.035,30
3555.47911,60,66,0.21,6,0.035,30
3555.47911,59,67,0.28,8,0.035,30
3555.47911,58,68,0.35,10,0.035,30
3555.47911,57,69,0.42,12,0.035,30
3555.47911,56,70,0.49,14,0.035,30
3546.3498,37,51,0.54,14,0.038571429,30
3546.315237,38,50,0.46,12,0.038333333,30
3540.367767,40,48,0.3,8,0.0375,30
3539.236227,57,70,0.44,13,0.033846154,30
3537.688445,61,70,0.29,9,0.032222222,30
3527.956801,63,67,0.13,4,0.0325,30
3527.910135,55,84,0.83,29,0.02862069,30
3524.945041,59,68,0.31,9,0.034444444,30
3524.780137,58,69,0.38,11,0.034545455,30
3524.780137,57,70,0.45,13,0.034615385,30
3524.780137,56,71,0.52,15,0.034666667,30
3524.780137,55,72,0.59,17,0.034705882,30
3520.068732,51,77,0.89,26,0.034230769,30
3519.607162,39,49,0.38,10,0.038,30
3515.505676,62,64,0.07,2,0.035,30
3510.247346,57,74,0.56,17,0.032941176,30
3510.247346,53,78,0.83,25,0.0332,30
3509.495901,54,85,0.89,31,0.028709677,30
3505.288061,62,68,0.2,6,0.033333333,30
3505.288061,59,71,0.4,12,0.033333333,30
3504.374889,54,77,0.76,23,0.033043478,30
3504.099272,37,51,0.55,14,0.039285714,30
3503.613842,54,73,0.65,19,0.034210526,30
3503.613842,53,74,0.72,21,0.034285714,30
3501.287361,60,67,0.24,7,0.034285714,30
3499.423671,56,74,0.6,18,0.033333333,30
3499.423671,55,75,0.67,20,0.0335,30
3497.059931,42,46,0.15,4,0.0375,30
3496.808212,37,52,0.56,15,0.037333333,30
3494.941347,55,72,0.58,17,0.034117647,30
3490.714498,56,76,0.65,20,0.0325,30
3490.539733,61,69,0.26,8,0.0325,30
3490.539733,59,71,0.39,12,0.0325,30
3487.411318,62,69,0.23,7,0.032857143,30
3484.873813,54,78,0.78,24,0.0325,30
3483.773702,59,72,0.42,13,0.032307692,30
3483.773702,57,74,0.55,17,0.032352941,30
3483.150752,58,74,0.52,16,0.0325,30
3481.291865,59,73,0.45,14,0.032142857,30
3480.482517,53,75,0.75,22,0.034090909,30
3480.482517,52,76,0.82,24,0.034166667,30
3480.109597,57,75,0.58,18,0.032222222,30
3476.684992,58,73,0.49,15,0.032666667,30
3470.130963,55,73,0.61,18,0.033888889,30
3470.130963,54,74,0.68,20,0.034,30
3466.565169,58,80,0.63,22,0.028636364,30
3454.791407,38,50,0.45,12,0.0375,30
3454.145998,39,49,0.37,10,0.037,30
3453.396195,57,73,0.53,16,0.033125,30
3453.227667,60,71,0.36,11,0.032727273,30
3451.105685,56,83,0.76,27,0.028148148,30
3448.793371,36,50,0.56,14,0.04,30
3447.67929,55,76,0.69,21,0.032857143,30
3447.569142,52,72,0.71,20,0.0355,30
3445.22299,64,73,0.26,9,0.028888889,30
3444.705828,55,87,0.88,32,0.0275,30
3444.196131,42,48,0.22,6,0.036666667,30
3443.391696,62,76,0.4,14,0.028571429,30
3442.137097,56,75,0.62,19,0.032631579,30
3442.137097,53,78,0.82,25,0.0328,30
3441.73326,35,54,0.73,19,0.038421053,30
3439.739115,59,78,0.55,19,0.028947368,30
3439.739115,58,79,0.61,21,0.029047619,30
3439.739115,57,81,0.69,24,0.02875,30
3439.739115,56,82,0.75,26,0.028846154,30
3438.314609,61,69,0.27,8,0.03375,30
3437.910654,56,83,0.77,27,0.028518519,30
3436.162151,57,80,0.67,23,0.029130435,30
3436.162151,56,81,0.73,25,0.0292,30
3436.162151,55,82,0.79,27,0.029259259,30
3436.162151,55,83,0.81,28,0.028928571,30
3436.162151,54,83,0.85,29,0.029310345,30
3436.162151,54,84,0.87,30,0.029,30
3436.162151,53,85,0.93,32,0.0290625,30
3432.568503,36,53,0.65,17,0.038235294,30
3432.535019,41,47,0.23,6,0.038333333,30
3432.535019,37,52,0.57,15,0.038,30
3431.835468,35,52,0.68,17,0.04,30
3431.598843,54,84,0.86,30,0.028666667,30
3428.64287,55,77,0.71,22,0.032272727,30
3428.240497,52,79,0.89,27,0.032962963,30
3424.31091,56,72,0.54,16,0.03375,30
3421.904868,62,72,0.31,10,0.031,30
3421.628067,50,78,0.97,28,0.034642857,30
3421.535408,53,89,0.99,36,0.0275,30
3419.644463,63,74,0.32,11,0.029090909,30
3419.307752,56,74,0.61,18,0.033888889,30
3418.998946,53,84,0.91,31,0.029354839,30
3415.147771,62,79,0.45,17,0.026470588,30
3414.922549,59,83,0.63,24,0.02625,30
3414.004154,57,73,0.54,16,0.03375,30
3413.89333,39,51,0.44,12,0.036666667,30
3413.403374,60,78,0.51,18,0.028333333,30
3413.403374,59,79,0.57,20,0.0285,30
3412.255833,35,55,0.74,20,0.037,30
3412.12998,36,53,0.66,17,0.038823529,30
3411.356669,41,48,0.26,7,0.037142857,30
3411.356669,39,50,0.41,11,0.037272727,30
3410.992117,61,77,0.46,16,0.02875,30
3409.995963,61,66,0.17,5,0.034,30
3409.995963,57,71,0.47,14,0.033571429,30
3409.492529,54,81,0.81,27,0.03,30
3409.336721,58,72,0.47,14,0.033571429,30
3407.973234,60,74,0.42,14,0.03,30
3407.790921,60,70,0.33,10,0.033,30
3407.176466,40,48,0.31,8,0.03875,30
3405.434186,35,54,0.75,19,0.039473684,30
3401.232386,56,85,0.81,29,0.027931034,30
3401.232386,55,86,0.87,31,0.028064516,30
3401.232386,54,88,0.94,34,0.027647059,30
3400.953067,61,80,0.5,19,0.026315789,30
3400.203046,55,75,0.68,20,0.034,30
3398.604002,59,70,0.37,11,0.033636364,30
3397.732888,41,46,0.19,5,0.038,30
3397.298774,63,75,0.34,12,0.028333333,30
3397.181568,57,85,0.74,28,0.026428571,30
3396.63191,62,67,0.17,5,0.034,30
3393.072738,58,72,0.46,14,0.032857143,30
3393.072738,56,74,0.59,18,0.032777778,30
3391.88903,57,82,0.71,25,0.0284,30
3391.88903,53,87,0.96,34,0.028235294,30
3391.16077,35,55,0.75,20,0.0375,30
3391.059418,56,82,0.74,26,0.028461538,30
3391.059418,55,84,0.82,29,0.028275862,30
3390.910472,60,81,0.56,21,0.026666667,30
3390.804596,60,73,0.41,13,0.031538462,30
3390.489152,34,56,0.82,22,0.037272727,30
3388.627833,40,50,0.37,10,0.037,30
3387.694829,55,85,0.85,30,0.028333333,30
3385.700927,56,84,0.78,28,0.027857143,30
3385.659325,55,83,0.8,28,0.028571429,30
3385.659325,54,85,0.88,31,0.028387097,30
3385.659325,53,86,0.94,33,0.028484848,30
3385.624705,36,51,0.59,15,0.039333333,30
3385.573232,35,54,0.74,19,0.038947368,30
3384.538417,55,87,0.87,32,0.0271875,30
3384.022142,64,77,0.34,13,0.026153846,30
3383.118322,53,75,0.76,22,0.034545455,30
3383.118322,52,76,0.83,24,0.034583333,30
3383.118322,51,77,0.9,26,0.034615385,30
3381.055629,56,75,0.63,19,0.033157895,30
3379.591802,57,84,0.74,27,0.027407407,30
3379.591802,56,85,0.8,29,0.027586207,30
3377.881414,59,72,0.43,13,0.033076923,30
3377.533301,63,70,0.22,7,0.031428571,30
3376.194098,37,52,0.58,15,0.038666667,30
3373.042811,41,45,0.16,4,0.04,30
3373.042811,40,46,0.24,6,0.04,30
3371.61264,55,88,0.87,33,0.026363636,30
3371.089876,52,86,0.97,34,0.028529412,30
3370.412938,60,70,0.34,10,0.034,30
3370.399302,60,69,0.31,9,0.034444444,30
3367.256526,33,57,0.91,24,0.037916667,30
3367.223661,36,53,0.64,17,0.037647059,30
3367.223661,35,54,0.72,19,0.037894737,30
3366.223635,32,57,0.99,25,0.0396,30
3365.908893,38,52,0.52,14,0.037142857,30
3365.836303,56,71,0.51,15,0.034,30
3365.604504,66,72,0.17,6,0.028333333,30
3365.604504,61,78,0.48,17,0.028235294,30
3365.604504,59,80,0.59,21,0.028095238,30
3365.604504,58,81,0.65,23,0.02826087,30
3365.604504,58,82,0.67,24,0.027916667,30
3365.589151,34,56,0.83,22,0.037727273,30
3365.387393,59,82,0.62,23,0.026956522,30
3365.387393,58,84,0.69,26,0.026538462,30
3365.387393,57,85,0.75,28,0.026785714,30
3365.387393,56,86,0.8,30,0.026666667,30
3365.293138,34,54,0.77,20,0.0385,30
3364.682162,54,76,0.74,22,0.033636364,30
3364.155912,32,56,0.96,24,0.04,30
3363.097867,53,72,0.67,19,0.035263158,30
3362.610465,34,54,0.78,20,0.039,30
3361.574251,54,88,0.93,34,0.027352941,30
3361.283849,33,55,0.87,22,0.039545455,30
3361.262624,53,90,0.99,37,0.026756757,30
3360.880298,63,66,0.1,3,0.033333333,30
3360.243786,57,83,0.73,26,0.028076923,30
3360.243786,55,85,0.84,30,0.028,30
3360.243786,54,86,0.9,32,0.028125,30
3359.940929,36,53,0.67,17,0.039411765,30
3359.650053,55,70,0.52,15,0.034666667,30
3359.252589,39,49,0.39,10,0.039,30
3359.252589,38,50,0.47,12,0.039166667,30
3358.352172,74,91,0.29,17,0.017058824,30
3358.352172,72,93,0.36,21,0.017142857,30
3358.352172,68,98,0.51,30,0.017,30
3357.218103,61,68,0.24,7,0.034285714,30
3357.137237,39,47,0.32,8,0.04,30
3357.137237,38,48,0.4,10,0.04,30
3357.137237,37,49,0.48,12,0.04,30
3356.614592,53,77,0.8,24,0.033333333,30
3356.03196,75,89,0.24,14,0.017142857,30
3356.03196,73,91,0.31,18,0.017222222,30
3355.990849,69,97,0.48,28,0.017142857,30
3355.127982,61,81,0.52,20,0.026,30
3354.174342,71,93,0.38,22,0.017272727,30
3353.544275,52,85,0.98,33,0.02969697,30
3353.031868,61,63,0.07,2,0.035,30
3353.031868,60,64,0.14,4,0.035,30
3353.031868,59,65,0.21,6,0.035,30
3352.569984,58,71,0.44,13,0.033846154,30
3350.376276,56,86,0.81,30,0.027,30
3349.66685,54,89,0.93,35,0.026571429,30
3349.163184,37,50,0.5,13,0.038461538,30
3348.579701,36,51,0.6,15,0.04,30
3346.699201,59,80,0.58,21,0.027619048,30
3346.188445,53,88,0.97,35,0.027714286,30
3345.859571,55,88,0.88,33,0.026666667,30
3345.332681,53,83,0.9,30,0.03,30
3344.855369,53,86,0.95,33,0.028787879,30
3344.772767,56,90,0.85,34,0.025,30
3344.364903,70,95,0.43,25,0.0172,30
3344.364903,68,97,0.5,29,0.017241379,30
3343.56094,55,80,0.75,25,0.03,30
3342.32642,56,84,0.79,28,0.028214286,30
3342.32642,55,86,0.86,31,0.027741935,30
3342.32642,54,87,0.92,33,0.027878788,30
3342.32642,53,88,0.98,35,0.028,30
3342.022451,53,77,0.81,24,0.03375,30
3342.01313,67,99,0.55,32,0.0171875,30
3341.898977,54,82,0.83,28,0.029642857,30
3339.752228,61,82,0.54,21,0.025714286,30
3339.752228,60,83,0.59,23,0.025652174,30
3338.63764,55,87,0.86,32,0.026875,30
3338.261784,55,81,0.78,26,0.03,30
3338.261784,54,82,0.84,28,0.03,30
3337.530958,33,55,0.86,22,0.039090909,30
3335.627914,38,51,0.49,13,0.037692308,30
3333.665753,52,78,0.88,26,0.033846154,30
3333.344048,55,75,0.66,20,0.033,30
3332.804755,52,83,0.95,31,0.030645161,30
3332.510005,54,89,0.94,35,0.026857143,30
3331.922183,56,82,0.77,26,0.029615385,30
3330.469255,56,79,0.69,23,0.03,30
3330.43236,52,86,0.99,34,0.029117647,30
3329.673947,58,77,0.56,19,0.029473684,30
3329.673947,57,78,0.62,21,0.02952381,30
3329.450087,56,86,0.82,30,0.027333333,30
3329.271602,56,87,0.84,31,0.027096774,30
3329.061058,55,82,0.8,27,0.02962963,30
3329.061058,54,83,0.86,29,0.029655172,30
3329.061058,53,84,0.92,31,0.029677419,30
3328.874485,33,56,0.89,23,0.038695652,30
3328.444919,36,52,0.62,16,0.03875,30
3328.016687,54,90,0.95,36,0.026388889,30
3327.822452,58,83,0.68,25,0.0272,30
3327.586225,35,53,0.68,18,0.037777778,30
3327.512263,67,73,0.16,6,0.026666667,30
3326.724895,59,77,0.52,18,0.028888889,30
3325.279827,60,84,0.61,24,0.025416667,30
3325.279827,58,87,0.73,29,0.025172414,30
3324.919293,58,83,0.69,25,0.0276,30
3324.565902,62,79,0.46,17,0.027058824,30
3324.145294,55,88,0.9,33,0.027272727,30
3323.967085,54,89,0.95,35,0.027142857,30
3323.85564,35,55,0.73,20,0.0365,30
3323.446136,37,52,0.55,15,0.036666667,30
3323.446136,34,56,0.8,22,0.036363636,30
3322.539972,56,68,0.42,12,0.035,30
3322.251718,54,84,0.88,30,0.029333333,30
3322.251718,53,85,0.94,32,0.029375,30
3321.049925,60,80,0.55,20,0.0275,30
3320.954928,38,51,0.48,13,0.036923077,30
3320.242107,61,79,0.5,18,0.027777778,30
3320.025997,58,80,0.65,22,0.029545455,30
3320.025997,57,81,0.71,24,0.029583333,30
3319.683804,52,73,0.74,21,0.035238095,30
3319.621509,57,84,0.75,27,0.027777778,30
3319.521804,54,72,0.62,18,0.034444444,30
3319.521804,53,73,0.69,20,0.0345,30
3319.447858,40,49,0.34,9,0.037777778,30
3319.342799,37,50,0.51,13,0.039230769,30
3319.054061,34,54,0.79,20,0.0395,30
3318.577007,60,79,0.54,19,0.028421053,30
3318.471824,54,70,0.57,16,0.035625,30
3317.044399,53,71,0.64,18,0.035555556,30
3316.82649,65,74,0.25,9,0.027777778,30
3315.511139,57,68,0.38,11,0.034545455,30
3315.511139,57,69,0.41,12,0.034166667,30
3315.511139,56,69,0.45,13,0.034615385,30
3315.250809,36,53,0.63,17,0.037058824,30
3314.791554,57,78,0.63,21,0.03,30
3313.972652,64,76,0.33,12,0.0275,30
3313.434953,50,77,0.94,27,0.034814815,30
3312.395336,61,76,0.44,15,0.029333333,30
3312.273525,32,57,0.98,25,0.0392,30
3312.031449,35,53,0.71,18,0.039444444,30
3311.858329,32,55,0.92,23,0.04,30
3311.563501,37,53,0.6,16,0.0375,30
3310.82681,54,76,0.73,22,0.033181818,30
3310.176667,58,68,0.34,10,0.034,30
3309.743297,62,78,0.43,16,0.026875,30
3309.743297,60,80,0.54,20,0.027,30
3309.326154,60,82,0.59,22,0.026818182,30
3309.32471,39,50,0.42,11,0.038181818,30
3308.928971,57,81,0.68,24,0.028333333,30
3308.535537,58,66,0.28,8,0.035,30
3308.535537,57,67,0.35,10,0.035,30
3307.380824,54,87,0.93,33,0.028181818,30
3307.194686,60,81,0.57,21,0.027142857,30
3307.00016,42,44,0.08,2,0.04,30
3306.149249,52,71,0.7,19,0.036842105,30
3305.107893,64,76,0.32,12,0.026666667,30
3304.086717,56,66,0.37,10,0.037,30
3303.843989,58,83,0.67,25,0.0268,30
3303.843989,57,83,0.71,26,0.027307692,30
3302.840576,62,75,0.38,13,0.029230769,30
3302.443039,37,52,0.59,15,0.039333333,30
3301.923016,37,53,0.59,16,0.036875,30
3301.698939,57,79,0.64,22,0.029090909,30
3301.551101,57,72,0.51,15,0.034,30
3301.326241,62,77,0.42,15,0.028,30
3301.326241,60,79,0.53,19,0.027894737,30
3301.326241,59,81,0.61,22,0.027727273,30
3301.14989,58,81,0.64,23,0.027826087,30
3301.14989,57,82,0.7,25,0.028,30
3301.14989,54,86,0.89,32,0.0278125,30
3300.950655,58,78,0.58,20,0.029,30
3300.699545,64,78,0.36,14,0.025714286,30
3300.201511,34,56,0.81,22,0.036818182,30
3298.760572,50,76,0.91,26,0.035,30
3298.485349,59,82,0.63,23,0.027391304,30
3298.165831,62,81,0.49,19,0.025789474,30
3298.074406,38,51,0.51,13,0.039230769,30
3298.002808,36,52,0.63,16,0.039375,30
3297.939128,62,80,0.47,18,0.026111111,30
3297.841347,37,51,0.53,14,0.037857143,30
3296.670893,61,68,0.23,7,0.032857143,30
3296.415577,56,70,0.48,14,0.034285714,30
3296.415577,55,71,0.55,16,0.034375,30
3296.368193,61,78,0.47,17,0.027647059,30
3295.374986,58,85,0.7,27,0.025925926,30
3295.35649,36,54,0.67,18,0.037222222,30
3294.627387,39,48,0.35,9,0.038888889,30
3294.206146,54,86,0.91,32,0.0284375,30
3293.615162,63,71,0.24,8,0.03,30
3293.615162,62,72,0.3,10,0.03,30
3293.615162,61,73,0.36,12,0.03,30
3292.963188,79,86,0.12,7,0.017142857,30
3292.028008,60,75,0.44,15,0.029333333,30
3292.028008,59,76,0.5,17,0.029411765,30
3291.656785,62,78,0.44,16,0.0275,30
3291.045197,60,78,0.52,18,0.028888889,30
3291.045197,59,79,0.58,20,0.029,30
3289.758405,66,76,0.26,10,0.026,30
3289.651929,32,57,0.96,25,0.0384,30
3288.87389,54,90,0.97,36,0.026944444,30
3287.811369,58,67,0.31,9,0.034444444,30
3287.51022,57,83,0.72,26,0.027692308,30
3285.685951,63,76,0.36,13,0.027692308,30
3284.813656,63,77,0.38,14,0.027142857,30
3284.813656,61,79,0.49,18,0.027222222,30
3284.813656,59,81,0.6,22,0.027272727,30
3284.813656,57,84,0.73,27,0.027037037,30
3284.57772,38,49,0.43,11,0.039090909,30
3283.286602,36,55,0.69,19,0.036315789,30
3283.232619,55,83,0.83,28,0.029642857,30
3283.185576,57,85,0.76,28,0.027142857,30
3283.128179,35,53,0.7,18,0.038888889,30
3282.917755,65,74,0.26,9,0.028888889,30
3282.431735,65,76,0.29,11,0.026363636,30
3281.089297,57,88,0.79,31,0.025483871,30
3281.089297,56,89,0.84,33,0.025454545,30
3281.089297,56,90,0.86,34,0.025294118,30
3281.089297,55,91,0.91,36,0.025277778,30
3280.713361,66,68,0.06,2,0.03,30
3280.713361,65,69,0.12,4,0.03,30
3280.713361,64,70,0.18,6,0.03,30
3280.668401,64,77,0.35,13,0.026923077,30
3280.668401,62,80,0.48,18,0.026666667,30
3280.668401,59,84,0.66,25,0.0264,30
3280.569506,68,73,0.13,5,0.026,30
3280.489088,32,56,0.95,24,0.039583333,30
3279.995196,53,87,0.97,34,0.028529412,30
3279.995196,53,88,0.99,35,0.028285714,30
3277.353987,35,56,0.77,21,0.036666667,30
3277.296104,56,82,0.76,26,0.029230769,30
3276.392001,59,84,0.65,25,0.026,30
3276.392001,57,87,0.77,30,0.025666667,30
3275.617202,51,74,0.81,23,0.035217391,30
3274.82184,61,74,0.38,13,0.029230769,30
3273.486146,58,80,0.64,22,0.029090909,30
3273.452146,54,86,0.94,32,0.029375,30
3273.424436,43,46,0.11,3,0.036666667,30
3272.511613,41,51,0.36,10,0.036,30
3271.047119,57,81,0.7,24,0.029166667,30
3270.719368,32,57,0.97,25,0.0388,30
3270.653646,67,73,0.17,6,0.028333333,30
3270.349598,55,90,0.92,35,0.026285714,30
3270.349598,54,91,0.98,37,0.026486486,30
3270.349598,54,92,0.99,38,0.026052632,30
3270.326969,58,82,0.66,24,0.0275,30
3270.326969,56,84,0.77,28,0.0275,30
3270.326969,55,85,0.83,30,0.027666667,30
3270.326969,55,86,0.85,31,0.027419355,30
3270.326969,54,87,0.91,33,0.027575758,30
3270.151562,56,85,0.79,29,0.027241379,30
3270.151562,54,88,0.92,34,0.027058824,30
3270.151562,53,89,0.98,36,0.027222222,30
3269.960623,71,95,0.41,24,0.017083333,30
3268.315719,63,78,0.4,15,0.026666667,30
3268.315719,60,82,0.58,22,0.026363636,30
3267.841973,59,85,0.68,26,0.026153846,30
3267.839622,54,85,0.9,31,0.029032258,30
3267.839622,53,86,0.96,33,0.029090909,30
3266.024262,58,84,0.7,26,0.026923077,30
3265.667223,59,83,0.65,24,0.027083333,30
3265.667223,58,85,0.72,27,0.026666667,30
3265.667223,57,86,0.78,29,0.026896552,30
3265.667223,55,88,0.89,33,0.026969697,30
3265.667223,54,90,0.96,36,0.026666667,30
3265.525547,65,77,0.31,12,0.025833333,30
3265.504997,34,58,0.87,24,0.03625,30
3262.543341,37,56,0.68,19,0.035789474,30
3262.488087,61,80,0.51,19,0.026842105,30
3261.879488,59,75,0.48,16,0.03,30
3261.563734,52,77,0.85,25,0.034,30
3261.563734,51,78,0.92,27,0.034074074,30
3261.563734,50,79,0.99,29,0.034137931,30
3260.754687,40,47,0.27,7,0.038571429,30
3260.331726,35,61,0.92,26,0.035384615,30
3259.159987,55,89,0.9,34,0.026470588,30
3258.747709,55,85,0.87,30,0.029,30
3257.776345,59,85,0.67,26,0.025769231,30
3257.762357,54,93,0.98,39,0.025128205,30
3257.045533,63,77,0.39,14,0.027857143,30
3256.417129,58,75,0.54,17,0.031764706,30
3255.872696,34,55,0.81,21,0.038571429,30
3255.398499,51,75,0.84,24,0.035,30
3254.810967,49,76,0.96,27,0.035555556,30
3254.807374,33,54,0.84,21,0.04,30
3254.310411,68,98,0.57,30,0.019,30
3253.606671,67,99,0.61,32,0.0190625,30
3253.326291,69,72,0.08,3,0.026666667,30
3253.326291,66,75,0.24,9,0.026666667,30
3253.326291,64,78,0.37,14,0.026428571,30
3253.326291,61,81,0.53,20,0.0265,30
3253.111437,60,83,0.6,23,0.026086957,30
3253.033247,53,86,0.97,33,0.029393939,30
3252.92912,36,52,0.61,16,0.038125,30
3252.844374,33,56,0.91,23,0.039565217,30
3252.593598,32,57,0.94,25,0.0376,30
3252.349134,55,91,0.93,36,0.025833333,30
3251.966947,56,89,0.85,33,0.025757576,30
3251.521945,59,78,0.56,19,0.029473684,30
3251.521945,58,79,0.62,21,0.02952381,30
3249.860905,58,76,0.54,18,0.03,30
3249.860905,57,77,0.6,20,0.03,30
3249.459775,66,67,0.03,1,0.03,30
3249.459775,65,68,0.09,3,0.03,30
3249.459775,64,69,0.15,5,0.03,30
3249.459775,63,70,0.21,7,0.03,30
3248.594772,56,87,0.83,31,0.026774194,30
3247.715328,32,56,0.94,24,0.039166667,30
3247.524593,59,83,0.64,24,0.026666667,30
3247.524593,58,85,0.71,27,0.026296296,30
3247.524593,57,86,0.77,29,0.026551724,30
3247.524593,56,87,0.82,31,0.026451613,30
3247.310111,57,86,0.76,29,0.026206897,30
3247.310111,56,88,0.83,32,0.0259375,30
3247.310111,55,89,0.89,34,0.026176471,30
3247.098685,63,79,0.42,16,0.02625,30
3246.337749,56,89,0.86,33,0.026060606,30
3245.956247,58,86,0.73,28,0.026071429,30
3245.301149,63,77,0.4,14,0.028571429,30
3244.148113,38,51,0.5,13,0.038461538,30
3244.080542,58,84,0.71,26,0.027307692,30
3243.752653,33,56,0.86,23,0.037391304,30
3243.745966,36,54,0.66,18,0.036666667,30
3243.31767,64,76,0.34,12,0.028333333,30
3243.31767,61,79,0.51,18,0.028333333,30
3243.066058,60,77,0.5,17,0.029411765,30
3242.497962,46,67,0.58,21,0.027619048,30
3240.898877,57,83,0.74,26,0.028461538,30
3240.371595,57,79,0.66,22,0.03,30
3240.371595,56,80,0.72,24,0.03,30
3239.273758,45,51,0.22,6,0.036666667,30
3239.008753,59,85,0.66,26,0.025384615,30
3237.622906,57,80,0.68,23,0.029565217,30
3237.592732,33,58,0.94,25,0.0376,30
3236.611543,56,87,0.89,31,0.028709677,30
3236.106876,62,79,0.48,17,0.028235294,30
3235.183607,59,79,0.59,20,0.0295,30
3234.970676,60,83,0.61,23,0.026521739,30
3234.610246,57,88,0.8,31,0.025806452,30
3234.610246,55,91,0.92,36,0.025555556,30
3234.610246,54,92,0.97,38,0.025526316,30
3233.683561,35,56,0.78,21,0.037142857,30
3233.388905,64,68,0.13,4,0.0325,30
3233.388905,62,70,0.26,8,0.0325,30
3233.388905,60,72,0.39,12,0.0325,30
3232.655857,35,53,0.69,18,0.038333333,30
3231.26013,33,56,0.88,23,0.03826087,30
3231.17156,55,89,0.91,34,0.026764706,30
3231.163294,40,49,0.35,9,0.038888889,30
3228.988388,66,74,0.22,8,0.0275,30
3227.587889,54,92,0.94,38,0.024736842,30
3227.581574,66,73,0.2,7,0.028571429,30
3227.083449,58,70,0.41,12,0.034166667,30
3227.033555,33,56,0.9,23,0.039130435,30
3226.547338,32,57,0.95,25,0.038,30
3226.349454,33,58,0.97,25,0.0388,30
3224.800617,60,81,0.58,21,0.027619048,30
3224.800617,60,82,0.6,22,0.027272727,30
3223.074936,53,85,0.95,32,0.0296875,30
3222.732508,65,76,0.31,11,0.028181818,30
3222.558753,35,52,0.67,17,0.039411765,30
3222.339769,54,93,0.99,39,0.025384615,30
3221.880991,61,75,0.4,14,0.028571429,30
3221.686166,39,50,0.43,11,0.039090909,30
3219.657699,57,85,0.77,28,0.0275,30
3219.580385,54,91,0.93,37,0.025135135,30
3219.482966,55,90,0.91,35,0.026,30
3219.482966,54,92,0.98,38,0.025789474,30
3219.061692,52,77,0.84,25,0.0336,30
3218.850132,59,69,0.34,10,0.034,30
3218.733964,53,76,0.78,23,0.033913043,30
3218.170781,60,80,0.57,20,0.0285,30
3217.832405,60,80,0.56,20,0.028,30
3216.499098,54,89,0.96,35,0.027428571,30
3215.263297,56,81,0.74,25,0.0296,30
3214.664193,33,59,0.96,26,0.036923077,30
3214.001487,67,74,0.19,7,0.027142857,30
3213.651791,61,81,0.57,20,0.0285,30
3213.214878,56,88,0.84,32,0.02625,30
3212.885818,34,55,0.82,21,0.039047619,30
3212.829382,33,54,0.83,21,0.03952381,30
3212.679687,40,49,0.33,9,0.036666667,30
3212.117921,39,53,0.51,14,0.036428571,30
3211.976936,36,57,0.76,21,0.036190476,30
3211.645991,65,75,0.27,10,0.027,30
3211.216465,61,78,0.49,17,0.028823529,30
3209.939388,54,91,0.99,37,0.026756757,30
3209.795475,68,72,0.11,4,0.0275,30
3209.585221,34,55,0.83,21,0.03952381,30
3209.562112,53,92,0.98,39,0.025128205,30
3208.679933,55,83,0.82,28,0.029285714,30
3208.149652,63,75,0.35,12,0.029166667,30
3207.760663,60,83,0.63,23,0.027391304,30
3206.811457,60,76,0.46,16,0.02875,30
3206.040615,52,75,0.79,23,0.034347826,30
3205.868252,34,53,0.76,19,0.04,30
3205.830414,62,77,0.43,15,0.028666667,30
3202.238956,60,78,0.53,18,0.029444444,30
3202.238956,57,82,0.73,25,0.0292,30
3202.238956,56,83,0.79,27,0.029259259,30
3202.238956,55,84,0.85,29,0.029310345,30
3200.386289,62,73,0.32,11,0.029090909,30
3200.071146,68,97,0.51,29,0.017586207,30
3199.827339,60,81,0.59,21,0.028095238,30
3199.1394,61,80,0.52,19,0.027368421,30
3199.033124,36,59,0.81,23,0.035217391,30
3199.001854,37,57,0.71,20,0.0355,30
3198.967698,65,76,0.3,11,0.027272727,30
3198.094146,54,75,0.7,21,0.033333333,30
3198.094146,53,76,0.77,23,0.033478261,30
3196.820392,57,88,0.81,31,0.026129032,30
3196.546912,42,47,0.19,5,0.038,30
3195.089523,54,75,0.71,21,0.033809524,30
3194.946784,41,48,0.27,7,0.038571429,30
3194.865923,55,92,0.92,37,0.024864865,30
3193.497859,34,55,0.8,21,0.038095238,30
3192.900359,36,51,0.58,15,0.038666667,30
3192.737581,61,67,0.2,6,0.033333333,30
3192.677338,68,98,0.56,30,0.018666667,30
3192.072804,55,89,0.86,34,0.025294118,30
3191.591841,42,50,0.29,8,0.03625,30
3191.1421,61,82,0.55,21,0.026190476,30
3190.513389,54,85,0.91,31,0.029354839,30
3190.003263,58,86,0.75,28,0.026785714,30
3189.788196,51,79,0.94,28,0.033571429,30
3189.111817,62,76,0.41,14,0.029285714,30
3188.003282,58,85,0.73,27,0.027037037,30
3187.255336,71,93,0.39,22,0.017727273,30
3186.950232,43,70,0.85,27,0.031481481,30
3186.935379,55,74,0.64,19,0.033684211,30
3186.628458,34,57,0.87,23,0.037826087,30
3186.451247,61,82,0.56,21,0.026666667,30
3186.451247,58,86,0.74,28,0.026428571,30
3186.451247,57,87,0.8,30,0.026666667,30
3186.451247,56,89,0.87,33,0.026363636,30
3185.937021,34,62,0.98,28,0.035,30
3184.782161,56,88,0.81,32,0.0253125,30
3184.690419,59,80,0.6,21,0.028571429,30
3183.822302,35,54,0.71,19,0.037368421,30
3183.620438,59,82,0.65,23,0.02826087,30
3181.88543,61,81,0.54,20,0.027,30
3181.647171,52,78,0.87,26,0.033461538,30
3181.367649,55,90,0.93,35,0.026571429,30
3180.953263,44,46,0.07,2,0.035,30
3180.118578,63,78,0.41,15,0.027333333,30
3180.03536,63,79,0.43,16,0.026875,30
3178.990852,67,72,0.14,5,0.028,30
3178.990852,64,75,0.31,11,0.028181818,30
3178.142079,56,73,0.57,17,0.033529412,30
3177.504221,58,86,0.72,28,0.025714286,30
3177.45822,56,85,0.84,29,0.028965517,30
3177.45822,55,86,0.9,31,0.029032258,30
3176.773442,60,68,0.27,8,0.03375,30
3175.385213,34,56,0.86,22,0.039090909,30
3175.175937,57,86,0.74,29,0.025517241,30
3174.375096,66,75,0.25,9,0.027777778,30
3174.357982,55,91,0.94,36,0.026111111,30
3174.012335,60,69,0.3,9,0.033333333,30
3173.282715,58,81,0.68,23,0.029565217,30
3173.282715,57,82,0.74,25,0.0296,30
3173.282715,56,84,0.82,28,0.029285714,30
3173.282715,55,85,0.88,30,0.029333333,30
3172.907397,55,84,0.84,29,0.028965517,30
3172.826563,56,89,0.88,33,0.026666667,30
3172.633794,33,55,0.85,22,0.038636364,30
3171.898068,71,94,0.4,23,0.017391304,30
3171.190362,62,80,0.5,18,0.027777778,30
3170.858115,62,78,0.45,16,0.028125,30
3170.164468,57,87,0.76,30,0.025333333,30
3169.211621,34,55,0.79,21,0.037619048,30
3168.863067,54,87,0.94,33,0.028484848,30
3167.590823,34,62,0.99,28,0.035357143,30
3166.847504,54,84,0.89,30,0.029666667,30
3166.006487,63,78,0.42,15,0.028,30
3166.006487,60,82,0.61,22,0.027727273,30
3165.975363,57,87,0.81,30,0.027,30
3165.859584,64,75,0.32,11,0.029090909,30
3165.859584,60,80,0.58,20,0.029,30
3165.792815,33,59,0.95,26,0.036538462,30
3165.338281,56,87,0.8,31,0.025806452,30
3164.044889,59,81,0.64,22,0.029090909,30
3164.044889,58,82,0.7,24,0.029166667,30
3164.044889,57,84,0.78,27,0.028888889,30
3162.874201,55,89,0.87,34,0.025588235,30
3162.874201,54,90,0.92,36,0.025555556,30
3162.874201,53,91,0.98,38,0.025789474,30
3162.582666,39,48,0.34,9,0.037777778,30
3162.514432,62,78,0.47,16,0.029375,30
3161.659636,52,83,0.96,31,0.030967742,30
3161.653519,53,92,0.97,39,0.024871795,30
3161.607742,61,80,0.53,19,0.027894737,30
3161.607742,58,84,0.72,26,0.027692308,30
3161.347151,65,75,0.28,10,0.028,30
3161.347151,64,77,0.36,13,0.027692308,30
3161.347151,62,79,0.47,17,0.027647059,30
3160.837106,33,57,0.94,24,0.039166667,30
3160.693111,54,86,0.93,32,0.0290625,30
3160.196334,57,86,0.83,29,0.02862069,30
3159.984497,58,81,0.66,23,0.028695652,30
3159.984497,57,82,0.72,25,0.0288,30
3159.886472,59,80,0.62,21,0.02952381,30
3159.784473,59,81,0.63,22,0.028636364,30
3159.714251,34,53,0.75,19,0.039473684,30
3158.986272,51,61,0.28,10,0.028,30
3158.664911,76,88,0.21,12,0.0175,30
3158.664911,74,90,0.28,16,0.0175,30
3158.664911,72,92,0.35,20,0.0175,30
3158.664911,69,96,0.47,27,0.017407407,30
3158.311835,57,84,0.76,27,0.028148148,30
3158.20176,49,63,0.39,14,0.027857143,30
3158.076243,68,73,0.14,5,0.028,30
3157.992341,62,82,0.51,20,0.0255,30
3157.992341,62,83,0.53,21,0.025238095,30
3157.992341,61,83,0.56,22,0.025454545,30
3157.992341,61,84,0.58,23,0.025217391,30
3157.992341,60,85,0.63,25,0.0252,30
3157.992341,59,86,0.68,27,0.025185185,30
3157.928224,65,77,0.32,12,0.026666667,30
3156.858407,50,78,0.96,28,0.034285714,30
3156.767118,36,52,0.6,16,0.0375,30
3156.715126,62,78,0.46,16,0.02875,30
3156.715126,61,79,0.52,18,0.028888889,30
3156.302385,59,83,0.66,24,0.0275,30
3156.302385,58,83,0.7,25,0.028,30
3156.073044,58,71,0.43,13,0.033076923,30
3156.034698,57,83,0.76,26,0.029230769,30
3156.034698,54,87,0.96,33,0.029090909,30
3155.533805,58,88,0.75,30,0.025,30
3155.533805,57,89,0.8,32,0.025,30
3153.219267,56,92,0.88,36,0.024444444,30
3153.219267,55,93,0.93,38,0.024473684,30
3152.766835,63,76,0.38,13,0.029230769,30
3152.298488,53,81,0.88,28,0.031428571,30
3152.04691,53,82,0.89,29,0.030689655,30
3151.937433,55,89,0.95,34,0.027941176,30
3151.802262,38,56,0.64,18,0.035555556,30
3151.390421,37,49,0.46,12,0.038333333,30
3151.343566,71,94,0.44,23,0.019130435,30
3151.067733,58,85,0.77,27,0.028518519,30
3151.067733,56,88,0.9,32,0.028125,30
3151.067733,55,89,0.96,34,0.028235294,30
3150.931301,55,74,0.65,19,0.034210526,30
3150.931301,54,75,0.72,21,0.034285714,30
3150.931301,53,76,0.79,23,0.034347826,30
3150.645131,51,79,0.95,28,0.033928571,30
3150.255523,34,56,0.84,22,0.038181818,30
3150.21196,64,74,0.29,10,0.029,30
3150.073166,32,57,0.93,25,0.0372,30
3149.88961,59,80,0.61,21,0.029047619,30
3149.88961,56,84,0.81,28,0.028928571,30
3149.463692,48,50,0.07,2,0.035,30
3149.463692,47,51,0.14,4,0.035,30
3149.463692,46,52,0.21,6,0.035,30
3149.463692,45,53,0.28,8,0.035,30
3149.358881,46,65,0.6,19,0.031578947,30
3149.350378,39,52,0.45,13,0.034615385,30
3148.542038,43,50,0.25,7,0.035714286,30
3148.354001,56,88,0.82,32,0.025625,30
3148.354001,54,91,0.94,37,0.025405405,30
3148.354001,53,92,0.99,39,0.025384615,30
3147.994089,34,54,0.76,20,0.038,30
3147.943132,63,79,0.44,16,0.0275,30
3147.522079,54,80,0.81,26,0.031153846,30
3146.988602,45,54,0.31,9,0.034444444,30
3146.988602,44,55,0.38,11,0.034545455,30
3146.916151,42,72,0.93,30,0.031,30
3146.81767,60,79,0.56,19,0.029473684,30
3146.111725,52,86,0.98,34,0.028823529,30
3146.032147,56,73,0.58,17,0.034117647,30
3145.415463,59,84,0.69,25,0.0276,30
3145.278023,58,83,0.71,25,0.0284,30
3144.975165,63,76,0.37,13,0.028461538,30
3144.81314,56,91,0.87,35,0.024857143,30
3144.587157,40,52,0.44,12,0.036666667,30
3144.530733,32,56,0.93,24,0.03875,30
3143.866636,55,87,0.92,32,0.02875,30
3143.866636,54,88,0.98,34,0.028823529,30
3143.538899,55,73,0.62,18,0.034444444,30
3143.505655,54,90,0.91,36,0.025277778,30
3143.246674,54,86,0.92,32,0.02875,30
3143.246674,53,87,0.98,34,0.028823529,30
3143.066369,58,85,0.69,27,0.025555556,30
3141.962284,57,86,0.75,29,0.025862069,30
3141.696064,58,82,0.68,24,0.028333333,30
3140.794815,43,47,0.14,4,0.035,30
3140.649906,36,59,0.82,23,0.035652174,30
3140.531203,45,67,0.68,22,0.030909091,30
3139.773879,45,52,0.25,7,0.035714286,30
3139.740621,53,91,0.97,38,0.025526316,30
3139.383564,33,57,0.92,24,0.038333333,30
3138.900499,59,84,0.7,25,0.028,30
3138.848875,53,87,0.99,34,0.029117647,30
3138.80533,66,77,0.28,11,0.025454545,30
3138.393249,35,60,0.88,25,0.0352,30
3138.209959,57,87,0.84,30,0.028,30
3137.856441,42,71,0.92,29,0.031724138,30
3136.863261,59,82,0.67,23,0.029130435,30
3136.863261,58,83,0.73,25,0.0292,30
3136.863261,57,84,0.79,27,0.029259259,30
3136.863261,56,85,0.85,29,0.029310345,30
3136.358655,58,84,0.73,26,0.028076923,30
3136.251836,54,87,0.97,33,0.029393939,30
3136.219267,57,86,0.82,29,0.028275862,30
3135.529872,43,56,0.45,13,0.034615385,30
3134.914699,53,87,0.92,34,0.027058824,30
3134.897539,57,84,0.77,27,0.028518519,30
3134.897539,56,85,0.83,29,0.02862069,30
3134.897539,54,88,0.97,34,0.028529412,30
3134.873396,63,77,0.41,14,0.029285714,30
3134.861695,56,72,0.55,16,0.034375,30
3134.783758,56,86,0.86,30,0.028666667,30
3134.71842,57,72,0.5,15,0.033333333,30
3134.199746,60,81,0.61,21,0.029047619,30
3134.199746,57,85,0.81,28,0.028928571,30
3134.199746,56,86,0.87,30,0.029,30
3133.608196,56,88,0.85,32,0.0265625,30
3133.586519,41,51,0.38,10,0.038,30
3133.586519,38,55,0.64,17,0.037647059,30
3133.396343,38,48,0.38,10,0.038,30
3132.611469,53,90,0.95,37,0.025675676,30
3132.368923,62,77,0.44,15,0.029333333,30
3132.368923,61,78,0.5,17,0.029411765,30
3132.122295,60,82,0.64,22,0.029090909,30
3131.827474,58,85,0.75,27,0.027777778,30
3131.827474,55,89,0.94,34,0.027647059,30
3131.800514,43,54,0.4,11,0.036363636,30
3131.714266,38,52,0.51,14,0.036428571,30
3131.462473,46,53,0.24,7,0.034285714,30
3131.435566,52,88,0.98,36,0.027222222,30
3131.19218,55,90,0.98,35,0.028,30
3131.092792,53,79,0.85,26,0.032692308,30
3131.092792,52,81,0.94,29,0.032413793,30
3130.989945,73,92,0.33,19,0.017368421,30
3130.989945,68,98,0.52,30,0.017333333,30
3130.922209,54,94,0.99,40,0.02475,30
3130.497332,55,68,0.47,13,0.036153846,30
3128.691325,68,75,0.18,7,0.025714286,30
3128.566807,66,99,0.63,33,0.019090909,30
3128.186188,46,66,0.62,20,0.031,30
3128.178614,61,81,0.55,20,0.0275,30
3128.178614,56,87,0.85,31,0.027419355,30
3128.117749,60,79,0.55,19,0.028947368,30
3128.117749,58,82,0.69,24,0.02875,30
3128.117749,57,83,0.75,26,0.028846154,30
3128.117749,54,87,0.95,33,0.028787879,30
3127.863482,77,86,0.16,9,0.017777778,30
3127.798133,66,79,0.26,13,0.02,30
3127.356285,57,87,0.79,30,0.026333333,30
3127.356285,54,91,0.97,37,0.026216216,30
3127.282457,39,54,0.54,15,0.036,30
3127.03057,52,82,0.94,30,0.031333333,30
3127.019076,59,84,0.67,25,0.0268,30
3126.322106,35,60,0.9,25,0.036,30
3126.082885,38,54,0.6,16,0.0375,30
3126.006701,57,85,0.79,28,0.028214286,30
3125.933513,51,82,0.99,31,0.031935484,30
3125.678921,33,57,0.93,24,0.03875,30
3125.678921,33,58,0.95,25,0.038,30
3125.677676,55,89,0.92,34,0.027058824,30
3124.944727,65,77,0.33,12,0.0275,30
3123.336143,58,83,0.72,25,0.0288,30
3123.277785,55,86,0.91,31,0.029354839,30
3123.211203,55,88,0.86,33,0.026060606,30
3123.211203,54,90,0.93,36,0.025833333,30
3122.927633,57,86,0.79,29,0.027241379,30
3122.916958,35,59,0.85,24,0.035416667,30
3122.678167,42,72,0.94,30,0.031333333,30
3122.497196,34,58,0.86,24,0.035833333,30
3121.905821,35,59,0.86,24,0.035833333,30
3121.854788,61,81,0.51,20,0.0255,30
3121.815592,55,88,0.94,33,0.028484848,30
3121.542513,42,56,0.5,14,0.035714286,30
3121.233229,56,88,0.91,32,0.0284375,30
3120.994261,55,87,0.83,32,0.0259375,30
3120.994261,54,89,0.9,35,0.025714286,30
3120.963454,61,80,0.55,19,0.028947368,30
3120.773006,65,75,0.29,10,0.029,30
3120.565403,72,93,0.4,21,0.019047619,30
3120.36602,54,91,0.96,37,0.025945946,30
3120.027966,36,59,0.83,23,0.036086957,30
3120.027966,35,60,0.91,25,0.0364,30
3119.93521,56,88,0.88,32,0.0275,30
3119.93521,55,90,0.96,35,0.027428571,30
3119.623552,61,83,0.57,22,0.025909091,30
3119.06077,32,99,0.19,67,0.002835821,30
3119.010683,64,77,0.38,13,0.029230769,30
3118.983363,64,76,0.35,12,0.029166667,30
3118.983363,62,79,0.49,17,0.028823529,30
3118.847153,39,51,0.45,12,0.0375,30
3118.563644,55,86,0.82,31,0.026451613,30
3118.563644,54,88,0.89,34,0.026176471,30
3118.563644,53,89,0.94,36,0.026111111,30
3118.563644,53,90,0.96,37,0.025945946,30
3118.388686,63,81,0.46,18,0.025555556,30
3117.86504,51,81,0.99,30,0.033,30
3117.74777,53,85,0.92,32,0.02875,30
3117.085755,44,67,0.73,23,0.03173913,30
3116.958801,63,82,0.48,19,0.025263158,30
3116.864295,56,85,0.82,29,0.028275862,30
3116.687307,65,80,0.3,15,0.02,30
3116.462589,68,97,0.55,29,0.018965517,30
3116.35954,36,58,0.78,22,0.035454545,30
3115.971363,57,87,0.78,30,0.026,30
3115.971363,55,90,0.9,35,0.025714286,30
3115.950645,61,76,0.43,15,0.028666667,30
3115.950645,60,77,0.49,17,0.028823529,30
3115.781201,61,81,0.56,20,0.028,30
3115.778796,59,88,0.72,29,0.024827586,30
3115.778796,58,89,0.77,31,0.02483871,30
3115.778796,57,90,0.82,33,0.024848485,30
3115.623564,67,98,0.59,31,0.019032258,30
3115.108018,55,74,0.63,19,0.033157895,30
3114.538987,58,85,0.76,27,0.028148148,30
3114.531229,62,84,0.55,22,0.025,30
3114.531229,61,85,0.6,24,0.025,30
3114.531229,60,86,0.65,26,0.025,30
3114.531229,59,87,0.7,28,0.025,30
3113.75222,55,86,0.89,31,0.028709677,30
3113.58425,53,93,0.99,40,0.02475,30
3113.062169,58,84,0.75,26,0.028846154,30
3112.569983,35,61,0.91,26,0.035,30
3112.504737,34,55,0.78,21,0.037142857,30
3111.755663,55,90,0.88,35,0.025142857,30
3111.739392,54,93,0.96,39,0.024615385,30
3111.648389,33,57,0.9,24,0.0375,30
3110.553379,56,88,0.92,32,0.02875,30
3110.41387,66,74,0.23,8,0.02875,30
3110.41387,63,78,0.43,15,0.028666667,30
3110.41387,60,81,0.6,21,0.028571429,30
3110.41387,59,82,0.66,23,0.028695652,30
3110.41387,58,84,0.74,26,0.028461538,30
3110.41387,57,85,0.8,28,0.028571429,30
3110.401081,57,85,0.73,28,0.026071429,30
3110.401081,55,88,0.85,33,0.025757576,30
3110.215073,55,93,0.94,38,0.024736842,30
3110.00998,67,99,0.6,32,0.01875,30
3109.901998,52,80,0.92,28,0.032857143,30
3109.654884,68,96,0.54,28,0.019285714,30
3109.635789,57,87,0.83,30,0.027666667,30
3109.635789,56,88,0.89,32,0.0278125,30
3109.490627,59,82,0.64,23,0.027826087,30
3109.490627,56,86,0.83,30,0.027666667,30
3109.283863,35,54,0.7,19,0.036842105,30
3108.906268,56,68,0.43,12,0.035833333,30
3108.70594,60,85,0.64,25,0.0256,30
3108.647406,35,58,0.87,23,0.037826087,30
3108.647406,34,59,0.95,25,0.038,30
3108.540132,43,44,0.04,1,0.04,30
3108.540132,42,45,0.12,3,0.04,30
3108.540132,41,46,0.2,5,0.04,30
3108.540132,40,47,0.28,7,0.04,30
3108.490346,55,69,0.5,14,0.035714286,30
3107.852046,32,58,0.99,26,0.038076923,30
3107.776805,34,56,0.85,22,0.038636364,30
3107.731782,56,88,0.86,32,0.026875,30
3107.689699,59,83,0.67,24,0.027916667,30
3107.114939,33,58,0.93,25,0.0372,30
3107.080389,59,84,0.68,25,0.0272,30
3107.080389,58,85,0.74,27,0.027407407,30
3106.824154,62,80,0.49,18,0.027222222,30
3106.501647,41,49,0.3,8,0.0375,30
3105.810774,69,97,0.51,28,0.018214286,30
3105.534676,37,54,0.62,17,0.036470588,30
3104.922671,57,86,0.81,29,0.027931034,30
3104.922671,56,87,0.87,31,0.028064516,30
3104.898505,70,93,0.45,23,0.019565217,30
3104.184089,61,77,0.47,16,0.029375,30
3104.184089,58,81,0.67,23,0.029130435,30
3103.334688,76,89,0.23,13,0.017692308,30
3102.764086,59,81,0.62,22,0.028181818,30
3102.746141,33,59,0.94,26,0.036153846,30
3102.553488,58,84,0.68,26,0.026153846,30
3102.553488,56,87,0.81,31,0.026129032,30
3102.548845,55,87,0.9,32,0.028125,30
3102.548845,54,88,0.96,34,0.028235294,30
3102.047797,15,19,0.05,4,0.0125,30
3101.932343,52,82,0.95,30,0.031666667,30
3101.742171,61,80,0.54,19,0.028421053,30
3101.742171,56,86,0.85,30,0.028333333,30
3101.742171,55,87,0.91,32,0.0284375,30
3101.742171,55,88,0.93,33,0.028181818,30
3101.742171,54,89,0.99,35,0.028285714,30
3101.277352,56,89,0.92,33,0.027878788,30
3101.238956,59,83,0.69,24,0.02875,30
3100.758954,56,87,0.88,31,0.028387097,30
3100.530291,34,61,0.99,27,0.036666667,30
3099.645354,53,91,0.99,38,0.026052632,30
3099.313573,80,84,0.07,4,0.0175,30
3099.313573,78,86,0.14,8,0.0175,30
3099.313573,75,90,0.26,15,0.017333333,30
3099.313573,70,96,0.45,26,0.017307692,30
3098.815377,48,63,0.47,15,0.031333333,30
3098.734866,55,90,0.97,35,0.027714286,30
3097.880836,33,56,0.87,23,0.037826087,30
3097.846114,36,55,0.72,19,0.037894737,30
3097.418804,77,87,0.18,10,0.018,30
3097.410602,58,87,0.75,29,0.025862069,30
3097.211116,52,89,0.98,37,0.026486486,30
3097.012646,54,89,0.92,35,0.026285714,30
3096.910625,54,74,0.69,20,0.0345,30
3096.835365,37,58,0.74,21,0.035238095,30
3096.670155,34,57,0.83,23,0.036086957,30
3096.612211,63,73,0.29,10,0.029,30
3095.972228,52,87,0.99,35,0.028285714,30
3095.836852,55,86,0.88,31,0.028387097,30
3095.641658,54,89,0.98,35,0.028,30
3095.546385,58,64,0.22,6,0.036666667,30
3095.424125,50,61,0.31,11,0.028181818,30
3094.94735,39,53,0.52,14,0.037142857,30
3094.875291,59,83,0.62,24,0.025833333,30
3094.703795,54,69,0.54,15,0.036,30
3093.785667,64,80,0.41,16,0.025625,30
3093.785667,60,84,0.62,24,0.025833333,30
3093.785667,59,86,0.69,27,0.025555556,30
3093.785667,58,87,0.74,29,0.025517241,30
3093.30164,52,84,0.93,32,0.0290625,30
3093.251923,34,53,0.72,19,0.037894737,30
3093.074282,36,58,0.8,22,0.036363636,30
3092.543457,58,78,0.59,20,0.0295,30
3092.543457,57,79,0.65,22,0.029545455,30
3092.203921,55,87,0.93,32,0.0290625,30
3092.203921,54,88,0.99,34,0.029117647,30
3092.117883,67,97,0.58,30,0.019333333,30
3092.074217,60,82,0.62,22,0.028181818,30
3091.977121,38,52,0.53,14,0.037857143,30
3091.709352,57,66,0.32,9,0.035555556,30
3091.367699,57,89,0.82,32,0.025625,30
3091.367699,55,92,0.94,37,0.025405405,30
3091.113237,58,84,0.67,26,0.025769231,30
3090.349842,33,58,0.92,25,0.0368,30
3090.318594,54,92,0.95,38,0.025,30
3090.268815,34,57,0.89,23,0.038695652,30
3090.267976,62,80,0.46,18,0.025555556,30
3089.624049,53,80,0.87,27,0.032222222,30
3089.431749,64,77,0.37,13,0.028461538,30
3089.431749,59,83,0.68,24,0.028333333,30
3089.415886,57,84,0.71,27,0.026296296,30
3089.415886,56,86,0.78,30,0.026,30
3089.385217,37,55,0.61,18,0.033888889,30
3089.272671,57,68,0.39,11,0.035454545,30
3089.272671,56,69,0.46,13,0.035384615,30
3088.935775,53,91,0.96,38,0.025263158,30
3088.851331,62,74,0.35,12,0.029166667,30
3088.834469,43,69,0.85,26,0.032692308,30
3088.717412,64,71,0.21,7,0.03,30
3088.717412,63,72,0.27,9,0.03,30
3088.717412,62,73,0.33,11,0.03,30
3088.717412,61,74,0.39,13,0.03,30
3088.362129,51,85,0.99,34,0.029117647,30
3088.358163,57,71,0.48,14,0.034285714,30
3088.319335,55,90,0.94,35,0.026857143,30
3088.123661,55,91,0.89,36,0.024722222,30
3088.104964,36,57,0.78,21,0.037142857,30
3088.104964,35,58,0.86,23,0.037391304,30
3088.104964,34,60,0.96,26,0.036923077,30
3088.058615,64,79,0.39,15,0.026,30
3087.687871,67,76,0.23,9,0.025555556,30
3087.528366,59,83,0.7,24,0.029166667,30
3087.271875,35,60,0.89,25,0.0356,30
3087.009099,54,89,0.91,35,0.026,30
3086.711373,38,54,0.59,16,0.036875,30
3086.469211,74,90,0.31,16,0.019375,30
3086.227862,67,99,0.56,32,0.0175,30
3085.857151,66,76,0.28,10,0.028,30
3085.709575,55,89,0.97,34,0.028529412,30
3085.577382,41,52,0.41,11,0.037272727,30
3085.444817,73,91,0.32,18,0.017777778,30
3085.343658,47,50,0.11,3,0.036666667,30
3085.228228,44,68,0.75,24,0.03125,30
3084.677243,34,61,0.98,27,0.036296296,30
3084.281884,64,80,0.42,16,0.02625,30
3083.918704,61,75,0.41,14,0.029285714,30
3083.853068,64,81,0.45,17,0.026470588,30
3083.642033,39,54,0.56,15,0.037333333,30
3083.604285,60,76,0.47,16,0.029375,30
3083.604285,59,77,0.53,18,0.029444444,30
3083.441463,39,52,0.44,13,0.033846154,30
3083.440722,41,58,0.6,17,0.035294118,30
3083.02945,56,81,0.72,25,0.0288,30
3083.006234,49,81,0.99,32,0.0309375,30
3082.865075,65,73,0.23,8,0.02875,30
3082.677973,38,55,0.61,17,0.035882353,30
3081.810635,56,88,0.87,32,0.0271875,30
3081.564379,42,51,0.33,9,0.036666667,30
3081.391855,36,57,0.77,21,0.036666667,30
3081.071017,72,91,0.37,19,0.019473684,30
3081.028953,36,52,0.64,16,0.04,30
3080.790839,52,77,0.86,25,0.0344,30
3080.773174,67,98,0.54,31,0.017419355,30
3080.126992,57,80,0.66,23,0.028695652,30
3079.244991,52,79,0.9,27,0.033333333,30
3079.210725,60,82,0.63,22,0.028636364,30
3078.928173,62,83,0.56,21,0.026666667,30
3078.662964,37,53,0.61,16,0.038125,30
3078.62352,81,84,0.05,3,0.016666667,30
3078.347634,48,61,0.42,13,0.032307692,30
3078.314226,58,77,0.54,19,0.028421053,30
3078.213706,66,99,0.64,33,0.019393939,30
3078.204117,34,61,0.97,27,0.035925926,30
3078.072855,71,93,0.42,22,0.019090909,30
3077.971351,37,57,0.72,20,0.036,30
3077.776325,70,95,0.48,25,0.0192,30
3077.776325,69,96,0.52,27,0.019259259,30
3077.70444,67,98,0.6,31,0.019354839,30
3077.248039,57,89,0.81,32,0.0253125,30
3077.202716,43,70,0.83,27,0.030740741,30
3077.048048,56,80,0.71,24,0.029583333,30
3077.048048,55,81,0.77,26,0.029615385,30
3076.938758,69,98,0.49,29,0.016896552,30
3076.860385,33,59,0.97,26,0.037307692,30
3076.666594,70,95,0.44,25,0.0176,30
3076.107055,75,88,0.25,13,0.019230769,30
3075.797318,46,51,0.18,5,0.036,30
3075.676367,74,89,0.33,15,0.022,30
3075.614437,69,96,0.51,27,0.018888889,30
3075.177264,54,88,0.88,34,0.025882353,30
3074.80903,41,72,0.99,31,0.031935484,30
3074.778291,73,93,0.33,20,0.0165,30
3074.773996,74,89,0.29,15,0.019333333,30
3074.773996,70,94,0.46,24,0.019166667,30
3074.773996,69,95,0.5,26,0.019230769,30
3074.399182,60,82,0.57,22,0.025909091,30
3074.17939,57,85,0.78,28,0.027857143,30
3074.117121,65,72,0.2,7,0.028571429,30
3073.935596,55,80,0.74,25,0.0296,30
3073.892192,75,89,0.26,14,0.018571429,30
3073.752542,33,59,0.93,26,0.035769231,30
3073.743634,69,97,0.53,28,0.018928571,30
3073.605031,45,66,0.66,21,0.031428571,30
3073.442937,33,57,0.89,24,0.037083333,30
3073.240573,60,75,0.45,15,0.03,30
3073.240573,59,76,0.51,17,0.03,30
3073.240573,58,77,0.57,19,0.03,30
3072.833235,69,94,0.57,25,0.0228,30
3072.833235,68,95,0.62,27,0.022962963,30
3072.833235,65,99,0.77,34,0.022647059,30
3072.340825,35,58,0.85,23,0.036956522,30
3072.126236,33,60,0.96,27,0.035555556,30
3072.06996,34,60,0.94,26,0.036153846,30
3072.063484,37,56,0.7,19,0.036842105,30
3071.750979,56,90,0.87,34,0.025588235,30
3071.730038,44,54,0.36,10,0.036,30
3071.630153,38,52,0.54,14,0.038571429,30
3071.537216,64,79,0.4,15,0.026666667,30
3070.476451,55,89,0.88,34,0.025882353,30
3070.383864,53,87,0.91,34,0.026764706,30
3070.10242,56,89,0.89,33,0.026969697,30
3069.985064,36,56,0.68,20,0.034,30
3069.985064,34,59,0.84,25,0.0336,30
3069.843654,59,87,0.74,28,0.026428571,30
3069.80602,34,61,0.95,27,0.035185185,30
3069.642525,43,64,0.7,21,0.033333333,30
3069.246755,53,85,0.91,32,0.0284375,30
3069.246755,52,87,0.98,35,0.028,30
3068.974766,58,83,0.66,25,0.0264,30
3068.762278,35,57,0.79,22,0.035909091,30
3068.489716,73,91,0.35,18,0.019444444,30
3068.094547,35,56,0.81,21,0.038571429,30
3068.09089,55,88,0.84,33,0.025454545,30
3068.09089,54,89,0.89,35,0.025428571,30
3067.849423,40,70,0.95,30,0.031666667,30
3066.89898,57,87,0.82,30,0.027333333,30
3065.821409,34,60,0.97,26,0.037307692,30
3065.780759,37,56,0.69,19,0.036315789,30
3065.657454,37,57,0.73,20,0.0365,30
3065.416584,38,56,0.66,18,0.036666667,30
3065.391715,44,53,0.33,9,0.036666667,30
3065.127157,68,99,0.53,31,0.017096774,30
3065.015043,57,88,0.82,31,0.026451613,30
3065.015043,56,90,0.89,34,0.026176471,30
3064.574162,43,69,0.81,26,0.031153846,30
3064.444999,36,54,0.68,18,0.037777778,30
3064.197213,71,92,0.41,21,0.01952381,30
3063.77309,77,86,0.17,9,0.018888889,30
3063.04158,70,96,0.49,26,0.018846154,30
3062.822427,67,75,0.21,8,0.02625,30
3062.811581,59,87,0.71,28,0.025357143,30
3062.728892,40,46,0.23,6,0.038333333,30
3062.543638,32,56,0.97,24,0.040416667,30
3062.512304,56,83,0.78,27,0.028888889,30
3062.512304,56,84,0.8,28,0.028571429,30
3062.512304,55,85,0.86,30,0.028666667,30
3062.380363,72,91,0.42,19,0.022105263,30
3062.380363,67,97,0.66,30,0.022,30
3062.197002,39,55,0.58,16,0.03625,30
3061.933656,73,90,0.33,17,0.019411765,30
3061.497819,38,54,0.61,16,0.038125,30
3061.18077,34,58,0.88,24,0.036666667,30
3061.166289,35,56,0.79,21,0.037619048,30
3061.046616,44,48,0.15,4,0.0375,30
3061.046616,42,50,0.3,8,0.0375,30
3061.00606,34,57,0.88,23,0.03826087,30
3060.889654,56,86,0.84,30,0.028,30
3060.84572,54,84,0.83,30,0.027666667,30
3060.626957,38,49,0.42,11,0.038181818,30
3060.07978,58,88,0.76,30,0.025333333,30
3060.07978,55,92,0.93,37,0.025135135,30
3060.076224,56,67,0.39,11,0.035454545,30
3060.042565,33,58,0.9,25,0.036,30
3059.964017,56,82,0.71,26,0.027307692,30
3058.667726,57,88,0.78,31,0.02516129,30
3058.426132,33,58,0.91,25,0.0364,30
3057.835709,54,81,0.8,27,0.02962963,30
3057.672989,67,98,0.55,31,0.017741935,30
3057.071129,55,88,0.95,33,0.028787879,30
3056.709627,66,98,0.71,32,0.0221875,30
3056.543125,72,93,0.39,21,0.018571429,30
3056.541996,37,53,0.62,16,0.03875,30
3056.541996,36,54,0.7,18,0.038888889,30
3056.378665,38,55,0.62,17,0.036470588,30
3056.378665,35,59,0.87,24,0.03625,30
3056.247649,33,55,0.83,22,0.037727273,30
3056.19899,54,93,0.97,39,0.024871795,30
3056.028431,64,78,0.39,14,0.027857143,30
3055.553658,54,87,0.87,33,0.026363636,30
3055.497093,37,57,0.74,20,0.037,30
3055.132861,35,56,0.8,21,0.038095238,30
3055.132861,33,59,0.98,26,0.037692308,30
3055.057785,53,87,0.93,34,0.027352941,30
3055.046872,35,55,0.76,20,0.038,30
3054.854204,57,82,0.69,25,0.0276,30
3054.664463,52,89,0.99,37,0.026756757,30
3054.297614,55,83,0.77,28,0.0275,30
3054.279437,58,86,0.71,28,0.025357143,30
3054.256282,64,74,0.28,10,0.028,30
3054.125968,56,85,0.77,29,0.026551724,30
3054.125968,54,87,0.88,33,0.026666667,30
3053.81562,34,60,0.95,26,0.036538462,30
3053.639726,55,90,0.95,35,0.027142857,30
3053.560792,64,81,0.43,17,0.025294118,30
3053.268608,41,47,0.22,6,0.036666667,30
3053.147331,68,97,0.54,29,0.01862069,30
3052.750482,39,54,0.55,15,0.036666667,30
3052.480595,57,78,0.6,21,0.028571429,30
3052.399902,42,71,0.89,29,0.030689655,30
3052.177766,38,57,0.62,19,0.032631579,30
3051.466411,54,85,0.86,31,0.027741935,30
3051.302394,52,88,0.99,36,0.0275,30
3051.086915,67,75,0.22,8,0.0275,30
3051.023415,55,88,0.96,33,0.029090909,30
3051.009643,51,85,0.98,34,0.028823529,30
3050.586342,79,84,0.09,5,0.018,30
3050.567805,61,75,0.43,14,0.030714286,30
3050.35634,47,64,0.54,17,0.031764706,30
3050.313937,62,80,0.51,18,0.028333333,30
3050.292382,77,87,0.19,10,0.019,30
3050.096991,63,80,0.45,17,0.026470588,30
3050.096991,60,84,0.63,24,0.02625,30
3050.09118,36,55,0.71,19,0.037368421,30
3049.240505,41,67,0.86,26,0.033076923,30
3049.17784,53,88,0.93,35,0.026571429,30
3048.668912,54,88,0.9,34,0.026470588,30
3048.463657,56,91,0.89,35,0.025428571,30
3048.366643,58,79,0.64,21,0.03047619,30
3048.366643,57,80,0.7,23,0.030434783,30
3048.357783,43,55,0.43,12,0.035833333,30
3048.268305,55,87,0.84,32,0.02625,30
3048.268305,53,89,0.95,36,0.026388889,30
3048.265657,73,91,0.34,18,0.018888889,30
3048.265657,72,92,0.38,20,0.019,30
3047.995852,69,96,0.48,27,0.017777778,30
3047.816838,36,50,0.54,14,0.038571429,30
3047.595784,66,77,0.3,11,0.027272727,30
3047.595784,64,79,0.41,15,0.027333333,30
3047.191504,37,50,0.49,13,0.037692308,30
3047.181814,64,78,0.38,14,0.027142857,30
3047.052187,56,81,0.76,25,0.0304,30
3047.043532,56,93,0.9,37,0.024324324,30
3046.962048,72,93,0.37,21,0.017619048,30
3046.805466,74,91,0.3,17,0.017647059,30
3046.729981,34,59,0.94,25,0.0376,30
3046.564919,56,79,0.66,23,0.028695652,30
3045.827495,46,64,0.58,18,0.032222222,30
3045.464745,75,89,0.27,14,0.019285714,30
3045.392669,68,96,0.61,28,0.021785714,30
3045.136184,67,98,0.58,31,0.018709677,30
3045.117014,65,79,0.36,14,0.025714286,30
3044.990925,47,64,0.53,17,0.031176471,30
3044.824235,54,90,0.98,36,0.027222222,30
3044.788194,41,57,0.58,16,0.03625,30
3044.707689,71,94,0.39,23,0.016956522,30
3044.139472,35,55,0.77,20,0.0385,30
3044.139472,33,58,0.96,25,0.0384,30
3044.107283,69,96,0.5,27,0.018518519,30
3044.03552,56,87,0.79,31,0.025483871,30
3043.87295,46,72,0.69,26,0.026538462,30
3043.770429,36,55,0.7,19,0.036842105,30
3043.642054,66,98,0.72,32,0.0225,30
3043.333375,70,94,0.52,24,0.021666667,30
3043.262631,45,67,0.69,22,0.031363636,30
3043.168173,54,90,0.94,36,0.026111111,30
3043.089292,41,52,0.4,11,0.036363636,30
3043.021128,58,79,0.58,21,0.027619048,30
3042.821384,53,90,0.97,37,0.026216216,30
3042.613121,73,92,0.35,19,0.018421053,30
3042.416549,53,90,0.98,37,0.026486486,30
3042.204947,35,51,0.62,16,0.03875,30
3041.686847,75,89,0.25,14,0.017857143,30
3041.646339,55,88,0.91,33,0.027575758,30
3041.554432,56,83,0.75,27,0.027777778,30
3041.554432,55,84,0.81,29,0.027931034,30
3041.554432,54,85,0.87,31,0.028064516,30
3041.554432,53,86,0.92,33,0.027878788,30
3041.554432,53,86,0.93,33,0.028181818,30
3040.747703,60,86,0.67,26,0.025769231,30
3040.747703,56,91,0.9,35,0.025714286,30
3040.687486,42,65,0.77,23,0.033478261,30
3040.488612,74,90,0.3,16,0.01875,30
3040.39651,77,88,0.19,11,0.017272727,30
3040.39446,69,95,0.49,26,0.018846154,30
3039.905955,69,97,0.49,28,0.0175,30
3039.58183,39,55,0.57,16,0.035625,30
3039.543671,66,77,0.29,11,0.026363636,30
3039.543671,63,81,0.47,18,0.026111111,30
3039.477235,69,74,0.13,5,0.026,30
3039.477235,65,78,0.34,13,0.026153846,30
3039.467305,54,85,0.84,31,0.027096774,30
3039.375663,69,76,0.18,7,0.025714286,30
3039.375663,64,81,0.44,17,0.025882353,30
3038.884809,36,56,0.76,20,0.038,30
3038.818846,35,52,0.64,17,0.037647059,30
3038.717766,57,60,0.08,3,0.026666667,30
3038.637875,55,91,0.9,36,0.025,30
3038.637875,54,92,0.96,38,0.025263158,30
3038.635768,33,57,0.88,24,0.036666667,30
3038.635768,32,58,0.96,26,0.036923077,30
3038.454288,69,73,0.11,4,0.0275,30
3038.127478,71,95,0.42,24,0.0175,30
3038.118657,35,57,0.75,22,0.034090909,30
3038.092575,36,58,0.79,22,0.035909091,30
3037.799827,68,98,0.55,30,0.018333333,30
3037.346756,54,79,0.8,25,0.032,30
3037.346756,52,81,0.93,29,0.032068966,30
3037.346756,51,81,0.98,30,0.032666667,30
3036.694727,58,88,0.78,30,0.026,30
3036.694727,55,92,0.96,37,0.025945946,30
3036.687211,41,68,0.86,27,0.031851852,30
3036.641043,39,53,0.53,14,0.037857143,30
3036.591234,37,56,0.71,19,0.037368421,30
3035.537977,35,59,0.88,24,0.036666667,30
3034.925413,66,99,0.61,33,0.018484848,30
3034.718317,58,80,0.6,22,0.027272727,30
3034.703556,52,88,0.97,36,0.026944444,30
3034.63548,62,81,0.52,19,0.027368421,30
3034.63548,62,82,0.54,20,0.027,30
3034.63548,60,84,0.65,24,0.027083333,30
3034.595714,68,96,0.53,28,0.018928571,30
3034.579997,58,78,0.56,20,0.028,30
3034.433591,54,83,0.81,29,0.027931034,30
3034.416858,55,82,0.75,27,0.027777778,30
3034.397943,34,58,0.89,24,0.037083333,30
3033.911023,59,82,0.61,23,0.026521739,30
3033.911023,57,84,0.72,27,0.026666667,30
3033.862316,78,87,0.15,9,0.016666667,30
3033.862316,71,95,0.4,24,0.016666667,30
3033.862316,69,97,0.47,28,0.016785714,30
3033.862316,69,98,0.48,29,0.016551724,30
3033.389286,39,51,0.46,12,0.038333333,30
3033.369165,38,53,0.51,15,0.034,30
3033.342659,67,97,0.65,30,0.021666667,30
3032.940093,37,57,0.75,20,0.0375,30
3032.74053,62,80,0.52,18,0.028888889,30
3032.703292,67,77,0.21,10,0.021,30
3032.676821,60,85,0.65,25,0.026,30
3032.051275,77,87,0.17,10,0.017,30
3032.023928,36,58,0.81,22,0.036818182,30
3031.845164,53,86,0.9,33,0.027272727,30
3031.803625,57,90,0.83,33,0.025151515,30
3031.803625,56,91,0.88,35,0.025142857,30
3031.803625,55,93,0.95,38,0.025,30
3031.739708,64,72,0.23,8,0.02875,30
3031.592554,61,84,0.6,23,0.026086957,30
3031.345508,66,99,0.62,33,0.018787879,30
3031.276184,49,64,0.38,15,0.025333333,30
3031.253471,70,94,0.43,24,0.017916667,30
3030.934833,67,97,0.68,30,0.022666667,30
3030.869437,57,90,0.85,33,0.025757576,30
3030.722668,53,69,0.58,16,0.03625,30
3030.476459,44,63,0.62,19,0.032631579,30
3030.319952,76,87,0.21,11,0.019090909,30
3030.172785,66,99,0.71,33,0.021515152,30
3029.99768,55,77,0.72,22,0.032727273,30
3029.946107,63,74,0.31,11,0.028181818,30
3029.827674,67,99,0.59,32,0.0184375,30
3029.709405,55,85,0.82,30,0.027333333,30
3029.646147,73,92,0.32,19,0.016842105,30
3028.492813,56,87,0.86,31,0.027741935,30
3028.492813,55,88,0.92,33,0.027878788,30
3028.492813,54,89,0.97,35,0.027714286,30
3028.492813,54,90,0.99,36,0.0275,30
3028.488942,55,86,0.83,31,0.026774194,30
3028.291338,59,81,0.59,22,0.026818182,30
3028.291338,57,83,0.7,26,0.026923077,30
3028.268532,41,68,0.87,27,0.032222222,30
3028.266617,49,62,0.41,13,0.031538462,30
3028.090902,56,86,0.79,30,0.026333333,30
3027.924795,66,78,0.31,12,0.025833333,30
3027.441298,63,83,0.5,20,0.025,30
3027.333901,49,74,0.91,25,0.0364,30
3026.958522,53,89,0.96,36,0.026666667,30
3026.905613,68,75,0.19,7,0.027142857,30
3026.618788,55,87,0.89,32,0.0278125,30
3026.426657,52,87,0.96,35,0.027428571,30
3026.203195,73,89,0.37,16,0.023125,30
3026.161258,69,74,0.14,5,0.028,30
3025.94402,61,83,0.58,22,0.026363636,30
3025.94402,59,85,0.69,26,0.026538462,30
3025.904347,65,78,0.33,13,0.025384615,30
3025.841183,68,96,0.52,28,0.018571429,30
3025.755483,55,68,0.48,13,0.036923077,30
3025.338919,38,56,0.65,18,0.036111111,30
3025.16235,37,54,0.63,17,0.037058824,30
3024.937772,43,48,0.19,5,0.038,30
3024.899922,47,63,0.51,16,0.031875,30
3024.866729,66,71,0.14,5,0.028,30
3024.809274,41,68,0.88,27,0.032592593,30
3024.052867,62,74,0.37,12,0.030833333,30
3023.982983,74,89,0.28,15,0.018666667,30
3023.818179,49,61,0.38,12,0.031666667,30
3023.813056,59,78,0.58,19,0.030526316,30
3023.4901,53,82,0.9,29,0.031034483,30
3023.484132,57,85,0.72,28,0.025714286,30
3023.484132,56,86,0.77,30,0.025666667,30
3023.459289,54,88,0.95,34,0.027941176,30
3023.400543,71,95,0.45,24,0.01875,30
3023.284347,45,66,0.67,21,0.031904762,30
3023.197431,52,71,0.69,19,0.036315789,30
3023.173344,82,88,0.1,6,0.016666667,30
3022.920279,71,93,0.43,22,0.019545455,30
3022.731471,36,49,0.54,13,0.041538462,30
3022.677273,70,95,0.47,25,0.0188,30
3022.340027,40,69,0.94,29,0.032413793,30
3022.194661,72,90,0.42,18,0.023333333,30
3022.181861,59,86,0.7,27,0.025925926,30
3022.162508,51,72,0.76,21,0.036190476,30
3022.014538,72,92,0.36,20,0.018,30
3021.887456,56,79,0.68,23,0.029565217,30
3021.876151,56,80,0.7,24,0.029166667,30
3021.876151,55,81,0.76,26,0.029230769,30
3021.798253,47,59,0.4,12,0.033333333,30
3021.532491,37,55,0.68,18,0.037777778,30
3021.442405,68,96,0.63,28,0.0225,30
3021.425444,42,66,0.78,24,0.0325,30
3021.284348,69,98,0.54,29,0.01862069,30
3021.167874,61,84,0.48,23,0.020869565,30
3021.113658,57,86,0.8,29,0.027586207,30
3020.991974,63,78,0.39,15,0.026,30
3020.757604,71,94,0.43,23,0.018695652,30
3020.619995,69,95,0.57,26,0.021923077,30
3020.536582,56,67,0.4,11,0.036363636,30
3020.344904,43,65,0.71,22,0.032272727,30
3020.117392,52,84,0.92,32,0.02875,30
3020.101814,60,77,0.48,17,0.028235294,30
3020.085309,72,91,0.36,19,0.018947368,30
3019.742423,57,79,0.62,22,0.028181818,30
3019.64474,40,53,0.48,13,0.036923077,30
3019.431334,67,77,0.27,10,0.027,30
3019.347376,72,92,0.37,20,0.0185,30
3019.347376,71,94,0.42,23,0.01826087,30
3019.347376,70,95,0.46,25,0.0184,30
3019.173565,61,84,0.62,23,0.026956522,30
3018.972663,34,57,0.85,23,0.036956522,30
3018.861698,52,71,0.68,19,0.035789474,30
3018.465601,56,90,0.88,34,0.025882353,30
3018.303547,55,85,0.81,30,0.027,30
3018.186462,61,81,0.58,20,0.029,30
3018.137365,52,84,0.97,32,0.0303125,30
3017.893905,53,83,0.88,30,0.029333333,30
3017.893905,52,84,0.94,32,0.029375,30
3017.873149,68,97,0.56,29,0.019310345,30
3017.817233,62,82,0.52,20,0.026,30
3017.807487,63,81,0.48,18,0.026666667,30
3017.807487,58,87,0.77,29,0.026551724,30
3017.657766,46,67,0.6,21,0.028571429,30
3017.534371,46,60,0.47,14,0.033571429,30
3017.51862,35,55,0.78,20,0.039,30
3017.466726,73,92,0.36,19,0.018947368,30
3017.289148,67,97,0.57,30,0.019,30
3016.936245,76,87,0.2,11,0.018181818,30
3016.564079,49,60,0.35,11,0.031818182,30
3016.410548,56,79,0.67,23,0.029130435,30
3016.279098,65,79,0.38,14,0.027142857,30
3016.279098,63,81,0.49,18,0.027222222,30
3015.87075,66,79,0.34,13,0.026153846,30
3015.87075,60,86,0.68,26,0.026153846,30
3015.761728,44,49,0.18,5,0.036,30
3015.721664,76,88,0.23,12,0.019166667,30
3015.36745,59,79,0.56,20,0.028,30
3015.328299,42,72,0.95,30,0.031666667,30
3015.231741,38,55,0.63,17,0.037058824,30
3015.199955,40,68,0.92,28,0.032857143,30
3015.06172,53,83,0.85,30,0.028333333,30
3014.788618,35,57,0.85,22,0.038636364,30
3014.567649,56,62,0.16,6,0.026666667,30
3014.441379,58,87,0.76,29,0.026206897,30
3014.363832,62,76,0.39,14,0.027857143,30
3014.18315,66,76,0.27,10,0.027,30
3013.707936,74,88,0.32,14,0.022857143,30
3013.650244,42,58,0.55,16,0.034375,30
3013.636905,39,49,0.4,10,0.04,30
3013.448406,33,56,0.85,23,0.036956522,30
3013.404856,53,84,0.87,31,0.028064516,30
3013.404856,52,85,0.93,33,0.028181818,30
3013.404856,51,86,0.99,35,0.028285714,30
3013.393582,53,85,0.89,32,0.0278125,30
3013.236084,40,50,0.38,10,0.038,30
3013.053936,69,95,0.48,26,0.018461538,30
3013.050104,73,93,0.34,20,0.017,30
3012.984753,55,91,0.95,36,0.026388889,30
3012.462717,56,66,0.36,10,0.036,30
3012.180671,32,56,0.98,24,0.040833333,30
3012.151069,70,94,0.45,24,0.01875,30
3011.924756,61,84,0.59,23,0.025652174,30
3011.886729,60,78,0.5,18,0.027777778,30
3011.845861,44,69,0.77,25,0.0308,30
3011.573785,45,65,0.64,20,0.032,30
3011.442731,63,80,0.46,17,0.027058824,30
3011.442731,61,82,0.57,21,0.027142857,30
3011.273313,67,96,0.67,29,0.023103448,30
3011.237888,66,78,0.32,12,0.026666667,30
3010.817247,50,62,0.34,12,0.028333333,30
3010.701471,70,93,0.51,23,0.022173913,30
3010.595817,68,99,0.58,31,0.018709677,30
3010.475278,35,51,0.65,16,0.040625,30
3010.452035,45,61,0.54,16,0.03375,30
3010.140744,40,51,0.42,11,0.038181818,30
3010.140744,39,52,0.5,13,0.038461538,30
3010.032161,75,91,0.29,16,0.018125,30
3009.960737,42,55,0.48,13,0.036923077,30
3009.670893,53,87,0.95,34,0.027941176,30
3009.485206,45,62,0.57,17,0.033529412,30
3009.362881,36,55,0.65,19,0.034210526,30
3009.296217,39,69,0.99,30,0.033,30
3009.009837,55,84,0.78,29,0.026896552,30
3008.96696,45,62,0.56,17,0.032941176,30
3008.7229,48,75,0.99,27,0.036666667,30
3008.657417,57,89,0.83,32,0.0259375,30
3008.641244,55,91,0.98,36,0.027222222,30
3008.486794,40,68,0.91,28,0.0325,30
3008.486794,39,69,0.98,30,0.032666667,30
3008.109692,67,75,0.23,8,0.02875,30
3008.109692,63,79,0.46,16,0.02875,30
3008.109692,61,82,0.6,21,0.028571429,30
3008.093206,59,84,0.64,25,0.0256,30
3007.993857,36,55,0.73,19,0.038421053,30
3007.951744,73,90,0.32,17,0.018823529,30
3007.905597,43,70,0.86,27,0.031851852,30
3007.640401,34,57,0.84,23,0.036521739,30
3007.58299,57,66,0.33,9,0.036666667,30
3007.58299,54,69,0.55,15,0.036666667,30
3007.475858,55,67,0.44,12,0.036666667,30
3007.056318,52,85,0.97,33,0.029393939,30
3007.041903,39,48,0.37,9,0.041111111,30
3006.999853,71,92,0.46,21,0.021904762,30
3006.917694,55,87,0.85,32,0.0265625,30
3006.630642,50,74,0.88,24,0.036666667,30
3006.473749,34,54,0.75,20,0.0375,30
3006.441581,73,92,0.34,19,0.017894737,30
3006.441581,70,95,0.45,25,0.018,30
3006.425316,60,85,0.67,25,0.0268,30
3006.312829,67,71,0.11,4,0.0275,30
3006.312829,65,73,0.22,8,0.0275,30
3006.312829,63,75,0.33,12,0.0275,30
3006.276362,36,58,0.82,22,0.037272727,30
3006.237486,34,61,0.96,27,0.035555556,30
3006.078805,42,71,0.93,29,0.032068966,30
3006.040337,54,82,0.82,28,0.029285714,30
3005.824809,34,57,0.86,23,0.037391304,30
3005.769734,38,53,0.58,15,0.038666667,30
3005.662092,59,76,0.48,17,0.028235294,30
3005.505108,65,80,0.38,15,0.025333333,30
3005.297835,42,57,0.53,15,0.035333333,30
3005.274188,53,83,0.89,30,0.029666667,30
3004.995796,71,93,0.41,22,0.018636364,30
3004.893974,56,77,0.67,21,0.031904762,30
3004.811776,68,99,0.57,31,0.018387097,30
3004.697364,64,79,0.42,15,0.028,30
3004.681401,46,61,0.5,15,0.033333333,30
3004.267736,70,93,0.52,23,0.022608696,30
3004.109608,44,70,0.71,26,0.027307692,30
3004.073974,52,84,0.95,32,0.0296875,30
3003.872753,55,82,0.83,27,0.030740741,30
3003.85663,66,99,0.72,33,0.021818182,30
3003.85475,42,69,0.86,27,0.031851852,30
3003.833621,42,56,0.51,14,0.036428571,30
3003.63198,53,85,0.97,32,0.0303125,30
3003.355279,57,80,0.64,23,0.027826087,30
3003.242352,33,55,0.84,22,0.038181818,30
3003.205579,44,63,0.64,19,0.033684211,30
3003.062761,52,84,0.99,32,0.0309375,30
3002.553938,71,92,0.48,21,0.022857143,30
3002.48211,68,97,0.53,29,0.018275862,30
3002.48211,68,98,0.54,30,0.018,30
3002.48211,67,99,0.58,32,0.018125,30
3002.102197,53,90,0.94,37,0.025405405,30
3001.704215,54,84,0.91,30,0.030333333,30
3001.346413,58,82,0.65,24,0.027083333,30
3001.346413,56,84,0.76,28,0.027142857,30
3001.346413,56,85,0.78,29,0.026896552,30
3001.346413,55,86,0.84,31,0.027096774,30
3001.346413,54,87,0.89,33,0.026969697,30
3001.346413,54,88,0.91,34,0.026764706,30
3001.32731,53,84,0.9,31,0.029032258,30
3001.32731,52,85,0.96,33,0.029090909,30
3001.286752,40,49,0.32,9,0.035555556,30
3001.234753,58,80,0.62,22,0.028181818,30
3000.931405,65,99,0.76,34,0.022352941,30
3000.923713,66,77,0.31,11,0.028181818,30
3000.876989,51,60,0.26,9,0.028888889,30
3000.637796,72,93,0.38,21,0.018095238,30
3000.637796,69,96,0.49,27,0.018148148,30
3000.591213,60,81,0.55,21,0.026190476,30
3000.568379,78,86,0.15,8,0.01875,30
3000.552204,41,66,0.82,25,0.0328,30
3000.112463,52,59,0.2,7,0.028571429,30
3000.03304,44,62,0.61,18,0.033888889,30
3000.019278,32,58,0.98,26,0.037692308,30
2999.832113,65,78,0.35,13,0.026923077,30
2999.832113,61,83,0.59,22,0.026818182,30
2999.607545,68,77,0.23,9,0.025555556,30
2999.588677,61,77,0.43,16,0.026875,30
2999.588677,59,79,0.54,20,0.027,30
2999.478001,76,86,0.23,10,0.023,30
2998.814035,68,74,0.16,6,0.026666667,30
2998.797007,53,71,0.65,18,0.036111111,30
2998.775286,44,63,0.63,19,0.033157895,30
2998.775286,43,65,0.72,22,0.032727273,30
2998.765014,69,75,0.16,6,0.026666667,30
2998.765014,64,80,0.43,16,0.026875,30
2998.75179,62,75,0.39,13,0.03,30
2998.481414,63,79,0.41,16,0.025625,30
2998.23017,72,92,0.39,20,0.0195,30
2998.205614,36,51,0.57,15,0.038,30
2998.147306,56,81,0.7,25,0.028,30
2997.955568,41,67,0.84,26,0.032307692,30
2997.849733,81,85,0.07,4,0.0175,30
2997.702587,46,61,0.49,15,0.032666667,30
2997.57667,67,69,0.06,2,0.03,30
2997.57667,66,70,0.12,4,0.03,30
2997.57667,65,71,0.18,6,0.03,30
2997.57667,64,72,0.24,8,0.03,30
2997.57667,63,73,0.3,10,0.03,30
2997.57667,62,74,0.36,12,0.03,30
2997.397657,41,50,0.34,9,0.037777778,30
2997.123962,67,99,0.57,32,0.0178125,30
2996.890246,48,64,0.46,16,0.02875,30
2996.889886,64,80,0.45,16,0.028125,30
2996.708458,41,69,0.88,28,0.031428571,30
2996.637819,40,53,0.47,13,0.036153846,30
2996.471126,53,70,0.62,17,0.036470588,30
2996.403124,37,53,0.56,16,0.035,30
2996.149522,55,83,0.84,28,0.03,30
2996.149522,54,84,0.9,30,0.03,30
2996.149522,53,86,0.98,33,0.02969697,30
2995.974619,47,66,0.53,19,0.027894737,30
2995.896522,40,58,0.66,18,0.036666667,30
2995.862516,67,98,0.57,31,0.018387097,30
2995.576219,54,63,0.24,9,0.026666667,30
2995.486659,58,85,0.78,27,0.028888889,30
2995.486659,57,86,0.84,29,0.028965517,30
2995.454507,38,50,0.48,12,0.04,30
2995.198273,58,86,0.76,28,0.027142857,30
2995.187546,42,66,0.79,24,0.032916667,30
2995.037185,59,85,0.7,26,0.026923077,30
2995.037185,57,88,0.83,31,0.026774194,30
2994.896329,60,79,0.52,19,0.027368421,30
2994.244813,67,77,0.26,10,0.026,30
2994.244813,63,82,0.49,19,0.025789474,30
2994.244813,62,84,0.56,22,0.025454545,30
2994.244813,59,87,0.72,28,0.025714286,30
2993.880033,74,99,0.42,25,0.0168,30
2993.611613,43,62,0.66,19,0.034736842,30
2993.162627,70,96,0.46,26,0.017692308,30
2993.113696,56,82,0.79,26,0.030384615,30
2992.970349,55,80,0.73,25,0.0292,30
2992.936917,60,83,0.62,23,0.026956522,30
2992.874662,47,67,0.5,20,0.025,30
2992.708934,50,57,0.23,7,0.032857143,30
2992.682428,40,70,0.96,30,0.032,30
2992.67982,69,97,0.5,28,0.017857143,30
2992.482643,37,51,0.56,14,0.04,30
2992.364777,38,56,0.67,18,0.037222222,30
2992.288604,59,84,0.71,25,0.0284,30
2992.093687,63,79,0.45,16,0.028125,30
2992.091997,74,91,0.31,17,0.018235294,30
2991.926418,52,86,0.95,34,0.027941176,30
2991.914621,61,75,0.39,14,0.027857143,30
2991.719674,72,91,0.43,19,0.022631579,30
2991.626098,72,94,0.37,22,0.016818182,30
2991.626098,68,99,0.52,31,0.016774194,30
2991.625224,67,98,0.56,31,0.018064516,30
2991.382222,42,69,0.85,27,0.031481481,30
2991.374154,54,84,0.84,30,0.028,30
2991.192826,40,67,0.9,27,0.033333333,30
2991.192826,39,68,0.97,29,0.033448276,30
2990.952675,55,83,0.85,28,0.030357143,30
2990.668411,34,53,0.78,19,0.041052632,30
2990.561806,55,92,0.95,37,0.025675676,30
2990.450668,50,73,0.84,23,0.036521739,30
2990.054214,35,54,0.76,19,0.04,30
2989.90958,61,84,0.61,23,0.026521739,30
2989.613401,76,89,0.22,13,0.016923077,30
2989.424602,67,78,0.28,11,0.025454545,30
2989.424602,66,79,0.33,13,0.025384615,30
2989.417617,39,67,0.94,28,0.033571429,30
2989.390453,62,81,0.5,19,0.026315789,30
2989.318319,43,64,0.68,21,0.032380952,30
2989.318319,42,65,0.75,23,0.032608696,30
2988.988705,38,47,0.37,9,0.041111111,30
2988.625583,33,55,0.88,22,0.04,30
2988.507773,61,76,0.41,15,0.027333333,30
2988.240527,69,94,0.56,25,0.0224,30
2988.193931,36,57,0.79,21,0.037619048,30
2987.967359,57,81,0.66,24,0.0275,30
2987.736999,66,98,0.73,32,0.0228125,30
2987.71164,70,96,0.44,26,0.016923077,30
2987.349704,41,71,0.99,30,0.033,30
2987.277323,53,88,0.95,35,0.027142857,30
2986.196658,35,50,0.63,15,0.042,30
2986.147698,34,55,0.84,21,0.04,30
2986.066701,40,68,0.9,28,0.032142857,30
2986.025655,60,76,0.45,16,0.028125,30
2985.913064,51,73,0.8,22,0.036363636,30
2985.741246,57,90,0.84,33,0.025454545,30
2985.417236,57,81,0.72,24,0.03,30
2985.417236,56,82,0.78,26,0.03,30
2985.334586,39,68,0.96,29,0.033103448,30
2985.269398,62,73,0.34,11,0.030909091,30
2985.269398,58,77,0.59,19,0.031052632,30
2985.13,58,88,0.79,30,0.026333333,30
2985.127647,44,67,0.72,23,0.031304348,30
2984.92056,70,93,0.53,23,0.023043478,30
2984.697736,53,88,0.94,35,0.026857143,30
2984.691941,40,67,0.89,27,0.032962963,30
2984.67665,57,82,0.67,25,0.0268,30
2984.529288,45,66,0.59,21,0.028095238,30
2984.401608,60,76,0.49,16,0.030625,30
2984.320434,75,87,0.24,12,0.02,30
2984.307633,35,59,0.89,24,0.037083333,30
2984.079488,61,85,0.61,24,0.025416667,30
2984.079488,60,86,0.66,26,0.025384615,30
2984.079488,58,89,0.78,31,0.02516129,30
2983.734252,72,94,0.41,22,0.018636364,30
2983.478215,59,78,0.57,19,0.03,30
2983.478215,58,79,0.63,21,0.03,30
2983.44256,39,59,0.74,20,0.037,30
2983.36619,45,62,0.55,17,0.032352941,30
2983.324408,47,60,0.43,13,0.033076923,30
2983.134951,49,63,0.4,14,0.028571429,30
2983.113858,61,74,0.4,13,0.030769231,30
2983.113858,59,77,0.55,18,0.030555556,30
2983.113858,58,78,0.61,20,0.0305,30
2983.113858,55,81,0.8,26,0.030769231,30
2983.101443,52,84,0.91,32,0.0284375,30
2983.00606,73,91,0.33,18,0.018333333,30
2982.878066,64,80,0.44,16,0.0275,30
2982.757771,62,81,0.54,19,0.028421053,30
2982.757771,59,85,0.73,26,0.028076923,30
2982.757771,58,86,0.79,28,0.028214286,30
2982.679447,53,83,0.87,30,0.029,30
2982.610644,58,86,0.78,28,0.027857143,30
2982.44224,49,56,0.24,7,0.034285714,30
2982.106203,65,72,0.19,7,0.027142857,30
2982.106203,63,74,0.3,11,0.027272727,30
2982.08911,35,99,0.11,64,0.00171875,30
2981.372472,48,70,0.58,22,0.026363636,30
2981.345267,68,74,0.17,6,0.028333333,30
2981.345267,65,77,0.34,12,0.028333333,30
2981.345267,61,82,0.59,21,0.028095238,30
2981.316657,78,85,0.13,7,0.018571429,30
