% profit,ema1,ema2,threshold,diff,thresh / diff,ID
3976.542102,31,59,0.97,28,0.034642857,29
3915.742249,32,58,0.9,26,0.034615385,29
3775.786869,62,70,0.25,8,0.03125,29
3720.603975,39,55,0.58,16,0.03625,29
3715.622278,38,56,0.65,18,0.036111111,29
3711.531058,39,54,0.55,15,0.036666667,29
3694.468632,39,51,0.42,12,0.035,29
3686.730254,42,51,0.33,9,0.036666667,29
3679.785375,38,52,0.49,14,0.035,29
3665.649531,61,72,0.34,11,0.030909091,29
3665.434289,44,49,0.18,5,0.036,29
3662.392695,40,47,0.27,7,0.038571429,29
3649.029962,41,52,0.4,11,0.036363636,29
3648.64819,48,64,0.43,16,0.026875,29
3642.149299,43,49,0.22,6,0.036666667,29
3642.149299,41,51,0.37,10,0.037,29
3634.413641,59,73,0.44,14,0.031428571,29
3629.160443,40,53,0.47,13,0.036153846,29
3629.160443,38,55,0.62,17,0.036470588,29
3627.869976,40,54,0.5,14,0.035714286,29
3616.420303,40,53,0.48,13,0.036923077,29
3595.448451,41,48,0.25,7,0.035714286,29
3593.206178,57,68,0.38,11,0.034545455,29
3593.206178,56,69,0.45,13,0.034615385,29
3593.206178,55,70,0.52,15,0.034666667,29
3593.206178,53,73,0.69,20,0.0345,29
3587.587711,54,71,0.59,17,0.034705882,29
3587.587711,52,74,0.76,22,0.034545455,29
3586.38323,59,66,0.24,7,0.034285714,29
3585.734435,36,58,0.81,22,0.036818182,29
3585.5181,33,60,0.91,27,0.033703704,29
3584.089384,58,75,0.53,17,0.031176471,29
3580.53349,61,63,0.07,2,0.035,29
3580.53349,60,64,0.14,4,0.035,29
3580.53349,59,65,0.21,6,0.035,29
3580.53349,58,66,0.28,8,0.035,29
3580.53349,57,67,0.35,10,0.035,29
3579.356795,38,55,0.63,17,0.037058824,29
3579.26931,38,56,0.66,18,0.036666667,29
3579.25892,34,62,0.98,28,0.035,29
3577.019356,58,67,0.31,9,0.034444444,29
3576.68071,48,65,0.42,17,0.024705882,29
3576.262152,39,49,0.38,10,0.038,29
3575.686484,51,76,0.86,25,0.0344,29
3574.625694,45,48,0.11,3,0.036666667,29
3571.930601,45,69,0.6,24,0.025,29
3571.39071,60,70,0.32,10,0.032,29
3569.457565,33,55,0.85,22,0.038636364,29
3566.434919,50,77,0.93,27,0.034444444,29
3565.998687,34,58,0.82,24,0.034166667,29
3564.495432,37,57,0.73,20,0.0365,29
3564.108117,36,58,0.8,22,0.036363636,29
3563.783353,63,69,0.19,6,0.031666667,29
3563.783353,60,72,0.38,12,0.031666667,29
3563.783353,57,75,0.57,18,0.031666667,29
3560.992012,39,55,0.57,16,0.035625,29
3560.444283,44,69,0.67,25,0.0268,29
3557.219305,60,71,0.35,11,0.031818182,29
3556.208211,39,54,0.54,15,0.036,29
3552.250742,55,57,0.05,2,0.025,29
3552.250742,54,58,0.1,4,0.025,29
3552.250742,53,59,0.15,6,0.025,29
3552.192506,62,71,0.28,9,0.031111111,29
3551.432263,58,68,0.34,10,0.034,29
3550.057173,54,91,0.95,37,0.025675676,29
3549.427917,50,62,0.3,12,0.025,29
3549.298752,56,70,0.48,14,0.034285714,29
3549.298752,55,71,0.55,16,0.034375,29
3549.298752,54,72,0.62,18,0.034444444,29
3545.823506,53,72,0.66,19,0.034736842,29
3545.823506,51,75,0.83,24,0.034583333,29
3542.754209,57,73,0.54,16,0.03375,29
3540.911585,51,76,0.85,25,0.034,29
3538.913059,41,48,0.26,7,0.037142857,29
3538.849178,56,68,0.42,12,0.035,29
3538.125671,62,65,0.1,3,0.033333333,29
3538.125671,59,67,0.27,8,0.03375,29
3538.125671,59,68,0.3,9,0.033333333,29
3538.125671,56,71,0.5,15,0.033333333,29
3538.125671,55,72,0.57,17,0.033529412,29
3538.034792,58,73,0.5,15,0.033333333,29
3537.605568,52,75,0.78,23,0.033913043,29
3537.477285,56,74,0.61,18,0.033888889,29
3537.477285,55,75,0.68,20,0.034,29
3537.085728,61,69,0.27,8,0.03375,29
3537.060967,37,51,0.53,14,0.037857143,29
3534.713245,54,76,0.75,22,0.034090909,29
3533.507974,40,48,0.3,8,0.0375,29
3533.077881,52,60,0.2,8,0.025,29
3533.077881,51,61,0.25,10,0.025,29
3531.024219,56,77,0.66,21,0.031428571,29
3530.486867,58,69,0.37,11,0.033636364,29
3529.450452,36,59,0.82,23,0.035652174,29
3529.450452,35,60,0.9,25,0.036,29
3528.957949,47,66,0.47,19,0.024736842,29
3528.680964,52,55,0.08,3,0.026666667,29
3527.993774,58,74,0.51,16,0.031875,29
3527.867459,37,56,0.7,19,0.036842105,29
3527.630934,38,50,0.46,12,0.038333333,29
3526.909488,31,59,0.98,28,0.035,29
3522.455436,34,55,0.78,21,0.037142857,29
3521.66854,56,76,0.64,20,0.032,29
3520.643781,41,57,0.56,16,0.035,29
3518.466533,47,65,0.49,18,0.027222222,29
3518.425836,35,61,0.93,26,0.035769231,29
3517.429996,59,74,0.47,15,0.031333333,29
3515.73408,54,78,0.77,24,0.032083333,29
3515.638322,32,57,0.95,25,0.038,29
3515.634086,53,74,0.72,21,0.034285714,29
3513.380949,56,71,0.52,15,0.034666667,29
3513.377374,34,55,0.79,21,0.037619048,29
3511.300605,57,69,0.41,12,0.034166667,29
3511.258184,35,61,0.94,26,0.036153846,29
3510.133628,52,75,0.79,23,0.034347826,29
3509.738148,55,78,0.73,23,0.03173913,29
3508.316085,37,58,0.77,21,0.036666667,29
3506.995186,53,80,0.86,27,0.031851852,29
3506.225038,58,69,0.38,11,0.034545455,29
3506.225038,57,70,0.45,13,0.034615385,29
3506.217799,53,77,0.82,24,0.034166667,29
3505.909103,61,71,0.32,10,0.032,29
3505.808569,61,68,0.24,7,0.034285714,29
3505.794946,33,56,0.87,23,0.037826087,29
3505.132451,39,50,0.41,11,0.037272727,29
3502.615584,34,54,0.77,20,0.0385,29
3502.30421,52,80,0.91,28,0.0325,29
3501.952397,58,72,0.45,14,0.032142857,29
3500.301028,59,73,0.45,14,0.032142857,29
3499.547573,36,59,0.83,23,0.036086957,29
3499.230888,55,77,0.71,22,0.032272727,29
3499.230888,53,79,0.84,26,0.032307692,29
3499.006673,56,71,0.51,15,0.034,29
3497.959237,32,57,0.89,25,0.0356,29
3497.209534,59,83,0.63,24,0.02625,29
3496.26191,33,56,0.86,23,0.037391304,29
3495.499001,46,66,0.54,20,0.027,29
3494.89105,55,76,0.7,21,0.033333333,29
3494.762691,38,50,0.45,12,0.0375,29
3493.941432,59,69,0.33,10,0.033,29
3493.684211,58,72,0.47,14,0.033571429,29
3493.562003,55,73,0.6,18,0.033333333,29
3493.135658,54,73,0.64,19,0.033684211,29
3492.958728,59,68,0.31,9,0.034444444,29
3492.952079,40,50,0.35,10,0.035,29
3489.674807,41,49,0.28,8,0.035,29
3489.369365,53,74,0.71,21,0.033809524,29
3489.318763,63,68,0.16,5,0.032,29
3489.318763,55,77,0.7,22,0.031818182,29
3489.246003,43,53,0.36,10,0.036,29
3489.133714,50,78,0.95,28,0.033928571,29
3489.0515,40,57,0.61,17,0.035882353,29
3488.648943,55,72,0.58,17,0.034117647,29
3486.314684,42,55,0.46,13,0.035384615,29
3486.088859,55,75,0.65,20,0.0325,29
3484.350368,36,60,0.84,24,0.035,29
3483.060957,61,70,0.29,9,0.032222222,29
3483.060957,59,72,0.42,13,0.032307692,29
3483.060957,57,74,0.55,17,0.032352941,29
3482.221339,36,52,0.61,16,0.038125,29
3480.77865,33,57,0.83,24,0.034583333,29
3479.724811,56,76,0.65,20,0.0325,29
3477.937078,70,96,0.45,26,0.017307692,29
3477.812796,52,79,0.9,27,0.033333333,29
3477.701738,58,74,0.52,16,0.0325,29
3477.437901,42,46,0.15,4,0.0375,29
3477.000155,55,76,0.69,21,0.032857143,29
3476.670753,57,75,0.58,18,0.032222222,29
3476.48487,56,87,0.81,31,0.026129032,29
3476.48487,54,90,0.94,36,0.026111111,29
3476.48487,53,91,0.99,38,0.026052632,29
3476.460953,35,53,0.69,18,0.038333333,29
3475.777669,53,75,0.74,22,0.033636364,29
3475.167616,56,73,0.56,17,0.032941176,29
3475.046563,55,73,0.61,18,0.033888889,29
3474.004743,60,71,0.36,11,0.032727273,29
3473.85908,54,78,0.78,24,0.0325,29
3473.515232,35,60,0.88,25,0.0352,29
3473.003363,58,84,0.69,26,0.026538462,29
3473.003363,57,86,0.76,29,0.026206897,29
3473.003363,55,88,0.87,33,0.026363636,29
3472.601098,33,56,0.85,23,0.036956522,29
3471.839322,53,79,0.85,26,0.032692308,29
3471.143382,51,81,0.98,30,0.032666667,29
3469.189991,37,58,0.75,21,0.035714286,29
3468.415959,51,80,0.95,29,0.032758621,29
3467.453164,58,73,0.49,15,0.032666667,29
3466.762312,62,78,0.43,16,0.026875,29
3466.762312,62,79,0.45,17,0.026470588,29
3466.762312,59,82,0.61,23,0.026521739,29
3466.66745,59,70,0.36,11,0.032727273,29
3466.484766,34,61,0.97,27,0.035925926,29
3466.233941,54,74,0.67,20,0.0335,29
3464.331599,54,91,0.94,37,0.025405405,29
3464.180715,33,60,0.92,27,0.034074074,29
3463.175338,54,73,0.65,19,0.034210526,29
3461.894951,61,66,0.17,5,0.034,29
3461.765568,54,89,0.93,35,0.026571429,29
3461.179201,58,73,0.48,15,0.032,29
3461.179201,56,75,0.61,19,0.032105263,29
3460.667557,60,83,0.6,23,0.026086957,29
3460.34019,35,61,0.95,26,0.036538462,29
3459.974736,54,74,0.68,20,0.034,29
3459.974736,53,75,0.75,22,0.034090909,29
3459.974736,52,76,0.82,24,0.034166667,29
3459.959531,35,60,0.89,25,0.0356,29
3459.069816,38,56,0.64,18,0.035555556,29
3459.039902,53,77,0.79,24,0.032916667,29
3458.754252,37,57,0.72,20,0.036,29
3456.617995,71,93,0.38,22,0.017272727,29
3455.731466,57,70,0.44,13,0.033846154,29
3454.970455,55,76,0.68,21,0.032380952,29
3454.970455,53,78,0.81,25,0.0324,29
3454.558953,51,77,0.89,26,0.034230769,29
3454.558953,50,78,0.96,28,0.034285714,29
3454.425632,63,67,0.13,4,0.0325,29
3454.425632,61,68,0.23,7,0.032857143,29
3454.425632,61,69,0.26,8,0.0325,29
3454.425632,59,71,0.39,12,0.0325,29
3454.425632,57,73,0.52,16,0.0325,29
3454.315424,59,72,0.43,13,0.033076923,29
3453.944389,55,89,0.88,34,0.025882353,29
3453.237829,56,72,0.53,16,0.033125,29
3451.802324,56,75,0.63,19,0.033157895,29
3451.61348,42,56,0.5,14,0.035714286,29
3451.244166,52,79,0.88,27,0.032592593,29
3450.869245,54,77,0.75,23,0.032608696,29
3450.4341,54,90,0.95,36,0.026388889,29
3450.32505,56,74,0.59,18,0.032777778,29
3449.898895,42,72,0.8,30,0.026666667,29
3449.668467,54,89,0.92,35,0.026285714,29
3448.957168,52,79,0.89,27,0.032962963,29
3447.268287,51,77,0.88,26,0.033846154,29
3446.878569,60,67,0.24,7,0.034285714,29
3446.213064,65,75,0.27,10,0.027,29
3446.213064,60,81,0.56,21,0.026666667,29
3446.213064,58,83,0.67,25,0.0268,29
3446.213064,57,85,0.74,28,0.026428571,29
3446.213064,56,86,0.8,30,0.026666667,29
3446.213064,55,87,0.85,32,0.0265625,29
3446.213064,53,90,0.98,37,0.026486486,29
3445.913109,34,54,0.73,20,0.0365,29
3445.783025,41,47,0.23,6,0.038333333,29
3444.661602,54,76,0.74,22,0.033636364,29
3442.930189,35,54,0.67,19,0.035263158,29
3442.608236,43,70,0.72,27,0.026666667,29
3441.02751,35,61,0.92,26,0.035384615,29
3440.662622,35,54,0.7,19,0.036842105,29
3438.92074,40,59,0.66,19,0.034736842,29
3438.477943,37,52,0.56,15,0.037333333,29
3437.604543,62,69,0.23,7,0.032857143,29
3437.312233,57,74,0.56,17,0.032941176,29
3437.312233,54,77,0.76,23,0.033043478,29
3436.482792,57,85,0.75,28,0.026785714,29
3436.482792,56,87,0.82,31,0.026451613,29
3435.788454,52,76,0.81,24,0.03375,29
3435.392575,57,87,0.78,30,0.026,29
3435.216325,56,75,0.62,19,0.032631579,29
3435.05953,55,87,0.86,32,0.026875,29
3435.05953,54,88,0.91,34,0.026764706,29
3434.807023,38,51,0.48,13,0.036923077,29
3434.703387,49,59,0.26,10,0.026,29
3434.580002,53,78,0.83,25,0.0332,29
3433.924359,38,51,0.46,13,0.035384615,29
3431.803405,36,53,0.64,17,0.037647059,29
3431.803405,35,54,0.72,19,0.037894737,29
3431.702195,52,78,0.86,26,0.033076923,29
3431.702195,51,79,0.93,28,0.033214286,29
3430.944472,75,90,0.26,15,0.017333333,29
3430.827231,45,52,0.25,7,0.035714286,29
3430.66691,40,52,0.44,12,0.036666667,29
3430.412329,54,90,0.93,36,0.025833333,29
3430.06679,33,56,0.82,23,0.035652174,29
3429.195717,34,62,0.99,28,0.035357143,29
3428.961733,35,59,0.88,24,0.036666667,29
3428.91462,57,76,0.6,19,0.031578947,29
3428.19949,36,53,0.63,17,0.037058824,29
3428.064349,31,59,0.99,28,0.035357143,29
3427.811784,35,54,0.68,19,0.035789474,29
3427.71013,57,72,0.5,15,0.033333333,29
3427.56341,58,72,0.46,14,0.032857143,29
3427.56341,55,75,0.66,20,0.033,29
3427.140242,67,99,0.56,32,0.0175,29
3427.022788,58,71,0.43,13,0.033076923,29
3426.22137,77,88,0.19,11,0.017272727,29
3426.16472,56,86,0.79,30,0.026333333,29
3426.16472,53,90,0.97,37,0.026216216,29
3424.20977,34,53,0.72,19,0.037894737,29
3424.171927,71,93,0.39,22,0.017727273,29
3423.820568,53,86,0.92,33,0.027878788,29
3423.516789,60,70,0.33,10,0.033,29
3423.071413,60,80,0.54,20,0.027,29
3423.071413,57,84,0.72,27,0.026666667,29
3423.071413,56,85,0.78,29,0.026896552,29
3423.071413,53,89,0.96,36,0.026666667,29
3422.521495,37,58,0.76,21,0.036190476,29
3422.422603,55,74,0.63,19,0.033157895,29
3422.077234,77,86,0.16,9,0.017777778,29
3420.926474,53,78,0.82,25,0.0328,29
3420.542521,36,53,0.6,17,0.035294118,29
3419.568287,56,73,0.58,17,0.034117647,29
3419.499173,63,77,0.38,14,0.027142857,29
3419.499173,61,79,0.49,18,0.027222222,29
3419.499173,59,82,0.62,23,0.026956522,29
3419.499173,57,84,0.73,27,0.027037037,29
3419.443814,34,61,0.95,27,0.035185185,29
3418.896437,41,58,0.59,17,0.034705882,29
3418.716445,41,57,0.57,16,0.035625,29
3418.384294,54,88,0.92,34,0.027058824,29
3417.950012,58,71,0.44,13,0.033846154,29
3417.950012,57,72,0.51,15,0.034,29
3417.640214,62,67,0.17,5,0.034,29
3416.940565,57,72,0.49,15,0.032666667,29
3416.097763,37,53,0.56,16,0.035,29
3414.731041,50,58,0.21,8,0.02625,29
3414.28344,34,55,0.74,21,0.035238095,29
3413.56356,68,97,0.51,29,0.017586207,29
3413.300804,34,55,0.75,21,0.035714286,29
3412.242001,52,78,0.88,26,0.033846154,29
3411.766263,54,76,0.72,22,0.032727273,29
3410.988982,61,73,0.37,12,0.030833333,29
3410.878164,53,89,0.97,36,0.026944444,29
3410.371966,49,63,0.35,14,0.025,29
3409.068751,53,77,0.81,24,0.03375,29
3408.854465,53,90,0.99,37,0.026756757,29
3408.11592,46,67,0.56,21,0.026666667,29
3408.049303,53,76,0.78,23,0.033913043,29
3407.716728,47,61,0.37,14,0.026428571,29
3406.903968,36,59,0.84,23,0.036521739,29
3406.903968,35,60,0.92,25,0.0368,29
3405.175634,60,74,0.43,14,0.030714286,29
3404.736008,39,49,0.36,10,0.036,29
3404.452913,46,67,0.52,21,0.024761905,29
3404.370815,51,79,0.95,28,0.033928571,29
3404.369395,46,52,0.21,6,0.035,29
3403.941377,55,88,0.86,33,0.026060606,29
3403.882266,55,89,0.89,34,0.026176471,29
3403.478552,35,53,0.65,18,0.036111111,29
3403.153899,54,88,0.9,34,0.026470588,29
3402.422203,62,68,0.2,6,0.033333333,29
3402.422203,59,71,0.4,12,0.033333333,29
3397.683568,45,53,0.28,8,0.035,29
3397.066623,51,80,0.97,29,0.033448276,29
3396.53185,59,81,0.6,22,0.027272727,29
3396.53185,55,86,0.84,31,0.027096774,29
3395.424246,56,85,0.79,29,0.027241379,29
3395.424246,54,87,0.9,33,0.027272727,29
3395.099453,35,56,0.78,21,0.037142857,29
3394.501317,56,74,0.6,18,0.033333333,29
3394.100221,44,70,0.66,26,0.025384615,29
3393.677899,37,53,0.6,16,0.0375,29
3390.788697,35,54,0.71,19,0.037368421,29
3390.151041,54,76,0.73,22,0.033181818,29
3387.398407,33,59,0.95,26,0.036538462,29
3386.594981,40,58,0.64,18,0.035555556,29
3386.256451,48,63,0.38,15,0.025333333,29
3385.516423,36,58,0.79,22,0.035909091,29
3385.399181,48,50,0.07,2,0.035,29
3385.399181,47,51,0.14,4,0.035,29
3383.861252,34,61,0.98,27,0.036296296,29
3383.089788,58,82,0.68,24,0.028333333,29
3382.865496,55,74,0.65,19,0.034210526,29
3382.865496,54,75,0.72,21,0.034285714,29
3382.831004,57,77,0.62,20,0.031,29
3382.793874,37,62,0.86,25,0.0344,29
3381.977756,39,50,0.39,11,0.035454545,29
3381.213694,41,56,0.54,15,0.036,29
3380.980625,63,66,0.1,3,0.033333333,29
3380.980625,60,69,0.3,9,0.033333333,29
3380.574291,35,59,0.87,24,0.03625,29
3379.460391,55,88,0.88,33,0.026666667,29
3379.132336,69,97,0.49,28,0.0175,29
3379.065411,34,61,0.96,27,0.035555556,29
3379.065328,39,60,0.74,21,0.035238095,29
3378.078806,50,61,0.28,11,0.025454545,29
3377.556842,59,70,0.37,11,0.033636364,29
3377.556842,55,75,0.67,20,0.0335,29
3377.345904,49,61,0.31,12,0.025833333,29
3377.288542,43,70,0.73,27,0.027037037,29
3376.287048,52,87,0.99,35,0.028285714,29
3375.750702,58,86,0.72,28,0.025714286,29
3375.527204,35,56,0.77,21,0.036666667,29
3375.092193,65,73,0.23,8,0.02875,29
3374.963893,57,73,0.53,16,0.033125,29
3374.963209,42,71,0.78,29,0.026896552,29
3374.235977,51,60,0.23,9,0.025555556,29
3373.948933,71,94,0.4,23,0.017391304,29
3373.879455,42,50,0.29,8,0.03625,29
3373.645909,60,70,0.34,10,0.034,29
3373.178222,61,81,0.52,20,0.026,29
3373.178222,58,85,0.7,27,0.025925926,29
3372.910045,49,58,0.24,9,0.026666667,29
3372.856415,49,62,0.33,13,0.025384615,29
3372.665606,44,54,0.35,10,0.035,29
3372.665606,43,55,0.42,12,0.035,29
3372.665606,42,56,0.49,14,0.035,29
3371.958618,43,69,0.71,26,0.027307692,29
3371.080078,43,54,0.39,11,0.035454545,29
3369.302069,80,84,0.07,4,0.0175,29
3369.302069,78,86,0.14,8,0.0175,29
3369.302069,76,88,0.21,12,0.0175,29
3369.294735,54,85,0.87,31,0.028064516,29
3368.536379,32,57,0.93,25,0.0372,29
3367.707455,35,60,0.91,25,0.0364,29
3366.908567,63,78,0.4,15,0.026666667,29
3366.908567,61,80,0.51,19,0.026842105,29
3366.908567,60,82,0.58,22,0.026363636,29
3366.77288,45,67,0.6,22,0.027272727,29
3366.092779,56,89,0.85,33,0.025757576,29
3365.056459,35,53,0.67,18,0.037222222,29
3364.565311,51,80,0.96,29,0.033103448,29
3364.459943,40,49,0.32,9,0.035555556,29
3364.246468,63,79,0.42,16,0.02625,29
3363.026023,51,79,0.94,28,0.033571429,29
3362.373927,33,59,0.94,26,0.036153846,29
3361.994454,68,98,0.52,30,0.017333333,29
3361.886345,44,68,0.65,24,0.027083333,29
3361.576458,32,62,0.97,30,0.032333333,29
3361.419152,56,85,0.81,29,0.027931034,29
3361.187062,57,87,0.77,30,0.025666667,29
3360.95299,63,74,0.32,11,0.029090909,29
3360.360063,60,79,0.54,19,0.028421053,29
3360.349374,59,84,0.68,25,0.0272,29
3359.970573,59,80,0.6,21,0.028571429,29
3359.970573,58,81,0.66,23,0.028695652,29
3359.936717,73,92,0.33,19,0.017368421,29
3359.796483,36,63,0.93,27,0.034444444,29
3359.275025,53,86,0.93,33,0.028181818,29
3358.850093,44,53,0.32,9,0.035555556,29
3358.329633,54,70,0.56,16,0.035,29
3356.897905,35,62,0.88,27,0.032592593,29
3355.837901,51,60,0.25,9,0.027777778,29
3354.872714,68,97,0.5,29,0.017241379,29
3353.453145,56,88,0.84,32,0.02625,29
3353.260188,60,65,0.17,5,0.034,29
3353.139664,32,57,0.9,25,0.036,29
3351.908846,73,91,0.32,18,0.017777778,29
3351.908846,70,95,0.44,25,0.0176,29
3350.307242,56,73,0.57,17,0.033529412,29
3350.180946,57,86,0.75,29,0.025862069,29
3350.180946,55,89,0.87,34,0.025588235,29
3348.375561,55,91,0.92,36,0.025555556,29
3347.850086,38,59,0.74,21,0.035238095,29
3347.25961,58,85,0.74,27,0.027407407,29
3346.375283,66,72,0.17,6,0.028333333,29
3346.375283,55,85,0.84,30,0.028,29
3346.277187,38,61,0.79,23,0.034347826,29
3346.029867,61,80,0.5,19,0.026315789,29
3346.029867,58,83,0.66,25,0.0264,29
3346.029867,58,84,0.68,26,0.026153846,29
3345.767621,59,84,0.65,25,0.026,29
3344.92157,34,60,0.83,26,0.031923077,29
3344.838169,41,72,0.84,31,0.027096774,29
3344.47295,70,95,0.43,25,0.0172,29
3342.99408,43,71,0.74,28,0.026428571,29
3342.660691,43,56,0.45,13,0.034615385,29
3342.660691,42,57,0.52,15,0.034666667,29
3342.431013,33,59,0.96,26,0.036923077,29
3342.194484,52,72,0.7,20,0.035,29
3342.001814,66,99,0.58,33,0.017575758,29
3340.853868,32,63,0.98,31,0.031612903,29
3340.328722,56,86,0.81,30,0.027,29
3340.328722,55,87,0.87,32,0.0271875,29
3339.870323,35,57,0.87,22,0.039545455,29
3338.366435,67,99,0.55,32,0.0171875,29
3338.28788,33,61,0.9,28,0.032142857,29
3338.061574,55,91,0.91,36,0.025277778,29
3337.985529,72,93,0.37,21,0.017619048,29
3337.932394,54,91,0.96,37,0.025945946,29
3337.896412,55,74,0.64,19,0.033684211,29
3337.575246,55,90,0.89,35,0.025428571,29
3337.481779,35,58,0.74,23,0.032173913,29
3335.820034,53,77,0.8,24,0.033333333,29
3335.820034,52,78,0.87,26,0.033461538,29
3335.354567,72,92,0.35,20,0.0175,29
3335.354567,70,94,0.42,24,0.0175,29
3335.354567,67,98,0.54,31,0.017419355,29
3334.588125,49,63,0.38,14,0.027142857,29
3334.275445,40,48,0.29,8,0.03625,29
3334.141621,58,81,0.65,23,0.02826087,29
3332.753725,44,70,0.69,26,0.026538462,29
3331.860876,69,72,0.08,3,0.026666667,29
3331.195735,55,90,0.9,35,0.025714286,29
3330.303584,65,75,0.28,10,0.028,29
3329.710607,60,83,0.61,23,0.026521739,29
3329.03871,46,66,0.57,20,0.0285,29
3328.912645,40,56,0.57,16,0.035625,29
3328.765092,61,78,0.48,17,0.028235294,29
3328.62417,56,88,0.85,32,0.0265625,29
3328.2275,56,83,0.75,27,0.027777778,29
3328.2275,55,84,0.81,29,0.027931034,29
3328.2275,53,87,0.94,34,0.027647059,29
3327.888293,69,95,0.46,26,0.017692308,29
3327.66937,56,88,0.82,32,0.025625,29
3326.989462,62,72,0.31,10,0.031,29
3326.98854,41,58,0.49,17,0.028823529,29
3326.246172,48,65,0.43,17,0.025294118,29
3325.72816,57,86,0.79,29,0.027241379,29
3325.358373,54,89,0.94,35,0.026857143,29
3325.013556,69,96,0.47,27,0.017407407,29
3324.863164,58,78,0.57,20,0.0285,29
3324.855778,39,53,0.52,14,0.037142857,29
3324.506015,53,71,0.63,18,0.035,29
3324.497742,69,97,0.48,28,0.017142857,29
3324.311567,60,82,0.57,22,0.025909091,29
3324.311567,57,85,0.73,28,0.026071429,29
3324.311567,56,87,0.8,31,0.025806452,29
3324.218586,37,61,0.84,24,0.035,29
3323.872931,37,60,0.81,23,0.035217391,29
3322.973134,67,98,0.55,31,0.017741935,29
3322.958479,34,57,0.86,23,0.037391304,29
3322.619649,55,87,0.88,32,0.0275,29
3322.541945,49,62,0.36,13,0.027692308,29
3321.695365,44,51,0.25,7,0.035714286,29
3321.694631,42,52,0.34,10,0.034,29
3321.088173,56,81,0.71,25,0.0284,29
3320.792494,48,64,0.4,16,0.025,29
3320.692518,35,61,0.91,26,0.035,29
3319.770324,54,56,0.05,2,0.025,29
3319.428283,74,90,0.28,16,0.0175,29
3318.025302,47,64,0.43,17,0.025294118,29
3317.920412,52,86,0.98,34,0.028823529,29
3317.887496,34,59,0.96,25,0.0384,29
3317.474539,37,56,0.69,19,0.036315789,29
3317.327477,59,82,0.64,23,0.027826087,29
3317.327477,58,83,0.7,25,0.028,29
3317.261159,57,84,0.75,27,0.027777778,29
3317.261159,54,88,0.94,34,0.027647059,29
3317.212868,64,71,0.2,7,0.028571429,29
3316.827254,36,57,0.77,21,0.036666667,29
3316.827254,34,60,0.94,26,0.036153846,29
3316.827254,34,60,0.95,26,0.036538462,29
3316.746842,55,81,0.76,26,0.029230769,29
3316.652371,53,89,0.99,36,0.0275,29
3316.550614,75,88,0.23,13,0.017692308,29
3316.265128,54,92,0.97,38,0.025526316,29
3315.615186,60,80,0.55,20,0.0275,29
3315.615186,58,83,0.68,25,0.0272,29
3314.993217,35,59,0.86,24,0.035833333,29
3314.533215,57,84,0.74,27,0.027407407,29
3313.720152,35,57,0.75,22,0.034090909,29
3313.532312,59,84,0.67,25,0.0268,29
3313.532312,55,89,0.91,34,0.026764706,29
3313.34575,57,80,0.67,23,0.029130435,29
3313.34575,55,83,0.81,28,0.028928571,29
3313.34575,54,84,0.87,30,0.029,29
3313.085636,54,75,0.71,21,0.033809524,29
3313.046568,57,83,0.73,26,0.028076923,29
3312.088838,66,75,0.24,9,0.026666667,29
3310.896454,47,65,0.45,18,0.025,29
3310.896454,46,66,0.5,20,0.025,29
3309.322443,41,72,0.87,31,0.028064516,29
3308.804303,43,69,0.74,26,0.028461538,29
3308.298241,56,85,0.77,29,0.026551724,29
3308.286314,61,77,0.46,16,0.02875,29
3308.286314,60,78,0.52,18,0.028888889,29
3308.17124,40,73,0.93,33,0.028181818,29
3307.928515,55,86,0.83,31,0.026774194,29
3307.928515,54,87,0.89,33,0.026969697,29
3307.716853,36,57,0.78,21,0.037142857,29
3307.535987,35,57,0.74,22,0.033636364,29
3306.928229,40,54,0.51,14,0.036428571,29
3306.910789,56,82,0.74,26,0.028461538,29
3306.910789,55,83,0.8,28,0.028571429,29
3306.842823,64,77,0.34,13,0.026153846,29
3306.302374,55,81,0.75,26,0.028846154,29
3306.167747,37,52,0.53,15,0.035333333,29
3305.880869,56,88,0.83,32,0.0259375,29
3305.678776,52,85,0.96,33,0.029090909,29
3305.386925,41,53,0.43,12,0.035833333,29
3305.363705,59,83,0.62,24,0.025833333,29
3305.196926,62,78,0.45,16,0.028125,29
3305.196926,61,79,0.51,18,0.028333333,29
3304.564978,64,75,0.31,11,0.028181818,29
3304.408779,54,87,0.94,33,0.028484848,29
3304.041739,57,79,0.63,22,0.028636364,29
3303.964085,42,48,0.22,6,0.036666667,29
3303.652311,35,63,0.98,28,0.035,29
3303.371339,37,51,0.51,14,0.036428571,29
3303.15083,35,55,0.7,20,0.035,29
3302.957821,52,57,0.13,5,0.026,29
3302.592469,61,78,0.49,17,0.028823529,29
3302.409208,58,82,0.67,24,0.027916667,29
3302.37047,62,77,0.42,15,0.028,29
3302.023592,55,87,0.84,32,0.02625,29
3301.513956,57,81,0.69,24,0.02875,29
3301.513956,56,82,0.75,26,0.028846154,29
3301.411158,52,59,0.2,7,0.028571429,29
3301.367156,55,82,0.77,27,0.028518519,29
3301.216918,60,75,0.44,15,0.029333333,29
3301.092521,34,60,0.96,26,0.036923077,29
3300.948534,60,81,0.55,21,0.026190476,29
3300.931213,56,84,0.79,28,0.028214286,29
3300.931213,55,85,0.85,30,0.028333333,29
3300.190129,54,82,0.82,28,0.029285714,29
3299.95357,45,53,0.27,8,0.03375,29
3299.839914,58,85,0.71,27,0.026296296,29
3299.804521,52,73,0.73,21,0.034761905,29
3299.804521,51,74,0.8,23,0.034782609,29
3299.804521,50,76,0.9,26,0.034615385,29
3299.515423,66,73,0.2,7,0.028571429,29
3299.515423,60,80,0.57,20,0.0285,29
3299.28495,33,57,0.85,24,0.035416667,29
3298.544555,57,79,0.64,22,0.029090909,29
3298.447891,53,57,0.1,4,0.025,29
3298.447891,52,58,0.15,6,0.025,29
3298.304284,42,53,0.39,11,0.035454545,29
3298.041104,47,66,0.48,19,0.025263158,29
3297.884288,63,76,0.36,13,0.027692308,29
3297.579106,42,70,0.79,28,0.028214286,29
3297.579106,41,71,0.85,30,0.028333333,29
3297.570607,37,54,0.62,17,0.036470588,29
3297.370976,60,75,0.43,15,0.028666667,29
3297.343106,61,80,0.53,19,0.027894737,29
3297.343106,58,84,0.72,26,0.027692308,29
3296.807933,60,79,0.53,19,0.027894737,29
3296.600103,36,64,0.96,28,0.034285714,29
3296.311896,63,72,0.26,9,0.028888889,29
3295.925719,65,74,0.25,9,0.027777778,29
3295.66648,48,51,0.1,3,0.033333333,29
3295.440991,36,52,0.58,16,0.03625,29
3295.050452,58,86,0.73,28,0.026071429,29
3294.849984,59,81,0.61,22,0.027727273,29
3294.274161,33,59,0.97,26,0.037307692,29
3294.179182,38,60,0.76,22,0.034545455,29
3293.908896,73,91,0.3,18,0.016666667,29
3293.627045,40,59,0.67,19,0.035263158,29
3293.300819,55,69,0.49,14,0.035,29
3293.223757,56,80,0.7,24,0.029166667,29
3292.927753,58,82,0.65,24,0.027083333,29
3292.927753,56,84,0.76,28,0.027142857,29
3292.63374,45,54,0.31,9,0.034444444,29
3292.445515,34,56,0.77,22,0.035,29
3291.958349,56,80,0.69,24,0.02875,29
3291.854501,50,60,0.26,10,0.026,29
3291.851533,55,86,0.88,31,0.028387097,29
3291.773283,61,78,0.47,17,0.027647059,29
3291.560272,48,62,0.36,14,0.025714286,29
3291.443934,54,89,0.95,35,0.027142857,29
3291.421715,62,80,0.47,18,0.026111111,29
3290.698864,58,82,0.66,24,0.0275,29
3290.240829,37,55,0.59,18,0.032777778,29
3289.29326,54,83,0.83,29,0.02862069,29
3288.839716,46,66,0.55,20,0.0275,29
3288.709452,54,84,0.86,30,0.028666667,29
3288.709452,53,85,0.92,32,0.02875,29
3288.709452,53,86,0.94,33,0.028484848,29
3288.316053,38,60,0.77,22,0.035,29
3288.120357,65,76,0.29,11,0.026363636,29
3287.868525,61,81,0.53,20,0.0265,29
3287.603863,55,86,0.86,31,0.027741935,29
3287.475621,45,54,0.3,9,0.033333333,29
3286.932797,37,59,0.73,22,0.033181818,29
3286.597164,44,54,0.34,10,0.034,29
3285.89641,34,57,0.8,23,0.034782609,29
3285.685174,47,60,0.35,13,0.026923077,29
3284.760379,51,59,0.2,8,0.025,29
3284.351296,38,53,0.55,15,0.036666667,29
3283.552546,39,51,0.44,12,0.036666667,29
3283.043141,34,57,0.87,23,0.037826087,29
3282.453674,59,80,0.59,21,0.028095238,29
3282.256331,59,80,0.58,21,0.027619048,29
3282.256331,57,83,0.71,26,0.027307692,29
3282.256331,55,85,0.82,30,0.027333333,29
3282.256331,53,88,0.95,35,0.027142857,29
3282.196469,41,73,0.86,32,0.026875,29
3281.497701,69,97,0.51,28,0.018214286,29
3281.338288,37,56,0.68,19,0.035789474,29
3281.338288,34,60,0.93,26,0.035769231,29
3281.184927,56,84,0.77,28,0.0275,29
3281.184927,54,86,0.88,32,0.0275,29
3281.184927,53,88,0.96,35,0.027428571,29
3280.658773,46,67,0.53,21,0.025238095,29
3279.728513,42,47,0.18,5,0.036,29
3279.664836,63,76,0.37,13,0.028461538,29
3279.664836,59,81,0.62,22,0.028181818,29
3279.284429,62,77,0.43,15,0.028666667,29
3278.783562,58,77,0.55,19,0.028947368,29
3278.783562,57,78,0.61,21,0.029047619,29
3278.566037,43,52,0.32,9,0.035555556,29
3277.993941,38,52,0.48,14,0.034285714,29
3277.213015,59,83,0.64,24,0.026666667,29
3276.365876,39,74,0.99,35,0.028285714,29
3275.871224,32,58,0.92,26,0.035384615,29
3275.338987,36,62,0.91,26,0.035,29
3275.141814,56,79,0.67,23,0.029130435,29
3275.105788,36,55,0.76,19,0.04,29
3274.968576,50,60,0.25,10,0.025,29
3274.818773,35,57,0.85,22,0.038636364,29
3274.483083,38,54,0.59,16,0.036875,29
3274.207727,44,69,0.7,25,0.028,29
3273.689329,42,71,0.79,29,0.027241379,29
3273.428108,61,75,0.4,14,0.028571429,29
3273.412581,42,70,0.8,28,0.028571429,29
3272.696089,57,83,0.72,26,0.027692308,29
3272.635747,36,55,0.69,19,0.036315789,29
3272.017464,62,79,0.47,17,0.027647059,29
3271.893803,56,86,0.82,30,0.027333333,29
3271.788145,63,77,0.39,14,0.027857143,29
3271.769153,61,74,0.38,13,0.029230769,29
3271.29645,61,67,0.2,6,0.033333333,29
3271.29645,58,70,0.4,12,0.033333333,29
3271.156755,32,63,0.99,31,0.031935484,29
3271.080205,36,61,0.88,25,0.0352,29
3270.362002,59,77,0.51,18,0.028333333,29
3270.173845,40,69,0.93,29,0.032068966,29
3269.810075,36,59,0.85,23,0.036956522,29
3269.645496,55,90,0.91,35,0.026,29
3269.505673,54,87,0.92,33,0.027878788,29
3269.44191,26,89,0.21,63,0.003333333,29
3269.437628,53,84,0.9,31,0.029032258,29
3269.119927,58,78,0.58,20,0.029,29
3269.048896,59,76,0.49,17,0.028823529,29
3268.798128,38,57,0.68,19,0.035789474,29
3268.578086,54,91,0.97,37,0.026216216,29
3268.510799,53,84,0.89,31,0.028709677,29
3268.244051,43,51,0.27,8,0.03375,29
3268.208732,41,49,0.3,8,0.0375,29
3268.122984,59,79,0.57,20,0.0285,29
3268.05992,54,75,0.7,21,0.033333333,29
3266.788104,46,53,0.2,7,0.028571429,29
3266.014964,54,88,0.93,34,0.027352941,29
3265.761728,54,88,0.95,34,0.027941176,29
3265.628801,34,58,0.87,24,0.03625,29
3265.46305,51,78,0.9,27,0.033333333,29
3265.081344,36,57,0.76,21,0.036190476,29
3264.954435,44,55,0.37,11,0.033636364,29
3264.378597,34,59,0.98,25,0.0392,29
3264.266503,33,59,0.89,26,0.034230769,29
3264.256111,37,59,0.78,22,0.035454545,29
3263.81563,38,52,0.52,14,0.037142857,29
3263.602264,57,87,0.81,30,0.027,29
3263.244317,67,99,0.58,32,0.018125,29
3262.849814,62,76,0.4,14,0.028571429,29
3262.731694,34,58,0.83,24,0.034583333,29
3262.347455,64,77,0.35,13,0.026923077,29
3262.264492,36,55,0.7,19,0.036842105,29
3262.204961,45,67,0.63,22,0.028636364,29
3261.446976,36,55,0.66,19,0.034736842,29
3261.237608,56,85,0.8,29,0.027586207,29
3261.10603,54,89,0.91,35,0.026,29
3261.012207,53,76,0.76,23,0.033043478,29
3260.919769,38,63,0.86,25,0.0344,29
3260.252328,58,85,0.73,27,0.027037037,29
3258.91488,40,50,0.37,10,0.037,29
3258.34944,35,58,0.88,23,0.03826087,29
3258.286219,38,62,0.84,24,0.035,29
3257.958383,38,55,0.61,17,0.035882353,29
3257.939234,58,81,0.64,23,0.027826087,29
3257.939234,55,85,0.83,30,0.027666667,29
3257.939234,54,86,0.89,32,0.0278125,29
3257.734656,56,89,0.84,33,0.025454545,29
3257.463231,57,86,0.77,29,0.026551724,29
3257.449277,54,74,0.69,20,0.0345,29
3257.377035,35,59,0.9,24,0.0375,29
3257.151356,40,53,0.49,13,0.037692308,29
3257.15005,33,55,0.8,22,0.036363636,29
3257.134758,52,77,0.83,25,0.0332,29
3257.127765,42,58,0.45,16,0.028125,29
3256.832902,54,86,0.92,32,0.02875,29
3256.605231,34,61,0.99,27,0.036666667,29
3256.260318,34,58,0.94,24,0.039166667,29
3256.045756,40,60,0.69,20,0.0345,29
3255.768368,41,51,0.38,10,0.038,29
3255.573715,63,77,0.4,14,0.028571429,29
3255.347255,55,84,0.82,29,0.028275862,29
3255.232453,74,91,0.3,17,0.017647059,29
3255.04077,42,48,0.21,6,0.035,29
3254.914638,32,58,0.91,26,0.035,29
3254.338356,35,56,0.79,21,0.037619048,29
3253.994629,60,82,0.59,22,0.026818182,29
3253.908872,37,61,0.83,24,0.034583333,29
3253.674866,32,57,0.88,25,0.0352,29
3253.350978,47,63,0.41,16,0.025625,29
3252.886518,50,79,0.99,29,0.034137931,29
3252.353597,39,49,0.37,10,0.037,29
3251.359323,56,89,0.86,33,0.026060606,29
3251.103101,44,53,0.31,9,0.034444444,29
3250.407854,32,62,0.98,30,0.032666667,29
3250.308171,43,56,0.37,13,0.028461538,29
3250.12887,58,80,0.63,22,0.028636364,29
3250.12887,56,83,0.77,27,0.028518519,29
3250.12887,55,84,0.83,29,0.02862069,29
3250.023053,37,53,0.59,16,0.036875,29
3248.965864,41,67,0.84,26,0.032307692,29
3248.265847,43,47,0.15,4,0.0375,29
3248.070246,54,90,0.99,36,0.0275,29
3248.018028,57,71,0.47,14,0.033571429,29
3248.005399,34,58,0.88,24,0.036666667,29
3247.423556,45,52,0.24,7,0.034285714,29
3247.273293,53,76,0.77,23,0.033478261,29
3246.552415,58,76,0.56,18,0.031111111,29
3246.479136,57,87,0.79,30,0.026333333,29
3246.46841,58,79,0.59,21,0.028095238,29
3246.46841,57,80,0.65,23,0.02826087,29
3246.345009,36,54,0.67,18,0.037222222,29
3246.294585,59,78,0.53,19,0.027894737,29
3246.112316,60,80,0.56,20,0.028,29
3246.080693,64,78,0.37,14,0.026428571,29
3246.01579,52,77,0.85,25,0.034,29
3244.827628,57,83,0.74,26,0.028461538,29
3244.79919,34,60,0.98,26,0.037692308,29
3244.771063,59,83,0.66,24,0.0275,29
3244.748295,43,70,0.76,27,0.028148148,29
3244.451142,57,82,0.72,25,0.0288,29
3244.451142,56,83,0.78,27,0.028888889,29
3244.451142,56,84,0.8,28,0.028571429,29
3244.451142,55,85,0.86,30,0.028666667,29
3244.361589,48,60,0.32,12,0.026666667,29
3244.246548,34,65,0.9,31,0.029032258,29
3243.484754,55,86,0.85,31,0.027419355,29
3243.484754,54,87,0.91,33,0.027575758,29
3243.484754,53,89,0.98,36,0.027222222,29
3243.472107,36,56,0.76,20,0.038,29
3243.133434,45,55,0.28,10,0.028,29
3242.893643,42,47,0.19,5,0.038,29
3242.893643,39,51,0.45,12,0.0375,29
3242.893643,38,52,0.53,14,0.037857143,29
3242.86143,56,88,0.86,32,0.026875,29
3242.847415,44,62,0.61,18,0.033888889,29
3242.842331,39,56,0.57,17,0.033529412,29
3241.169444,44,68,0.66,24,0.0275,29
3241.145426,60,78,0.51,18,0.028333333,29
3240.925503,51,78,0.92,27,0.034074074,29
3240.778002,33,66,0.98,33,0.02969697,29
3240.69541,42,73,0.81,31,0.026129032,29
3240.45242,42,57,0.43,15,0.028666667,29
3240.220364,32,61,0.98,29,0.033793103,29
3240.131194,56,87,0.86,31,0.027741935,29
3239.880539,34,63,0.95,29,0.032758621,29
3239.566273,64,77,0.36,13,0.027692308,29
3239.566273,61,81,0.55,20,0.0275,29
3239.303059,56,84,0.78,28,0.027857143,29
3239.231269,62,79,0.46,17,0.027058824,29
3239.231269,60,81,0.57,21,0.027142857,29
3238.904607,43,55,0.41,12,0.034166667,29
3238.735216,46,52,0.2,6,0.033333333,29
3238.584482,47,62,0.39,15,0.026,29
3238.438054,43,49,0.23,6,0.038333333,29
3238.173494,58,84,0.7,26,0.026923077,29
3237.820113,60,76,0.45,16,0.028125,29
3237.500625,34,65,0.91,31,0.029354839,29
3237.285855,60,76,0.46,16,0.02875,29
3237.061302,39,68,0.95,29,0.032758621,29
3236.761372,50,59,0.23,9,0.025555556,29
3236.052999,36,62,0.9,26,0.034615385,29
3235.556615,62,80,0.48,18,0.026666667,29
3235.556615,59,84,0.66,25,0.0264,29
3235.522375,56,86,0.83,30,0.027666667,29
3235.501778,54,92,0.96,38,0.025263158,29
3235.482394,36,57,0.8,21,0.038095238,29
3235.271775,62,75,0.36,13,0.027692308,29
3235.165402,64,67,0.1,3,0.033333333,29
3235.165402,61,70,0.3,9,0.033333333,29
3235.121608,36,54,0.68,18,0.037777778,29
3234.958996,40,52,0.46,12,0.038333333,29
3234.937396,40,49,0.34,9,0.037777778,29
3234.830779,39,58,0.67,19,0.035263158,29
3233.600565,60,81,0.58,21,0.027619048,29
3233.600565,58,83,0.69,25,0.0276,29
3233.482634,54,92,0.98,38,0.025789474,29
3231.943427,42,58,0.53,16,0.033125,29
3231.674134,39,57,0.65,18,0.036111111,29
3231.44938,64,76,0.34,12,0.028333333,29
3231.042711,56,72,0.54,16,0.03375,29
3231.042711,52,77,0.84,25,0.0336,29
3230.178928,70,97,0.46,27,0.017037037,29
3229.262795,57,86,0.82,29,0.028275862,29
3228.667397,55,86,0.87,31,0.028064516,29
3228.487419,36,54,0.63,18,0.035,29
3228.479561,61,82,0.54,21,0.025714286,29
3228.338069,38,62,0.68,24,0.028333333,29
3228.318681,58,86,0.74,28,0.026428571,29
3228.318681,56,89,0.87,33,0.026363636,29
3228.318681,55,90,0.92,35,0.026285714,29
3228.318681,54,91,0.98,37,0.026486486,29
3228.318681,54,92,0.99,38,0.026052632,29
3228.191693,68,98,0.55,30,0.018333333,29
3228.191693,67,99,0.59,32,0.0184375,29
3227.904783,37,63,0.89,26,0.034230769,29
3227.902769,38,51,0.49,13,0.037692308,29
3227.107133,76,89,0.23,13,0.017692308,29
3226.911911,39,53,0.51,14,0.036428571,29
3226.497393,71,96,0.43,25,0.0172,29
3226.11918,33,57,0.84,24,0.035,29
3226.000516,35,57,0.8,22,0.036363636,29
3225.855744,43,56,0.44,13,0.033846154,29
3225.63406,34,58,0.95,24,0.039583333,29
3225.585615,36,60,0.85,24,0.035416667,29
3225.079437,52,86,0.97,34,0.028529412,29
3224.923661,71,94,0.38,23,0.016521739,29
3224.264422,44,54,0.29,10,0.029,29
3224.119148,37,56,0.73,19,0.038421053,29
3223.978085,26,90,0.22,64,0.0034375,29
3223.78545,38,55,0.64,17,0.037647059,29
3223.647667,57,85,0.76,28,0.027142857,29
3223.647667,55,88,0.89,33,0.026969697,29
3223.271491,48,61,0.34,13,0.026153846,29
3223.057839,57,86,0.8,29,0.027586207,29
3222.534208,48,63,0.43,15,0.028666667,29
3222.329096,39,57,0.64,18,0.035555556,29
3222.204484,51,58,0.18,7,0.025714286,29
3221.787723,43,57,0.46,14,0.032857143,29
3221.628271,42,48,0.24,6,0.04,29
3221.628271,41,49,0.32,8,0.04,29
3221.628271,40,50,0.4,10,0.04,29
3221.456166,51,78,0.91,27,0.033703704,29
3221.456166,50,79,0.98,29,0.033793103,29
3221.44404,39,54,0.56,15,0.037333333,29
3221.429834,34,64,0.97,30,0.032333333,29
3221.382245,35,63,0.84,28,0.03,29
3221.250352,45,61,0.54,16,0.03375,29
3221.096297,39,61,0.76,22,0.034545455,29
3220.87483,36,58,0.82,22,0.037272727,29
3219.98212,68,72,0.11,4,0.0275,29
3219.98212,66,74,0.22,8,0.0275,29
3219.98212,64,76,0.33,12,0.0275,29
3219.55525,42,50,0.3,8,0.0375,29
3219.432984,65,71,0.17,6,0.028333333,29
3219.432984,62,74,0.34,12,0.028333333,29
3218.930443,61,80,0.52,19,0.027368421,29
3218.930443,59,82,0.63,23,0.027391304,29
3218.81966,54,90,0.96,36,0.026666667,29
3218.8147,53,87,0.98,34,0.028823529,29
3218.675833,37,54,0.66,17,0.038823529,29
3218.21758,44,46,0.07,2,0.035,29
3218.21758,43,47,0.14,4,0.035,29
3218.136963,42,54,0.43,12,0.035833333,29
3218.136963,41,56,0.53,15,0.035333333,29
3218.123992,45,53,0.23,8,0.02875,29
3218.113719,45,68,0.62,23,0.026956522,29
3218.009375,27,87,0.24,60,0.004,29
3217.957075,77,88,0.18,11,0.016363636,29
3217.895131,35,58,0.85,23,0.036956522,29
3217.679294,37,64,0.94,27,0.034814815,29
3217.673731,36,53,0.61,17,0.035882353,29
3217.508915,43,56,0.43,13,0.033076923,29
3217.428697,63,75,0.34,12,0.028333333,29
3217.301989,47,49,0.07,2,0.035,29
3216.992076,43,51,0.29,8,0.03625,29
3216.40366,37,60,0.82,23,0.035652174,29
3216.267518,37,55,0.7,18,0.038888889,29
3216.220881,37,50,0.48,13,0.036923077,29
3216.088126,49,60,0.28,11,0.025454545,29
3216.077889,46,53,0.23,7,0.032857143,29
3215.92859,54,86,0.9,32,0.028125,29
3215.924224,42,65,0.75,23,0.032608696,29
3215.39502,70,95,0.46,25,0.0184,29
3215.079627,37,63,0.92,26,0.035384615,29
3214.915066,69,97,0.46,28,0.016428571,29
3214.915066,67,99,0.53,32,0.0165625,29
3214.617396,66,75,0.25,9,0.027777778,29
3214.106738,55,79,0.75,24,0.03125,29
3213.843725,39,69,0.97,30,0.032333333,29
3213.66834,57,87,0.8,30,0.026666667,29
3212.252469,42,56,0.48,14,0.034285714,29
3212.234183,40,55,0.53,15,0.035333333,29
3211.96722,67,73,0.17,6,0.028333333,29
3211.96722,60,81,0.59,21,0.028095238,29
3211.890363,40,49,0.33,9,0.036666667,29
3211.351994,54,90,0.98,36,0.027222222,29
3210.380945,53,88,0.97,35,0.027714286,29
3209.647707,41,52,0.41,11,0.037272727,29
3209.554899,61,82,0.55,21,0.026190476,29
3209.548869,35,57,0.86,22,0.039090909,29
3209.2313,62,73,0.32,11,0.029090909,29
3209.034317,43,50,0.26,7,0.037142857,29
3209.031415,55,73,0.62,18,0.034444444,29
3208.838998,44,56,0.39,12,0.0325,29
3207.09942,42,65,0.76,23,0.033043478,29
3206.945392,54,87,0.93,33,0.028181818,29
3206.945392,53,88,0.99,35,0.028285714,29
3206.823227,73,92,0.35,19,0.018421053,29
3206.143568,36,61,0.9,25,0.036,29
3206.109272,58,85,0.75,27,0.027777778,29
3206.063575,65,76,0.31,11,0.028181818,29
3205.585401,59,64,0.18,5,0.036,29
3205.457682,34,61,0.85,27,0.031481481,29
3205.456061,52,59,0.19,7,0.027142857,29
3205.411559,45,55,0.32,10,0.032,29
3205.323123,42,70,0.77,28,0.0275,29
3205.271157,32,59,0.98,27,0.036296296,29
3205.196959,33,59,0.98,26,0.037692308,29
3205.128819,46,64,0.52,18,0.028888889,29
3205.025916,43,52,0.33,9,0.036666667,29
3204.859249,34,56,0.78,22,0.035454545,29
3204.822076,55,69,0.5,14,0.035714286,29
3204.48835,63,78,0.41,15,0.027333333,29
3204.313263,59,83,0.68,24,0.028333333,29
3204.243421,59,77,0.52,18,0.028888889,29
3204.211131,59,83,0.65,24,0.027083333,29
3204.211131,56,87,0.83,31,0.026774194,29
3204.157977,57,82,0.71,25,0.0284,29
3204.157977,53,87,0.96,34,0.028235294,29
3203.960583,44,48,0.15,4,0.0375,29
3203.7715,36,61,0.87,25,0.0348,29
3203.769607,56,72,0.55,16,0.034375,29
3203.691994,54,88,0.96,34,0.028235294,29
3203.575216,67,72,0.14,5,0.028,29
3203.494689,40,56,0.58,16,0.03625,29
3203.494659,37,53,0.65,16,0.040625,29
3203.446406,39,69,0.98,30,0.032666667,29
3203.099147,44,67,0.67,23,0.029130435,29
3202.455383,41,67,0.85,26,0.032692308,29
3202.306124,53,72,0.67,19,0.035263158,29
3202.250555,58,70,0.41,12,0.034166667,29
3202.078905,60,82,0.61,22,0.027727273,29
3201.968287,54,85,0.88,31,0.028387097,29
3201.811631,38,62,0.85,24,0.035416667,29
3201.640771,42,50,0.31,8,0.03875,29
3201.569269,55,88,0.9,33,0.027272727,29
3201.421459,37,64,0.95,27,0.035185185,29
3201.073209,79,84,0.09,5,0.018,29
3200.720969,45,68,0.65,23,0.02826087,29
3200.597656,38,53,0.58,15,0.038666667,29
3200.56702,65,76,0.3,11,0.027272727,29
3200.55544,36,57,0.81,21,0.038571429,29
3200.447339,76,90,0.24,14,0.017142857,29
3200.447339,74,92,0.31,18,0.017222222,29
3200.426656,56,77,0.67,21,0.031904762,29
3200.049708,54,89,0.98,35,0.028,29
3200.030945,35,59,0.89,24,0.037083333,29
3199.813258,35,58,0.89,23,0.038695652,29
3199.627944,38,61,0.82,23,0.035652174,29
3199.612465,37,56,0.72,19,0.037894737,29
3199.383,53,85,0.93,32,0.0290625,29
3199.093807,53,88,0.98,35,0.028,29
3199.044839,54,90,0.97,36,0.026944444,29
3198.34409,40,58,0.63,18,0.035,29
3198.043357,67,74,0.19,7,0.027142857,29
3197.288083,39,53,0.53,14,0.037857143,29
3197.226847,57,71,0.48,14,0.034285714,29
3197.165183,58,85,0.72,27,0.026666667,29
3197.165183,55,89,0.9,34,0.026470588,29
3197.15942,39,59,0.7,20,0.035,29
3196.969004,38,53,0.59,15,0.039333333,29
3196.969004,37,54,0.67,17,0.039411765,29
3196.969004,36,55,0.75,19,0.039473684,29
3196.944519,37,59,0.8,22,0.036363636,29
3196.549746,35,62,0.89,27,0.032962963,29
3196.400296,57,85,0.77,28,0.0275,29
3196.156497,69,96,0.45,27,0.016666667,29
3195.853594,39,48,0.36,9,0.04,29
3195.254331,40,70,0.95,30,0.031666667,29
3195.088969,62,78,0.44,16,0.0275,29
3194.944683,41,58,0.6,17,0.035294118,29
3194.829233,39,62,0.78,23,0.033913043,29
3194.294994,58,87,0.74,29,0.025517241,29
3194.229887,54,69,0.54,15,0.036,29
3193.566181,35,55,0.73,20,0.0365,29
3193.550029,45,66,0.6,21,0.028571429,29
3193.406867,46,68,0.54,22,0.024545455,29
3193.312451,32,57,0.91,25,0.0364,29
3193.113987,56,83,0.76,27,0.028148148,29
3193.079601,47,65,0.51,18,0.028333333,29
3193.068691,39,52,0.45,13,0.034615385,29
3192.908413,63,70,0.22,7,0.031428571,29
3192.722569,60,82,0.62,22,0.028181818,29
3192.492411,40,52,0.45,12,0.0375,29
3192.243267,37,54,0.63,17,0.037058824,29
3192.243267,36,55,0.71,19,0.037368421,29
3192.145901,63,80,0.44,17,0.025882353,29
3192.145901,62,81,0.49,19,0.025789474,29
3191.763486,55,89,0.92,34,0.027058824,29
3191.506244,57,84,0.76,27,0.028148148,29
3191.506244,56,85,0.82,29,0.028275862,29
3191.128724,39,59,0.71,20,0.0355,29
3191.024416,37,56,0.71,19,0.037368421,29
3190.829144,41,73,0.89,32,0.0278125,29
3190.426744,41,50,0.31,9,0.034444444,29
3190.357454,63,78,0.42,15,0.028,29
3189.455463,42,57,0.51,15,0.034,29
3189.34433,43,71,0.75,28,0.026785714,29
3188.843672,40,68,0.91,28,0.0325,29
3187.911586,60,73,0.41,13,0.031538462,29
3187.836741,52,59,0.18,7,0.025714286,29
3187.575178,34,58,0.89,24,0.037083333,29
3187.382952,54,86,0.91,32,0.0284375,29
3186.951362,57,88,0.79,31,0.025483871,29
3186.595452,56,85,0.83,29,0.02862069,29
3186.331377,74,89,0.27,15,0.018,29
3186.186301,52,72,0.72,20,0.036,29
3186.099072,34,63,0.98,29,0.033793103,29
3186.034302,52,87,0.98,35,0.028,29
3186.034302,52,88,0.99,36,0.0275,29
3185.801575,55,68,0.47,13,0.036153846,29
3185.78655,43,68,0.72,25,0.0288,29
3185.267416,45,68,0.58,23,0.025217391,29
3185.148948,41,58,0.58,17,0.034117647,29
3185.088009,46,49,0.11,3,0.036666667,29
3184.961336,39,56,0.62,17,0.036470588,29
3184.898974,66,99,0.61,33,0.018484848,29
3184.601431,41,59,0.6,18,0.033333333,29
3184.413813,38,49,0.44,11,0.04,29
3184.349714,51,73,0.79,22,0.035909091,29
3184.017564,69,98,0.5,29,0.017241379,29
3183.914643,57,85,0.78,28,0.027857143,29
3183.812748,40,51,0.38,11,0.034545455,29
3183.801681,50,63,0.31,13,0.023846154,29
3183.746598,76,87,0.2,11,0.018181818,29
3183.746598,73,90,0.31,17,0.018235294,29
3183.692153,63,79,0.43,16,0.026875,29
3183.614126,57,82,0.7,25,0.028,29
3183.589102,70,94,0.45,24,0.01875,29
3182.651971,61,81,0.54,20,0.027,29
3182.651971,57,86,0.78,29,0.026896552,29
3182.449303,35,62,0.96,27,0.035555556,29
3181.644616,41,71,0.82,30,0.027333333,29
3181.578493,37,55,0.67,18,0.037222222,29
3181.363183,56,68,0.43,12,0.035833333,29
3181.243614,39,60,0.6,21,0.028571429,29
3181.18207,53,82,0.89,29,0.030689655,29
3181.005924,34,63,0.97,29,0.033448276,29
3180.963232,54,71,0.6,17,0.035294118,29
3180.859742,55,90,0.93,35,0.026571429,29
3180.612976,44,49,0.17,5,0.034,29
3180.297217,42,46,0.16,4,0.04,29
3180.297217,41,47,0.24,6,0.04,29
3179.132315,37,50,0.52,13,0.04,29
3179.082964,41,55,0.5,14,0.035714286,29
3178.766788,44,55,0.38,11,0.034545455,29
3178.745326,36,57,0.68,21,0.032380952,29
3178.60065,60,68,0.27,8,0.03375,29
3178.5177,55,88,0.92,33,0.027878788,29
3178.246199,37,58,0.71,21,0.033809524,29
3177.894745,36,57,0.79,21,0.037619048,29
3176.571832,55,88,0.93,33,0.028181818,29
3176.544893,73,94,0.36,21,0.017142857,29
3176.464029,68,74,0.16,6,0.026666667,29
3176.464029,65,77,0.32,12,0.026666667,29
3176.338939,37,55,0.62,18,0.034444444,29
3176.266606,43,45,0.08,2,0.04,29
3175.499905,26,90,0.23,64,0.00359375,29
3175.191944,33,58,0.91,25,0.0364,29
3175.153841,68,96,0.51,28,0.018214286,29
3174.951271,43,64,0.69,21,0.032857143,29
3174.951271,42,66,0.78,24,0.0325,29
3174.821773,35,63,0.99,28,0.035357143,29
3174.261913,40,55,0.54,15,0.036,29
3173.836846,24,95,0.19,71,0.002676056,29
3173.638972,53,86,0.95,33,0.028787879,29
3173.624529,34,59,0.94,25,0.0376,29
3173.564709,39,56,0.61,17,0.035882353,29
3173.460349,36,60,0.79,24,0.032916667,29
3173.40188,75,89,0.25,14,0.017857143,29
3173.390608,69,95,0.49,26,0.018846154,29
3173.145338,35,60,0.93,25,0.0372,29
3172.837435,56,87,0.88,31,0.028387097,29
3172.467875,54,88,0.97,34,0.028529412,29
3172.293279,35,60,0.94,25,0.0376,29
3172.25767,56,86,0.84,30,0.028,29
3172.25767,55,87,0.9,32,0.028125,29
3171.851534,58,75,0.54,17,0.031764706,29
3171.837062,45,67,0.59,22,0.026818182,29
3171.800781,62,72,0.29,10,0.029,29
3171.800781,61,73,0.35,12,0.029166667,29
3171.698933,43,64,0.7,21,0.033333333,29
3171.581792,38,57,0.64,19,0.033684211,29
3171.496169,56,87,0.84,31,0.027096774,29
3171.353643,44,66,0.7,22,0.031818182,29
3171.321752,52,73,0.75,21,0.035714286,29
3171.321752,51,74,0.82,23,0.035652174,29
3170.877771,63,73,0.28,10,0.028,29
3170.877771,60,77,0.47,17,0.027647059,29
3170.772646,32,57,0.96,25,0.0384,29
3170.672492,40,72,0.91,32,0.0284375,29
3170.612786,42,73,0.82,31,0.026451613,29
3170.396216,60,74,0.41,14,0.029285714,29
3170.344705,69,96,0.5,27,0.018518519,29
3170.25601,68,99,0.53,31,0.017096774,29
3170.18739,33,60,0.89,27,0.032962963,29
3170.186006,36,60,0.86,24,0.035833333,29
3170.144271,69,99,0.51,30,0.017,29
3170.081944,75,92,0.29,17,0.017058824,29
3169.966575,72,92,0.36,20,0.018,29
3169.952886,53,87,0.95,34,0.027941176,29
3169.16503,59,69,0.34,10,0.034,29
3168.781572,34,59,0.95,25,0.038,29
3168.431833,62,80,0.49,18,0.027222222,29
3167.805437,38,60,0.79,22,0.035909091,29
3167.62361,36,59,0.86,23,0.037391304,29
3167.554394,57,67,0.36,10,0.036,29
3167.532498,39,51,0.48,12,0.04,29
3167.338436,51,75,0.84,24,0.035,29
3166.852243,44,67,0.66,23,0.028695652,29
3166.820006,56,88,0.87,32,0.0271875,29
3166.820006,55,89,0.93,34,0.027352941,29
3166.677629,38,54,0.62,16,0.03875,29
3166.542264,52,84,0.96,32,0.03,29
3166.210294,35,53,0.66,18,0.036666667,29
3165.960869,52,72,0.71,20,0.0355,29
3165.896252,64,68,0.13,4,0.0325,29
3165.896252,62,70,0.26,8,0.0325,29
3165.820651,55,87,0.89,32,0.0278125,29
3165.724691,33,60,0.9,27,0.033333333,29
3165.295061,67,98,0.56,31,0.018064516,29
3165.27529,35,55,0.74,20,0.037,29
3165.08119,66,76,0.27,10,0.027,29
3165.08119,64,78,0.38,14,0.027142857,29
3165.078448,57,86,0.81,29,0.027931034,29
3165.078448,56,87,0.87,31,0.028064516,29
3164.849159,62,80,0.5,18,0.027777778,29
3164.409729,33,60,0.88,27,0.032592593,29
3164.324339,36,63,0.94,27,0.034814815,29
3163.795106,41,54,0.47,13,0.036153846,29
3163.625181,35,56,0.84,21,0.04,29
3163.619322,59,85,0.67,26,0.025769231,29
3162.704377,33,57,0.88,24,0.036666667,29
3162.540583,50,75,0.89,25,0.0356,29
3162.540583,50,76,0.92,26,0.035384615,29
3162.540583,49,77,0.99,28,0.035357143,29
3162.205337,39,53,0.54,14,0.038571429,29
3162.088792,45,50,0.18,5,0.036,29
3161.802337,43,71,0.78,28,0.027857143,29
3161.802337,42,72,0.84,30,0.028,29
3161.784193,26,89,0.24,63,0.003809524,29
3161.697587,48,59,0.36,11,0.032727273,29
3161.689218,54,70,0.57,16,0.035625,29
3161.689218,49,76,0.96,27,0.035555556,29
3161.430868,61,79,0.5,18,0.027777778,29
3161.264647,71,93,0.4,22,0.018181818,29
3161.261323,68,97,0.54,29,0.01862069,29
3161.055726,37,60,0.8,23,0.034782609,29
3160.905299,40,54,0.49,14,0.035,29
3160.65679,77,87,0.18,10,0.018,29
3160.599033,45,65,0.58,20,0.029,29
3160.125763,41,57,0.46,16,0.02875,29
3159.847975,59,88,0.58,29,0.02,29
3159.724831,35,62,0.98,27,0.036296296,29
3159.708924,47,56,0.28,9,0.031111111,29
3159.32817,42,53,0.4,11,0.036363636,29
3159.318458,43,57,0.48,14,0.034285714,29
3159.318458,42,58,0.55,16,0.034375,29
3158.9305,37,51,0.54,14,0.038571429,29
3158.573704,47,59,0.4,12,0.033333333,29
3157.736871,43,50,0.24,7,0.034285714,29
3157.573987,40,67,0.88,27,0.032592593,29
3157.265421,40,68,0.9,28,0.032142857,29
3157.075225,43,44,0.04,1,0.04,29
3157.075225,42,45,0.12,3,0.04,29
3156.982487,36,62,0.92,26,0.035384615,29
3156.777125,71,94,0.41,23,0.017826087,29
3156.500337,41,46,0.2,5,0.04,29
3156.500337,40,47,0.28,7,0.04,29
3155.849196,76,88,0.2,12,0.016666667,29
3155.696396,52,60,0.19,8,0.02375,29
3155.53958,33,56,0.88,23,0.03826087,29
3155.12081,40,57,0.6,17,0.035294118,29
3154.881011,51,72,0.76,21,0.036190476,29
3154.833028,52,73,0.74,21,0.035238095,29
3154.635529,39,60,0.75,21,0.035714286,29
3154.452855,71,95,0.39,24,0.01625,29
3154.05817,39,70,0.99,31,0.031935484,29
3153.731454,44,62,0.6,18,0.033333333,29
3153.695118,72,94,0.38,22,0.017272727,29
3153.689981,39,48,0.35,9,0.038888889,29
3153.571365,51,54,0.08,3,0.026666667,29
3153.035126,61,81,0.56,20,0.028,29
3152.696791,37,54,0.59,17,0.034705882,29
3152.637482,58,84,0.71,26,0.027307692,29
3152.630971,39,60,0.73,21,0.034761905,29
3152.417123,52,83,0.95,31,0.030645161,29
3151.406117,34,63,0.96,29,0.033103448,29
3151.317194,44,63,0.62,19,0.032631579,29
3150.836985,46,65,0.53,19,0.027894737,29
3150.611265,57,89,0.81,32,0.0253125,29
3150.611265,56,91,0.88,35,0.025142857,29
3150.611265,55,92,0.93,37,0.025135135,29
3150.367185,38,58,0.72,20,0.036,29
3150.28007,69,98,0.47,29,0.016206897,29
3150.119263,33,62,0.92,29,0.031724138,29
3150.053538,53,71,0.64,18,0.035555556,29
3149.911577,51,74,0.81,23,0.035217391,29
3149.354404,55,89,0.94,34,0.027647059,29
3149.207657,40,47,0.26,7,0.037142857,29
3148.719547,32,58,0.96,26,0.036923077,29
3148.401113,59,75,0.47,16,0.029375,29
3148.401113,58,76,0.53,18,0.029444444,29
3148.134718,39,61,0.75,22,0.034090909,29
3147.959533,36,56,0.72,20,0.036,29
3147.951821,64,79,0.39,15,0.026,29
3147.676627,40,51,0.4,11,0.036363636,29
3147.431292,49,64,0.36,15,0.024,29
3147.124542,39,68,0.96,29,0.033103448,29
3147.1202,55,70,0.53,15,0.035333333,29
3146.722284,54,89,0.97,35,0.027714286,29
3146.314409,42,52,0.36,10,0.036,29
3146.22757,46,60,0.47,14,0.033571429,29
3146.185835,50,60,0.29,10,0.029,29
3146.177643,36,53,0.65,17,0.038235294,29
3146.048527,79,85,0.1,6,0.016666667,29
3146.0014,34,54,0.71,20,0.0355,29
3145.60886,60,72,0.39,12,0.0325,29
3144.938642,35,61,0.9,26,0.034615385,29
3144.895469,44,63,0.63,19,0.033157895,29
3144.852713,54,71,0.61,17,0.035882353,29
3144.801211,38,59,0.75,21,0.035714286,29
3144.701932,39,55,0.54,16,0.03375,29
3144.529809,52,71,0.68,19,0.035789474,29
3144.491534,78,86,0.15,8,0.01875,29
3144.461434,39,57,0.53,18,0.029444444,29
3144.332388,44,68,0.68,24,0.028333333,29
3144.20277,41,66,0.82,25,0.0328,29
3144.167815,69,95,0.47,26,0.018076923,29
3143.871697,51,60,0.26,9,0.028888889,29
3143.857855,41,52,0.43,11,0.039090909,29
3143.706316,39,53,0.55,14,0.039285714,29
3143.626993,33,66,0.99,33,0.03,29
3143.187567,36,51,0.56,15,0.037333333,29
3143.118542,41,53,0.42,12,0.035,29
3143.085112,35,63,0.83,28,0.029642857,29
3142.667235,41,74,0.91,33,0.027575758,29
3142.648661,34,56,0.82,22,0.037272727,29
3142.648661,33,57,0.9,24,0.0375,29
3142.413547,36,63,0.96,27,0.035555556,29
3142.131599,44,63,0.54,19,0.028421053,29
3142.018922,64,76,0.25,12,0.020833333,29
3141.888029,34,59,0.85,25,0.034,29
3141.357133,70,94,0.43,24,0.017916667,29
3141.357133,66,99,0.59,33,0.017878788,29
3141.07758,40,51,0.41,11,0.037272727,29
3141.033002,70,96,0.46,26,0.017692308,29
3140.922325,35,62,0.97,27,0.035925926,29
3140.908601,71,97,0.44,26,0.016923077,29
3140.536673,44,56,0.41,12,0.034166667,29
3140.353439,37,52,0.57,15,0.038,29
3140.314383,42,52,0.38,10,0.038,29
3139.944276,55,87,0.91,32,0.0284375,29
3139.82186,37,58,0.7,21,0.033333333,29
3139.754133,55,83,0.63,28,0.0225,29
3139.565242,43,50,0.25,7,0.035714286,29
3139.179761,38,54,0.61,16,0.038125,29
3139.098626,35,60,0.95,25,0.038,29
3138.830101,35,61,0.86,26,0.033076923,29
3138.474309,43,69,0.86,26,0.033076923,29
3138.318681,62,79,0.35,17,0.020588235,29
3138.132423,38,53,0.52,15,0.034666667,29
3138.078811,45,67,0.56,22,0.025454545,29
3138.050892,32,58,0.98,26,0.037692308,29
3137.410092,32,59,0.99,27,0.036666667,29
3137.369081,56,88,0.88,32,0.0275,29
3137.181202,36,65,0.82,29,0.028275862,29
3137.109725,42,49,0.27,7,0.038571429,29
3137.100675,41,54,0.46,13,0.035384615,29
3137.038036,72,93,0.39,21,0.018571429,29
3136.827836,31,58,0.98,27,0.036296296,29
3136.756781,34,55,0.8,21,0.038095238,29
3136.477778,37,51,0.55,14,0.039285714,29
3136.477778,36,52,0.63,16,0.039375,29
3136.415729,50,76,0.91,26,0.035,29
3136.415729,49,77,0.98,28,0.035,29
3136.178317,44,61,0.49,17,0.028823529,29
3135.977622,41,68,0.87,27,0.032222222,29
3135.657344,33,61,0.89,28,0.031785714,29
3134.980422,33,57,0.89,24,0.037083333,29
3134.885911,35,53,0.72,18,0.04,29
3134.774793,48,64,0.44,16,0.0275,29
3134.682602,73,92,0.34,19,0.017894737,29
3133.828093,37,63,0.74,26,0.028461538,29
3133.784057,34,58,0.84,24,0.035,29
3133.782955,52,88,0.98,36,0.027222222,29
3133.525401,68,99,0.54,31,0.017419355,29
3133.273268,40,76,0.98,36,0.027222222,29
3133.230595,38,62,0.82,24,0.034166667,29
3133.024136,40,54,0.47,14,0.033571429,29
3132.808246,56,90,0.86,34,0.025294118,29
3132.808246,54,93,0.98,39,0.025128205,29
3132.502746,44,51,0.26,7,0.037142857,29
3132.502746,42,53,0.41,11,0.037272727,29
3132.429984,53,72,0.68,19,0.035789474,29
3132.162087,37,58,0.72,21,0.034285714,29
3131.997352,61,72,0.35,11,0.031818182,29
3131.911084,40,67,0.89,27,0.032962963,29
3131.74869,41,66,0.83,25,0.0332,29
3131.747982,42,51,0.32,9,0.035555556,29
3131.651854,58,65,0.25,7,0.035714286,29
3131.600088,69,96,0.48,27,0.017777778,29
3131.510697,57,66,0.32,9,0.035555556,29
3131.414827,60,82,0.6,22,0.027272727,29
3131.349648,69,74,0.13,5,0.026,29
3131.183259,39,48,0.34,9,0.037777778,29
3131.133675,35,62,0.9,27,0.033333333,29
3130.798967,50,56,0.2,6,0.033333333,29
3130.798967,47,60,0.43,13,0.033076923,29
3130.690976,41,53,0.46,12,0.038333333,29
3130.427992,24,95,0.2,71,0.002816901,29
3130.261491,35,61,0.89,26,0.034230769,29
3129.960949,41,52,0.39,11,0.035454545,29
3129.67941,34,67,0.94,33,0.028484848,29
3129.281734,35,61,0.88,26,0.033846154,29
3129.251158,34,56,0.81,22,0.036818182,29
3129.239341,65,78,0.34,13,0.026153846,29
3128.660928,50,55,0.14,5,0.028,29
3128.579372,57,85,0.79,28,0.028214286,29
3128.494025,50,77,0.94,27,0.034814815,29
3128.215971,57,84,0.77,27,0.028518519,29
3128.215971,56,86,0.85,30,0.028333333,29
3128.150663,70,97,0.47,27,0.017407407,29
3128.004541,38,57,0.69,19,0.036315789,29
3127.753872,37,54,0.68,17,0.04,29
3127.31182,37,62,0.88,25,0.0352,29
3127.122239,43,64,0.6,21,0.028571429,29
3126.802728,44,56,0.34,12,0.028333333,29
3126.43401,32,62,0.96,30,0.032,29
3126.081821,42,71,0.82,29,0.028275862,29
3126.06831,57,77,0.59,20,0.0295,29
3125.709729,67,99,0.57,32,0.0178125,29
3125.675774,35,52,0.63,17,0.037058824,29
3125.650142,27,87,0.21,60,0.0035,29
3125.295324,43,63,0.67,20,0.0335,29
3124.84738,37,55,0.69,18,0.038333333,29
3124.764343,36,59,0.77,23,0.033478261,29
3124.596313,71,99,0.47,28,0.016785714,29
3123.988901,67,75,0.21,8,0.02625,29
3123.822727,54,85,0.89,31,0.028709677,29
3123.753211,58,67,0.32,9,0.035555556,29
3123.753211,57,68,0.39,11,0.035454545,29
3123.753211,56,69,0.46,13,0.035384615,29
3123.753211,51,75,0.85,24,0.035416667,29
3123.410782,72,91,0.35,19,0.018421053,29
3123.360282,54,72,0.63,18,0.035,29
3123.360282,53,73,0.7,20,0.035,29
3123.360282,52,74,0.77,22,0.035,29
3123.069972,46,67,0.57,21,0.027142857,29
3123.022438,36,56,0.79,20,0.0395,29
3122.890142,33,60,0.93,27,0.034444444,29
3122.376528,61,80,0.54,19,0.028421053,29
3122.257332,24,94,0.2,70,0.002857143,29
3122.046863,71,95,0.42,24,0.0175,29
3121.313874,39,52,0.51,13,0.039230769,29
3120.910017,37,55,0.65,18,0.036111111,29
3120.899605,61,83,0.44,22,0.02,29
3120.661378,43,58,0.51,15,0.034,29
3120.622622,39,61,0.77,22,0.035,29
3120.31282,31,58,0.96,27,0.035555556,29
3120.277903,33,55,0.83,22,0.037727273,29
3120.111404,36,60,0.8,24,0.033333333,29
3120.067221,65,77,0.33,12,0.0275,29
3120.067221,63,79,0.44,16,0.0275,29
3119.98634,34,60,0.87,26,0.033461538,29
3119.858477,59,81,0.63,22,0.028636364,29
3119.798903,58,85,0.76,27,0.028148148,29
3119.761225,68,97,0.52,29,0.017931034,29
3119.703117,36,63,0.95,27,0.035185185,29
3119.63233,54,89,0.9,35,0.025714286,29
3119.429563,63,81,0.46,18,0.025555556,29
3119.24778,41,65,0.81,24,0.03375,29
3119.082752,62,81,0.5,19,0.026315789,29
3119.028831,54,91,0.99,37,0.026756757,29
3118.897141,45,69,0.61,24,0.025416667,29
3118.85159,33,61,0.94,28,0.033571429,29
3118.838296,45,54,0.29,9,0.032222222,29
3118.458173,40,71,0.89,31,0.028709677,29
3118.371003,41,53,0.41,12,0.034166667,29
3117.722934,36,60,0.82,24,0.034166667,29
3117.360711,60,84,0.48,24,0.02,29
3117.281461,34,64,0.92,30,0.030666667,29
3117.144047,26,89,0.23,63,0.003650794,29
3116.898703,37,55,0.71,18,0.039444444,29
3116.765881,34,62,0.93,28,0.033214286,29
3116.670678,59,82,0.65,23,0.02826087,29
3116.660993,39,58,0.68,19,0.035789474,29
3116.385329,37,62,0.87,25,0.0348,29
3116.308617,58,83,0.71,25,0.0284,29
3116.156994,42,71,0.81,29,0.027931034,29
3115.532297,34,64,0.93,30,0.031,29
3115.480011,41,50,0.35,9,0.038888889,29
3115.068233,59,77,0.41,18,0.022777778,29
3114.923255,60,81,0.6,21,0.028571429,29
3114.885559,45,62,0.56,17,0.032941176,29
3114.477339,55,90,0.94,35,0.026857143,29
3113.793663,38,61,0.81,23,0.035217391,29
3113.691835,40,73,0.94,33,0.028484848,29
3113.66618,38,58,0.71,20,0.0355,29
3113.490266,42,69,0.77,27,0.028518519,29
3113.490266,41,70,0.83,29,0.02862069,29
3112.81522,53,78,0.84,25,0.0336,29
3112.732819,61,83,0.57,22,0.025909091,29
3112.28657,50,73,0.83,23,0.036086957,29
3112.28657,49,74,0.9,25,0.036,29
3112.25282,62,82,0.51,20,0.0255,29
3111.797639,71,93,0.37,22,0.016818182,29
3111.443649,34,59,0.83,25,0.0332,29
3110.480995,49,61,0.35,12,0.029166667,29
3110.110647,62,82,0.4,20,0.02,29
3109.981386,78,91,0.22,13,0.016923077,29
3109.897965,74,96,0.37,22,0.016818182,29
3109.795915,50,56,0.17,6,0.028333333,29
3109.299011,68,99,0.51,31,0.016451613,29
3109.202543,42,68,0.83,26,0.031923077,29
3108.925155,56,86,0.65,30,0.021666667,29
3108.887345,60,84,0.62,24,0.025833333,29
3108.700919,41,59,0.62,18,0.034444444,29
3108.476819,72,93,0.38,21,0.018095238,29
3108.476819,68,98,0.54,30,0.018,29
3108.344714,44,50,0.22,6,0.036666667,29
3107.994601,54,86,0.87,32,0.0271875,29
3107.927571,52,79,0.91,27,0.033703704,29
3107.927571,51,80,0.98,29,0.033793103,29
3107.87841,37,61,0.85,24,0.035416667,29
3107.706409,54,77,0.77,23,0.033478261,29
3106.96103,43,46,0.11,3,0.036666667,29
3106.959787,46,67,0.55,21,0.026190476,29
3106.474,36,52,0.64,16,0.04,29
3106.287733,38,57,0.65,19,0.034210526,29
3106.284807,37,54,0.58,17,0.034117647,29
3106.239876,66,99,0.6,33,0.018181818,29
3106.105953,33,59,0.93,26,0.035769231,29
3105.637784,67,73,0.16,6,0.026666667,29
3105.637784,64,76,0.32,12,0.026666667,29
3105.488053,45,55,0.35,10,0.035,29
3105.303221,55,88,0.91,33,0.027575758,29
3104.653468,44,69,0.68,25,0.0272,29
3104.634985,40,54,0.54,14,0.038571429,29
3104.578152,38,60,0.64,22,0.029090909,29
3104.32791,42,69,0.85,27,0.031481481,29
3104.027425,36,51,0.61,15,0.040666667,29
3103.920695,53,92,0.99,39,0.025384615,29
3103.895992,41,53,0.44,12,0.036666667,29
3103.682791,33,62,0.96,29,0.033103448,29
3103.463893,37,61,0.86,24,0.035833333,29
3102.856215,52,80,0.93,28,0.033214286,29
3102.620223,52,85,0.94,33,0.028484848,29
3102.332808,69,97,0.5,28,0.017857143,29
3101.83732,32,56,0.94,24,0.039166667,29
3101.594049,38,47,0.37,9,0.041111111,29
3101.401326,40,75,0.96,35,0.027428571,29
3101.034128,64,78,0.39,14,0.027857143,29
3101.012696,45,68,0.61,23,0.026521739,29
3100.875919,45,60,0.43,15,0.028666667,29
3100.737842,33,61,0.92,28,0.032857143,29
3100.718955,38,54,0.6,16,0.0375,29
3100.645235,32,61,0.99,29,0.034137931,29
3100.546459,50,76,0.93,26,0.035769231,29
3100.20017,60,77,0.38,17,0.022352941,29
3100.033332,64,81,0.34,17,0.02,29
3100.033332,63,82,0.38,19,0.02,29
3099.92021,42,65,0.66,23,0.028695652,29
3099.509189,33,55,0.84,22,0.038181818,29
3099.507353,35,53,0.71,18,0.039444444,29
3099.334086,40,52,0.47,12,0.039166667,29
3099.318062,41,55,0.51,14,0.036428571,29
3099.280547,37,53,0.55,16,0.034375,29
3098.978392,44,69,0.65,25,0.026,29
3098.752838,62,82,0.52,20,0.026,29
3098.752838,58,87,0.75,29,0.025862069,29
3098.206302,37,62,0.72,25,0.0288,29
3098.111381,36,60,0.81,24,0.03375,29
3097.991311,34,56,0.83,22,0.037727273,29
3097.991311,33,57,0.91,24,0.037916667,29
3097.991311,32,58,0.99,26,0.038076923,29
3097.920226,42,67,0.8,25,0.032,29
3097.90483,53,87,0.93,34,0.027352941,29
3097.791418,37,55,0.68,18,0.037777778,29
3097.416593,55,89,0.95,34,0.027941176,29
3097.261533,26,88,0.25,62,0.004032258,29
3097.144528,32,56,0.97,24,0.040416667,29
3097.07794,36,53,0.62,17,0.036470588,29
3097.041481,38,65,0.9,27,0.033333333,29
3096.988806,38,61,0.66,23,0.028695652,29
3096.868749,44,64,0.65,20,0.0325,29
3096.677893,65,79,0.29,14,0.020714286,29
3096.615469,42,57,0.53,15,0.035333333,29
3096.069338,55,90,0.95,35,0.027142857,29
3095.692656,49,57,0.21,8,0.02625,29
3095.682698,62,79,0.48,17,0.028235294,29
3095.682698,59,83,0.67,24,0.027916667,29
3095.682698,58,84,0.73,26,0.028076923,29
3095.606969,74,90,0.29,16,0.018125,29
3095.548889,48,52,0.13,4,0.0325,29
3095.536282,49,51,0.07,2,0.035,29
3095.536282,48,52,0.14,4,0.035,29
3095.536282,47,53,0.21,6,0.035,29
3095.506927,40,74,0.95,34,0.027941176,29
3095.090514,34,62,0.97,28,0.034642857,29
3094.964668,40,54,0.48,14,0.034285714,29
3094.624072,56,82,0.58,26,0.022307692,29
3094.618692,36,56,0.77,20,0.0385,29
3094.481423,42,72,0.83,30,0.027666667,29
3094.118838,37,50,0.5,13,0.038461538,29
3094.074245,35,51,0.65,16,0.040625,29
3093.799202,42,64,0.74,22,0.033636364,29
3093.551043,39,62,0.79,23,0.034347826,29
3093.080227,59,66,0.25,7,0.035714286,29
3092.994037,37,60,0.69,23,0.03,29
3092.914882,38,60,0.78,22,0.035454545,29
3092.909047,68,98,0.53,30,0.017666667,29
3092.79511,35,58,0.75,23,0.032608696,29
3092.358067,33,60,0.97,27,0.035925926,29
3091.837004,41,59,0.51,18,0.028333333,29
3091.494398,40,58,0.52,18,0.028888889,29
3091.381417,37,57,0.75,20,0.0375,29
3091.322266,32,56,0.89,24,0.037083333,29
3091.289205,44,57,0.41,13,0.031538462,29
3091.068865,47,53,0.17,6,0.028333333,29
3090.839606,39,55,0.6,16,0.0375,29
3090.661174,33,65,0.99,32,0.0309375,29
3090.654165,44,66,0.64,22,0.029090909,29
3090.643651,48,59,0.3,11,0.027272727,29
3090.423504,71,94,0.42,23,0.01826087,29
3090.361357,34,59,0.97,25,0.0388,29
3090.218756,35,53,0.64,18,0.035555556,29
3090.091339,44,52,0.29,8,0.03625,29
3089.544799,36,60,0.87,24,0.03625,29
3089.494721,42,66,0.68,24,0.028333333,29
3089.216252,62,83,0.42,21,0.02,29
3088.772529,55,70,0.54,15,0.036,29
3088.75295,33,61,0.91,28,0.0325,29
3088.692135,59,85,0.68,26,0.026153846,29
3088.395945,55,87,0.83,32,0.0259375,29
3088.395945,53,90,0.95,37,0.025675676,29
3088.073112,36,62,0.93,26,0.035769231,29
3087.93721,60,84,0.64,24,0.026666667,29
3087.721735,58,85,0.57,27,0.021111111,29
3087.682046,55,91,0.93,36,0.025833333,29
3087.516196,44,65,0.68,21,0.032380952,29
3087.482254,37,60,0.83,23,0.036086957,29
3087.459698,71,73,0.04,2,0.02,29
3087.459698,70,74,0.08,4,0.02,29
3087.459698,69,75,0.12,6,0.02,29
3087.459698,68,76,0.16,8,0.02,29
3087.459698,67,77,0.2,10,0.02,29
3087.459698,66,78,0.24,12,0.02,29
3087.459698,65,79,0.28,14,0.02,29
3086.848456,39,52,0.48,13,0.036923077,29
3086.848456,38,53,0.56,15,0.037333333,29
3086.848456,37,55,0.66,18,0.036666667,29
3086.526756,36,65,0.98,29,0.033793103,29
3086.342051,54,89,0.96,35,0.027428571,29
3086.297907,71,92,0.4,21,0.019047619,29
3086.237296,60,84,0.5,24,0.020833333,29
3086.188015,37,64,0.76,27,0.028148148,29
3085.842235,56,88,0.89,32,0.0278125,29
3085.638005,37,66,0.98,29,0.033793103,29
3085.467325,43,56,0.46,13,0.035384615,29
3085.456137,26,90,0.19,64,0.00296875,29
3085.378368,55,89,0.96,34,0.028235294,29
3084.718638,66,73,0.19,7,0.027142857,29
3084.542767,66,76,0.26,10,0.026,29
3084.467018,48,60,0.31,12,0.025833333,29
3084.389411,56,87,0.85,31,0.027419355,29
3084.368556,38,51,0.47,13,0.036153846,29
3084.3019,37,50,0.54,13,0.041538462,29
3083.889577,74,91,0.28,17,0.016470588,29
3083.454932,36,54,0.71,18,0.039444444,29
3083.213429,36,64,0.8,28,0.028571429,29
3083.163299,36,56,0.78,20,0.039,29
3082.887945,37,50,0.53,13,0.040769231,29
3082.329807,36,56,0.74,20,0.037,29
3082.329807,35,57,0.82,22,0.037272727,29
3082.252706,65,79,0.36,14,0.025714286,29
3082.031905,61,82,0.56,21,0.026666667,29
3081.96283,36,58,0.83,22,0.037727273,29
3081.883173,41,51,0.39,10,0.039,29
3081.87002,28,86,0.19,58,0.003275862,29
3081.860177,48,53,0.17,5,0.034,29
3081.690177,59,86,0.69,27,0.025555556,29
3081.690177,56,90,0.87,34,0.025588235,29
3081.626949,34,59,0.9,25,0.036,29
3081.532229,73,93,0.33,20,0.0165,29
3081.490099,35,58,0.87,23,0.037826087,29
3081.48569,28,86,0.18,58,0.003103448,29
3081.452913,37,48,0.46,11,0.041818182,29
3081.452913,35,50,0.63,15,0.042,29
3081.171611,32,58,0.97,26,0.037307692,29
3080.938182,41,71,0.87,30,0.029,29
3080.938182,40,72,0.93,32,0.0290625,29
3080.338985,45,54,0.25,9,0.027777778,29
3080.317876,47,62,0.48,15,0.032,29
3080.317876,45,64,0.61,19,0.032105263,29
3080.294126,34,58,0.81,24,0.03375,29
3079.942949,53,87,0.97,34,0.028529412,29
3079.906884,39,73,0.97,34,0.028529412,29
3079.898608,63,74,0.24,11,0.021818182,29
3079.89777,53,90,0.96,37,0.025945946,29
3079.89777,53,91,0.97,38,0.025526316,29
3079.803389,60,83,0.62,23,0.026956522,29
3079.780959,38,56,0.61,18,0.033888889,29
3079.721043,37,54,0.64,17,0.037647059,29
3079.529924,38,56,0.68,18,0.037777778,29
3079.371557,38,54,0.55,16,0.034375,29
3079.117861,45,55,0.33,10,0.033,29
3078.895777,71,93,0.41,22,0.018636364,29
3078.750027,45,68,0.6,23,0.026086957,29
3078.749256,70,94,0.44,24,0.018333333,29
3078.736324,45,59,0.43,14,0.030714286,29
3078.59298,57,88,0.8,31,0.025806452,29
3078.530703,34,54,0.8,20,0.04,29
3078.438586,64,80,0.32,16,0.02,29
3078.307813,33,67,0.97,34,0.028529412,29
3077.81879,42,49,0.26,7,0.037142857,29
3077.620556,58,84,0.74,26,0.028461538,29
3077.448804,58,89,0.63,31,0.020322581,29
3077.446287,53,79,0.86,26,0.033076923,29
3077.259202,34,57,0.85,23,0.036956522,29
3076.98021,52,74,0.78,22,0.035454545,29
3076.641832,39,53,0.48,14,0.034285714,29
3076.53286,40,56,0.59,16,0.036875,29
3076.530494,58,70,0.39,12,0.0325,29
3076.466645,55,90,0.96,35,0.027428571,29
3076.308613,36,51,0.6,15,0.04,29
3076.277679,54,90,0.92,36,0.025555556,29
3076.147127,55,88,0.7,33,0.021212121,29
3076.031792,46,66,0.51,20,0.0255,29
3075.767096,36,57,0.71,21,0.033809524,29
3075.713984,70,95,0.45,25,0.018,29
3075.605381,38,49,0.45,11,0.040909091,29
3075.542274,36,61,0.89,25,0.0356,29
3075.504941,38,57,0.66,19,0.034736842,29
3075.504941,37,58,0.73,21,0.034761905,29
3075.431411,46,61,0.49,15,0.032666667,29
3075.067686,47,57,0.29,10,0.029,29
3074.984738,54,79,0.8,25,0.032,29
3074.835149,50,77,0.95,27,0.035185185,29
3074.720542,70,93,0.44,23,0.019130435,29
3074.697862,57,80,0.52,23,0.022608696,29
3074.663087,33,54,0.8,21,0.038095238,29
3074.394261,54,89,0.99,35,0.028285714,29
3074.072612,41,71,0.86,30,0.028666667,29
3074.041018,52,81,0.93,29,0.032068966,29
3073.889128,35,58,0.83,23,0.036086957,29
3073.798164,45,63,0.58,18,0.032222222,29
3073.798164,43,65,0.71,22,0.032272727,29
3073.466781,45,58,0.36,13,0.027692308,29
3073.380133,62,82,0.53,20,0.0265,29
3073.3622,64,73,0.25,9,0.027777778,29
3073.317049,39,50,0.4,11,0.036363636,29
3073.093274,32,64,0.98,32,0.030625,29
3072.829784,46,63,0.45,17,0.026470588,29
3072.76988,58,87,0.59,29,0.020344828,29
3072.55444,36,56,0.66,20,0.033,29
3072.23521,34,62,0.96,28,0.034285714,29
3072.137141,59,78,0.54,19,0.028421053,29
3071.932194,38,54,0.63,16,0.039375,29
3071.780084,36,59,0.8,23,0.034782609,29
3071.590748,55,82,0.76,27,0.028148148,29
3071.590748,54,83,0.82,29,0.028275862,29
3071.250378,37,59,0.79,22,0.035909091,29
3071.047319,72,94,0.36,22,0.016363636,29
3070.761408,46,60,0.4,14,0.028571429,29
3070.640445,39,46,0.29,7,0.041428571,29
3070.599988,73,91,0.31,18,0.017222222,29
3070.583409,49,60,0.29,11,0.026363636,29
3070.530969,32,62,0.99,30,0.033,29
3070.36121,33,53,0.82,20,0.041,29
3070.217306,38,56,0.67,18,0.037222222,29
3069.900109,58,87,0.77,29,0.026551724,29
3069.853868,32,56,0.95,24,0.039583333,29
3069.756074,47,50,0.11,3,0.036666667,29
3069.612138,48,57,0.24,9,0.026666667,29
3069.560202,62,81,0.51,19,0.026842105,29
3069.362897,38,61,0.8,23,0.034782609,29
3069.303437,36,59,0.87,23,0.037826087,29
3069.209762,41,60,0.62,19,0.032631579,29
3069.136441,37,51,0.52,14,0.037142857,29
3068.929575,43,65,0.72,22,0.032727273,29
3068.910981,42,73,0.76,31,0.024516129,29
3068.669536,43,68,0.68,25,0.0272,29
3068.58644,67,69,0.06,2,0.03,29
3068.285396,42,74,0.77,32,0.0240625,29
3067.984075,39,55,0.59,16,0.036875,29
3067.92634,38,51,0.52,13,0.04,29
3067.710437,62,83,0.43,21,0.02047619,29
3067.710437,61,84,0.47,23,0.020434783,29
3067.710437,60,85,0.51,25,0.0204,29
3067.694503,63,81,0.36,18,0.02,29
3067.571436,56,89,0.88,33,0.026666667,29
3067.567481,40,47,0.29,7,0.041428571,29
3067.548272,54,84,0.85,30,0.028333333,29
3067.471949,35,52,0.71,17,0.041764706,29
3067.275357,35,62,0.94,27,0.034814815,29
3067.041942,69,96,0.46,27,0.017037037,29
3066.942878,40,75,0.97,35,0.027714286,29
3066.769832,66,77,0.29,11,0.026363636,29
3066.769832,64,79,0.4,15,0.026666667,29
3066.769832,63,80,0.45,17,0.026470588,29
3066.769832,61,83,0.58,22,0.026363636,29
3066.769832,60,84,0.63,24,0.02625,29
3066.747667,46,54,0.28,8,0.035,29
3066.664693,67,74,0.2,7,0.028571429,29
3066.664693,62,80,0.51,18,0.028333333,29
3066.638489,79,86,0.12,7,0.017142857,29
3066.546714,32,54,0.91,22,0.041363636,29
3065.884337,61,79,0.38,18,0.021111111,29
3065.789488,78,85,0.13,7,0.018571429,29
3065.789488,74,89,0.28,15,0.018666667,29
3065.766688,59,85,0.69,26,0.026538462,29
3065.766688,58,87,0.76,29,0.026206897,29
3065.766688,57,88,0.81,31,0.026129032,29
3065.766688,57,88,0.82,31,0.026451613,29
3065.766688,55,91,0.94,36,0.026111111,29
3065.589612,35,61,0.87,26,0.033461538,29
3065.552254,35,63,0.97,28,0.034642857,29
3065.461432,74,90,0.27,16,0.016875,29
3065.461432,72,92,0.34,20,0.017,29
3065.461432,68,97,0.49,29,0.016896552,29
3065.413296,67,98,0.57,31,0.018387097,29
3065.164084,76,87,0.21,11,0.019090909,29
3064.91782,54,72,0.64,18,0.035555556,29
3064.799195,58,64,0.22,6,0.036666667,29
3064.730223,56,88,0.9,32,0.028125,29
3064.513104,52,56,0.13,4,0.0325,29
3064.513104,50,58,0.26,8,0.0325,29
3064.471296,48,54,0.19,6,0.031666667,29
3064.261719,60,81,0.46,21,0.021904762,29
3064.134259,61,82,0.44,21,0.020952381,29
3064.017051,40,74,0.94,34,0.027647059,29
3063.520819,38,64,0.9,26,0.034615385,29
3063.456641,46,51,0.18,5,0.036,29
3063.37768,34,55,0.76,21,0.036190476,29
3063.24791,39,55,0.55,16,0.034375,29
3063.155804,53,73,0.71,20,0.0355,29
3062.939835,34,59,0.81,25,0.0324,29
3062.701924,37,57,0.76,20,0.038,29
3062.640658,36,52,0.6,16,0.0375,29
3062.508263,61,84,0.46,23,0.02,29
3062.436431,34,59,0.82,25,0.0328,29
3062.414882,37,52,0.55,15,0.036666667,29
3062.327039,45,49,0.15,4,0.0375,29
3062.208876,33,58,0.92,25,0.0368,29
3062.19538,61,76,0.44,15,0.029333333,29
3062.112461,47,65,0.46,18,0.025555556,29
3062.099929,51,56,0.13,5,0.026,29
3062.018103,39,62,0.63,23,0.027391304,29
3061.832228,56,92,0.73,36,0.020277778,29
3061.80534,56,80,0.55,24,0.022916667,29
3061.763778,53,84,0.88,31,0.028387097,29
3061.63689,53,80,0.87,27,0.032222222,29
3061.63689,52,81,0.94,29,0.032413793,29
3061.598005,70,95,0.42,25,0.0168,29
3061.434733,45,47,0.08,2,0.04,29
3061.341886,31,58,0.99,27,0.036666667,29
3061.297768,64,74,0.29,10,0.029,29
3061.171486,32,56,0.96,24,0.04,29
3061.110742,43,70,0.74,27,0.027407407,29
3060.91243,71,95,0.41,24,0.017083333,29
3060.899038,34,60,0.99,26,0.038076923,29
3060.824114,60,88,0.7,28,0.025,29
3060.824114,57,92,0.87,35,0.024857143,29
3060.794424,48,64,0.41,16,0.025625,29
3060.541415,35,65,0.86,30,0.028666667,29
3060.535152,33,58,0.93,25,0.0372,29
3060.479734,46,54,0.22,8,0.0275,29
3060.43584,54,84,0.82,30,0.027333333,29
3060.260156,78,85,0.12,7,0.017142857,29
3060.208766,65,82,0.33,17,0.019411765,29
3060.159958,59,86,0.7,27,0.025925926,29
3060.104786,36,59,0.79,23,0.034347826,29
3060.104786,35,60,0.86,25,0.0344,29
3059.666204,45,62,0.48,17,0.028235294,29
3058.928788,50,56,0.16,6,0.026666667,29
3058.871086,52,75,0.8,23,0.034782609,29
3058.871086,51,76,0.87,25,0.0348,29
3058.847162,51,61,0.24,10,0.024,29
3058.523427,44,66,0.65,22,0.029545455,29
3058.432956,68,97,0.53,29,0.018275862,29
3058.355699,70,98,0.48,28,0.017142857,29
3058.060273,34,61,0.83,27,0.030740741,29
3057.95266,54,85,0.84,31,0.027096774,29
3057.830941,44,70,0.67,26,0.025769231,29
3057.75204,41,60,0.66,19,0.034736842,29
3057.709074,42,72,0.79,30,0.026333333,29
3057.661047,42,64,0.66,22,0.03,29
3057.508598,74,91,0.29,17,0.017058824,29
3057.369846,35,58,0.84,23,0.036521739,29
3057.369846,34,59,0.92,25,0.0368,29
3057.156781,39,47,0.32,8,0.04,29
3057.135199,34,54,0.75,20,0.0375,29
3057.120691,36,51,0.62,15,0.041333333,29
3057.002619,59,86,0.55,27,0.02037037,29
3056.920918,69,73,0.11,4,0.0275,29
3056.920918,67,75,0.22,8,0.0275,29
3056.92007,53,88,0.94,35,0.026857143,29
3056.686464,69,96,0.49,27,0.018148148,29
3056.25773,60,67,0.23,7,0.032857143,29
3056.128911,27,88,0.2,61,0.003278689,29
3055.802815,35,52,0.68,17,0.04,29
3055.573194,34,57,0.84,23,0.036521739,29
3055.556793,59,87,0.57,28,0.020357143,29
3055.534922,41,57,0.58,16,0.03625,29
3055.375302,47,55,0.25,8,0.03125,29
3055.073182,58,88,0.61,30,0.020333333,29
3055.073182,57,89,0.65,32,0.0203125,29
3055.073182,56,90,0.69,34,0.020294118,29
3054.950183,39,63,0.81,24,0.03375,29
3054.950183,38,64,0.88,26,0.033846154,29
3054.934117,47,58,0.32,11,0.029090909,29
3054.883361,34,62,0.95,28,0.033928571,29
3054.711433,72,93,0.35,21,0.016666667,29
3054.537958,48,60,0.39,12,0.0325,29
3054.439553,64,77,0.37,13,0.028461538,29
3053.982441,58,76,0.42,18,0.023333333,29
3053.8504,53,85,0.88,32,0.0275,29
3053.719494,40,70,0.9,30,0.03,29
3053.539359,27,87,0.23,60,0.003833333,29
3053.537466,50,62,0.29,12,0.024166667,29
3053.30865,68,96,0.52,28,0.018571429,29
3053.30865,67,97,0.56,30,0.018666667,29
3053.221266,42,61,0.5,19,0.026315789,29
3053.220653,60,85,0.64,25,0.0256,29
3053.220653,59,87,0.71,28,0.025357143,29
3053.220653,58,88,0.76,30,0.025333333,29
3053.220653,55,92,0.94,37,0.025405405,29
3053.220653,54,93,0.99,39,0.025384615,29
3053.220498,43,69,0.7,26,0.026923077,29
3052.947284,35,55,0.8,20,0.04,29
3052.55042,39,55,0.56,16,0.035,29
3052.462021,56,86,0.78,30,0.026,29
3052.462021,55,88,0.85,33,0.025757576,29
3052.432975,64,75,0.3,11,0.027272727,29
3052.274991,54,84,0.84,30,0.028,29
3052.17981,47,52,0.14,5,0.028,29
3052.130897,61,73,0.28,12,0.023333333,29
3052.072564,26,89,0.22,63,0.003492063,29
3052.04489,52,81,0.85,29,0.029310345,29
3052.04489,51,82,0.91,31,0.029354839,29
3051.969294,33,63,0.91,30,0.030333333,29
3051.800848,65,74,0.19,9,0.021111111,29
3051.780447,35,59,0.91,24,0.037916667,29
3051.770986,44,57,0.42,13,0.032307692,29
3051.760953,31,58,0.97,27,0.035925926,29
3051.690103,53,79,0.77,26,0.029615385,29
3051.685798,55,77,0.64,22,0.029090909,29
3051.414092,27,86,0.25,59,0.004237288,29
3051.34824,56,66,0.37,10,0.037,29
3051.276438,53,85,0.9,32,0.028125,29
3051.276438,52,86,0.96,34,0.028235294,29
3051.233594,61,74,0.3,13,0.023076923,29
3051.212183,39,62,0.77,23,0.033478261,29
3051.17147,65,79,0.3,14,0.021428571,29
3051.143536,63,79,0.34,16,0.02125,29
3050.934491,66,79,0.33,13,0.025384615,29
3050.921956,47,64,0.49,17,0.028823529,29
3050.833253,54,73,0.67,19,0.035263158,29
3050.78691,38,56,0.63,18,0.035,29
3050.533822,55,83,0.78,28,0.027857143,29
3050.4365,54,89,0.75,35,0.021428571,29
3050.192236,48,52,0.11,4,0.0275,29
3050.15117,66,78,0.31,12,0.025833333,29
3050.15117,62,83,0.54,21,0.025714286,29
3050.15117,61,84,0.59,23,0.025652174,29
3050.15117,57,89,0.82,32,0.025625,29
3050.150924,45,56,0.31,11,0.028181818,29
3050.147338,62,74,0.27,12,0.0225,29
3050.147338,60,76,0.36,16,0.0225,29
3050.13817,61,86,0.49,25,0.0196,29
3050.135709,46,62,0.42,16,0.02625,29
3050.031162,35,52,0.64,17,0.037647059,29
3049.55103,36,52,0.62,16,0.03875,29
3049.475687,39,49,0.39,10,0.039,29
3049.475687,38,50,0.47,12,0.039166667,29
3049.451942,49,55,0.17,6,0.028333333,29
3049.448353,55,71,0.57,16,0.035625,29
3049.120069,36,56,0.73,20,0.0365,29
3049.007524,75,88,0.24,13,0.018461538,29
3048.894395,42,62,0.54,20,0.027,29
3048.881851,52,87,0.97,35,0.027714286,29
3048.648203,53,74,0.73,21,0.034761905,29
3048.643159,43,54,0.32,11,0.029090909,29
3048.643159,42,55,0.38,13,0.029230769,29
3048.527718,42,44,0.08,2,0.04,29
3048.508273,56,83,0.74,27,0.027407407,29
3048.435309,60,77,0.5,17,0.029411765,29
3048.435309,59,78,0.56,19,0.029473684,29
3048.422409,35,66,0.88,31,0.028387097,29
3048.335946,67,77,0.26,10,0.026,29
3048.313867,43,51,0.3,8,0.0375,29
3048.124957,36,59,0.81,23,0.035217391,29
3048.014881,42,59,0.58,17,0.034117647,29
3047.955466,64,83,0.37,19,0.019473684,29
3047.879706,79,85,0.11,6,0.018333333,29
3047.867234,67,78,0.28,11,0.025454545,29
3047.856516,52,65,0.35,13,0.026923077,29
3047.783246,58,80,0.61,22,0.027727273,29
3047.399671,36,49,0.54,13,0.041538462,29
3047.160788,25,92,0.2,67,0.002985075,29
3047.074214,72,94,0.37,22,0.016818182,29
3046.955985,62,81,0.39,19,0.020526316,29
3046.955985,61,82,0.43,21,0.02047619,29
3046.850073,63,80,0.46,17,0.027058824,29
3046.850073,61,82,0.57,21,0.027142857,29
3046.850073,59,85,0.7,26,0.026923077,29
3046.769185,61,77,0.44,16,0.0275,29
3046.769185,59,79,0.55,20,0.0275,29
3046.563808,46,65,0.6,19,0.031578947,29
3046.292343,42,55,0.47,13,0.036153846,29
3046.132717,54,85,0.86,31,0.027741935,29
3045.794479,41,69,0.89,28,0.031785714,29
3045.582392,33,55,0.89,22,0.040454545,29
3045.296887,40,61,0.72,21,0.034285714,29
3045.169365,54,78,0.71,24,0.029583333,29
3045.161373,58,88,0.79,30,0.026333333,29
3045.156112,61,76,0.42,15,0.028,29
3045.085264,35,53,0.7,18,0.038888889,29
3045.074551,40,72,0.94,32,0.029375,29
3044.996236,54,82,0.81,28,0.028928571,29
3044.996236,53,83,0.87,30,0.029,29
3044.996236,52,84,0.93,32,0.0290625,29
3044.978959,64,79,0.41,15,0.027333333,29
3044.978959,62,81,0.52,19,0.027368421,29
3044.978959,60,83,0.63,23,0.027391304,29
3044.960885,35,56,0.75,21,0.035714286,29
3044.955957,58,77,0.44,19,0.023157895,29
3044.805126,41,72,0.85,31,0.027419355,29
3044.797571,39,70,0.95,31,0.030645161,29
3044.722711,45,57,0.38,12,0.031666667,29
3044.5985,68,73,0.14,5,0.028,29
3044.217886,44,58,0.39,14,0.027857143,29
3044.147491,40,51,0.43,11,0.039090909,29
3044.026945,54,73,0.66,19,0.034736842,29
3043.816646,72,92,0.37,20,0.0185,29
3043.816646,69,95,0.48,26,0.018461538,29
3043.568928,44,57,0.36,13,0.027692308,29
3043.400993,37,65,0.96,28,0.034285714,29
3043.259115,39,63,0.64,24,0.026666667,29
3043.00664,57,81,0.67,24,0.027916667,29
3042.943881,40,60,0.56,20,0.028,29
3042.92284,73,90,0.32,17,0.018823529,29
3042.813058,48,57,0.25,9,0.027777778,29
3042.372281,42,54,0.44,12,0.036666667,29
3042.284039,39,59,0.58,20,0.029,29
3042.245915,61,65,0.14,4,0.035,29
3042.245915,60,66,0.21,6,0.035,29
3042.245915,59,67,0.28,8,0.035,29
3042.245915,58,68,0.35,10,0.035,29
3042.245915,57,69,0.42,12,0.035,29
3042.245915,56,70,0.49,14,0.035,29
3042.245915,55,71,0.56,16,0.035,29
3042.093669,49,62,0.38,13,0.029230769,29
3042.078236,73,91,0.33,18,0.018333333,29
3042.047443,41,65,0.72,24,0.03,29
3042.011023,56,82,0.73,26,0.028076923,29
3042.010908,41,45,0.17,4,0.0425,29
3041.82335,38,63,0.87,25,0.0348,29
3041.477475,64,70,0.14,6,0.023333333,29
3041.436647,41,72,0.83,31,0.026774194,29
3041.431704,41,61,0.56,20,0.028,29
3041.267071,43,65,0.57,22,0.025909091,29
3041.218193,56,88,0.67,32,0.0209375,29
3041.197147,34,53,0.73,19,0.038421053,29
3041.092857,48,57,0.26,9,0.028888889,29
3040.778742,45,51,0.22,6,0.036666667,29
3040.7208,54,68,0.52,14,0.037142857,29
3040.719564,60,85,0.5,25,0.02,29
3040.715624,75,89,0.24,14,0.017142857,29
3040.710287,40,62,0.74,22,0.033636364,29
3040.682237,43,66,0.74,23,0.032173913,29
3040.63076,59,86,0.54,27,0.02,29
3040.621828,50,68,0.48,18,0.026666667,29
3040.571174,38,50,0.44,12,0.036666667,29
3040.520168,52,83,0.89,31,0.028709677,29
3040.507412,36,51,0.59,15,0.039333333,29
3040.47242,57,88,0.64,31,0.020645161,29
3040.270986,24,96,0.19,72,0.002638889,29
3040.243328,58,88,0.77,30,0.025666667,29
3040.201968,39,72,0.96,33,0.029090909,29
3040.101622,56,93,0.93,37,0.025135135,29
3039.929856,45,66,0.57,21,0.027142857,29
3039.914244,57,77,0.47,20,0.0235,29
3039.713999,46,61,0.39,15,0.026,29
3039.623477,55,83,0.79,28,0.028214286,29
3039.471618,54,78,0.79,24,0.032916667,29
3039.171505,55,87,0.7,32,0.021875,29
3039.027517,55,72,0.59,17,0.034705882,29
3038.997246,61,76,0.33,15,0.022,29
3038.640174,58,79,0.47,21,0.022380952,29
3038.5762,44,50,0.23,6,0.038333333,29
3038.569119,49,63,0.34,14,0.024285714,29
3038.433814,64,80,0.42,16,0.02625,29
3038.433814,63,81,0.47,18,0.026111111,29
3038.433814,60,85,0.65,25,0.026,29
3038.132085,34,58,0.85,24,0.035416667,29
3038.104916,33,62,0.9,29,0.031034483,29
3037.971462,75,90,0.25,15,0.016666667,29
3037.96288,55,93,0.94,38,0.024736842,29
3037.850409,33,58,0.87,25,0.0348,29
3037.634054,62,64,0.07,2,0.035,29
3037.594153,43,72,0.72,29,0.024827586,29
3037.592847,37,51,0.56,14,0.04,29
3037.5339,65,68,0.07,3,0.023333333,29
3037.501913,47,58,0.31,11,0.028181818,29
3037.439646,59,86,0.71,27,0.026296296,29
3037.439646,56,90,0.88,34,0.025882353,29
3037.439646,56,90,0.89,34,0.026176471,29
3037.282621,66,71,0.14,5,0.028,29
3037.09306,35,57,0.81,22,0.036818182,29
3036.958401,39,47,0.34,8,0.0425,29
3036.918216,38,52,0.57,14,0.040714286,29
3036.779534,35,52,0.67,17,0.039411765,29
3036.779534,34,53,0.75,19,0.039473684,29
3036.77924,41,52,0.42,11,0.038181818,29
3036.773714,34,54,0.76,20,0.038,29
3036.772572,34,52,0.73,18,0.040555556,29
3036.734641,54,87,0.95,33,0.028787879,29
3036.732468,52,89,0.99,37,0.026756757,29
3036.699288,68,99,0.56,31,0.018064516,29
3036.543091,45,68,0.57,23,0.024782609,29
3036.525949,64,72,0.23,8,0.02875,29
3036.5111,42,51,0.34,9,0.037777778,29
3036.353036,43,69,0.72,26,0.027692308,29
3036.246654,37,57,0.74,20,0.037,29
3036.229644,59,85,0.53,26,0.020384615,29
3036.22064,55,84,0.8,29,0.027586207,29
3036.186408,53,85,0.91,32,0.0284375,29
3036.07887,51,60,0.22,9,0.024444444,29
3036.00915,50,54,0.11,4,0.0275,29
3036.00915,48,56,0.22,8,0.0275,29
3035.830796,37,64,0.74,27,0.027407407,29
3035.647103,62,75,0.38,13,0.029230769,29
3035.632089,69,97,0.47,28,0.016785714,29
3035.595926,43,55,0.35,12,0.029166667,29
3035.374117,51,84,0.95,33,0.028787879,29
3035.345892,33,56,0.83,23,0.036086957,29
3035.283003,45,63,0.71,18,0.039444444,29
3034.947081,52,76,0.83,24,0.034583333,29
3034.947081,51,77,0.9,26,0.034615385,29
3034.947081,50,78,0.97,28,0.034642857,29
3034.719181,42,53,0.34,11,0.030909091,29
3034.670807,52,59,0.17,7,0.024285714,29
3034.625618,57,88,0.63,31,0.020322581,29
3034.593208,56,94,0.93,38,0.024473684,29
3034.593208,55,95,0.98,40,0.0245,29
3034.575452,38,55,0.66,17,0.038823529,29
3034.571163,52,86,0.94,34,0.027647059,29
3034.53209,62,77,0.32,15,0.021333333,29
3034.484007,56,89,0.68,33,0.020606061,29
3034.381366,39,58,0.69,19,0.036315789,29
3034.299688,53,91,0.98,38,0.025789474,29
3034.293389,64,72,0.18,8,0.0225,29
3034.186,34,62,0.94,28,0.033571429,29
3034.105422,62,85,0.45,23,0.019565217,29
3034.105422,60,87,0.53,27,0.01962963,29
3034.039286,60,65,0.18,5,0.036,29
3034.012654,36,58,0.84,22,0.038181818,29
3034.000618,57,74,0.5,17,0.029411765,29
3033.911406,38,58,0.64,20,0.032,29
3033.896874,61,84,0.49,23,0.021304348,29
3033.857975,38,63,0.88,25,0.0352,29
3033.741988,51,55,0.11,4,0.0275,29
3033.648401,41,60,0.52,19,0.027368421,29
3033.644039,33,54,0.81,21,0.038571429,29
3033.600257,55,95,0.99,40,0.02475,29
3033.578993,61,83,0.59,22,0.026818182,29
3033.484335,66,77,0.23,11,0.020909091,29
3033.26608,46,55,0.25,9,0.027777778,29
3033.183811,44,56,0.42,12,0.035,29
3033.110719,56,82,0.72,26,0.027692308,29
3033.093956,49,57,0.27,8,0.03375,29
3033.014527,52,82,0.94,30,0.031333333,29
3032.993582,32,55,0.92,23,0.04,29
3032.916726,40,71,0.98,31,0.031612903,29
3032.885122,43,58,0.48,15,0.032,29
3032.780959,60,86,0.66,26,0.025384615,29
3032.780959,57,90,0.83,33,0.025151515,29
3032.780959,56,91,0.89,35,0.025428571,29
3032.772181,43,59,0.5,16,0.03125,29
3032.683839,49,57,0.22,8,0.0275,29
3032.661914,60,77,0.48,17,0.028235294,29
3032.542466,43,72,0.71,29,0.024482759,29
3032.497862,46,60,0.37,14,0.026428571,29
3032.443849,49,56,0.2,7,0.028571429,29
3032.407959,42,66,0.63,24,0.02625,29
3032.371802,35,52,0.7,17,0.041176471,29
3032.307664,37,65,0.98,28,0.035,29
3032.262719,58,80,0.62,22,0.028181818,29
3032.111931,60,78,0.5,18,0.027777778,29
3032.111931,59,79,0.56,20,0.028,29
3032.106607,39,73,0.99,34,0.029117647,29
3031.909685,57,93,0.74,36,0.020555556,29
3031.85648,69,98,0.52,29,0.017931034,29
3031.727757,50,61,0.3,11,0.027272727,29
3031.339597,36,54,0.66,18,0.036666667,29
3031.308538,40,72,0.92,32,0.02875,29
3030.977976,46,61,0.41,15,0.027333333,29
3030.823454,51,77,0.91,26,0.035,29
3030.823454,50,78,0.98,28,0.035,29
3030.712972,40,65,0.67,25,0.0268,29
3030.658817,61,85,0.63,24,0.02625,29
3030.448493,38,65,0.91,27,0.033703704,29
3030.345933,53,75,0.76,22,0.034545455,29
3030.343635,53,74,0.74,21,0.035238095,29
3030.343635,52,75,0.81,23,0.035217391,29
3030.343635,51,76,0.88,25,0.0352,29
3030.236273,33,58,0.94,25,0.0376,29
3030.223981,58,86,0.57,28,0.020357143,29
3030.176806,70,96,0.43,26,0.016538462,29
3030.156773,43,68,0.73,25,0.0292,29
3029.85401,27,87,0.18,60,0.003,29
3029.817956,48,59,0.29,11,0.026363636,29
3029.640392,38,63,0.68,25,0.0272,29
3029.452554,36,55,0.67,19,0.035263158,29
3029.409569,43,63,0.6,20,0.03,29
3029.402461,56,94,0.78,38,0.020526316,29
3029.362582,43,71,0.73,28,0.026071429,29
3029.144313,26,90,0.18,64,0.0028125,29
3029.106019,35,53,0.68,18,0.037777778,29
3028.751925,40,46,0.23,6,0.038333333,29
3028.673028,68,75,0.19,7,0.027142857,29
3028.673028,66,77,0.3,11,0.027272727,29
3028.658305,33,60,0.99,27,0.036666667,29
3028.643963,39,52,0.5,13,0.038461538,29
3028.537344,43,55,0.43,12,0.035833333,29
3028.430005,38,49,0.41,11,0.037272727,29
3028.277891,50,78,0.99,28,0.035357143,29
3027.804447,54,81,0.73,27,0.027037037,29
3027.660191,54,82,0.8,28,0.028571429,29
3027.524322,46,62,0.63,16,0.039375,29
3027.110247,34,54,0.79,20,0.0395,29
3027.012282,44,69,0.66,25,0.0264,29
3026.864656,43,67,0.71,24,0.029583333,29
3026.698085,45,64,0.5,19,0.026315789,29
3026.695526,41,54,0.49,13,0.037692308,29
3026.669436,53,83,0.86,30,0.028666667,29
3026.588448,39,57,0.67,18,0.037222222,29
3026.579823,39,63,0.82,24,0.034166667,29
3026.514944,41,63,0.6,22,0.027272727,29
3026.498845,44,55,0.39,11,0.035454545,29
3026.393156,47,59,0.34,12,0.028333333,29
3026.203808,45,65,0.59,20,0.0295,29
3026.185762,62,82,0.41,20,0.0205,29
3026.185762,61,83,0.45,22,0.020454545,29
3026.020214,41,74,0.88,33,0.026666667,29
3025.983282,52,85,0.95,33,0.028787879,29
3025.87024,59,80,0.57,21,0.027142857,29
3025.866741,35,55,0.75,20,0.0375,29
3025.861518,32,60,0.97,28,0.034642857,29
3025.757393,49,53,0.11,4,0.0275,29
3025.757393,47,55,0.22,8,0.0275,29
3025.649892,45,59,0.41,14,0.029285714,29
3025.630824,44,68,0.69,24,0.02875,29
3025.406216,43,70,0.71,27,0.026296296,29
3025.314416,78,87,0.15,9,0.016666667,29
3025.281297,35,56,0.73,21,0.034761905,29
3025.207561,24,94,0.22,70,0.003142857,29
3025.183937,58,90,0.81,32,0.0253125,29
3025.102809,47,57,0.31,10,0.031,29
3025.048347,56,82,0.71,26,0.027307692,29
3024.917395,42,73,0.77,31,0.02483871,29
3024.885232,41,60,0.65,19,0.034210526,29
3024.799978,54,83,0.8,29,0.027586207,29
3024.556926,55,77,0.72,22,0.032727273,29
3024.534966,76,88,0.22,12,0.018333333,29
3024.487247,48,65,0.41,17,0.024117647,29
3024.479835,57,84,0.6,27,0.022222222,29
3024.067881,68,98,0.5,30,0.016666667,29
3024.004763,63,84,0.41,21,0.01952381,29
3023.710463,71,94,0.39,23,0.016956522,29
3023.198676,45,54,0.26,9,0.028888889,29
3023.050768,36,63,0.82,27,0.03037037,29
3022.973176,64,80,0.41,16,0.025625,29
3022.404795,56,75,0.56,19,0.029473684,29
3022.13548,63,81,0.37,18,0.020555556,29
3022.030012,52,84,0.92,32,0.02875,29
3022.030012,51,85,0.98,34,0.028823529,29
3021.859201,46,49,0.1,3,0.033333333,29
3021.803064,63,74,0.31,11,0.028181818,29
3021.764694,51,81,0.99,30,0.033,29
3021.51788,27,87,0.22,60,0.003666667,29
3021.404641,37,65,0.97,28,0.034642857,29
3021.279731,54,82,0.78,28,0.027857143,29
3021.14313,49,60,0.33,11,0.03,29
3021.137995,67,79,0.31,12,0.025833333,29
3021.133909,60,86,0.52,26,0.02,29
3021.133909,59,87,0.56,28,0.02,29
3021.133909,58,88,0.6,30,0.02,29
3021.033225,58,80,0.65,22,0.029545455,29
3021.033225,57,81,0.71,24,0.029583333,29
3021.033225,54,85,0.91,31,0.029354839,29
3020.951699,59,85,0.54,26,0.020769231,29
3020.918447,44,62,0.54,18,0.03,29
3020.896086,28,87,0.19,59,0.003220339,29
3020.77397,51,84,0.96,33,0.029090909,29
3020.653782,57,69,0.43,12,0.035833333,29
3020.6256,58,86,0.75,28,0.026785714,29
3020.356933,63,79,0.45,16,0.028125,29
3020.340892,62,72,0.23,10,0.023,29
3020.238319,41,73,0.85,32,0.0265625,29
3020.149305,62,85,0.59,23,0.025652174,29
3020.142465,53,64,0.3,11,0.027272727,29
3019.883226,67,76,0.24,9,0.026666667,29
3019.852515,67,71,0.11,4,0.0275,29
3019.780383,49,56,0.19,7,0.027142857,29
3019.642563,54,87,0.88,33,0.026666667,29
3019.642563,53,89,0.95,36,0.026388889,29
3019.625458,35,54,0.69,19,0.036315789,29
3019.437032,52,80,0.92,28,0.032857143,29
3019.409016,35,62,0.95,27,0.035185185,29
3019.408944,52,86,0.95,34,0.027941176,29
3019.302863,55,67,0.44,12,0.036666667,29
3019.29404,52,92,0.84,40,0.021,29
3019.226556,60,73,0.36,13,0.027692308,29
3019.159375,31,57,0.98,26,0.037692308,29
3018.907601,35,58,0.78,23,0.033913043,29
3018.688275,47,59,0.32,12,0.026666667,29
3018.543455,42,58,0.56,16,0.035,29
3018.543455,41,59,0.63,18,0.035,29
3018.475322,36,61,0.78,25,0.0312,29
3018.455084,45,61,0.46,16,0.02875,29
3018.442402,46,54,0.26,8,0.0325,29
3018.237026,34,59,0.91,25,0.0364,29
3018.089971,64,81,0.44,17,0.025882353,29
3018.089971,63,82,0.49,19,0.025789474,29
3018.089971,61,84,0.6,23,0.026086957,29
3018.089971,60,86,0.67,26,0.025769231,29
3018.089971,59,87,0.72,28,0.025714286,29
3018.033249,55,77,0.65,22,0.029545455,29
3017.961181,52,87,0.95,35,0.027142857,29
3017.794407,43,59,0.47,16,0.029375,29
3017.722937,62,79,0.37,17,0.021764706,29
3017.69479,63,82,0.5,19,0.026315789,29
3017.52881,57,86,0.61,29,0.021034483,29
3017.378111,53,81,0.81,28,0.028928571,29
3017.178499,39,59,0.73,20,0.0365,29
3017.171773,37,58,0.74,21,0.035238095,29
3017.102247,58,88,0.78,30,0.026,29
3017.102247,57,89,0.83,32,0.0259375,29
3017.102247,56,91,0.9,35,0.025714286,29
3017.102247,55,92,0.95,37,0.025675676,29
3017.102247,55,92,0.96,37,0.025945946,29
3016.887511,40,63,0.64,23,0.027826087,29
3016.840673,65,73,0.22,8,0.0275,29
3016.837925,60,84,0.65,24,0.027083333,29
3016.76099,53,81,0.88,28,0.031428571,29
3016.658803,42,73,0.78,31,0.02516129,29
3016.444966,40,69,0.94,29,0.032413793,29
3016.340127,56,81,0.69,25,0.0276,29
3016.333627,74,90,0.3,16,0.01875,29
3016.226081,55,80,0.73,25,0.0292,29
3016.226081,51,85,0.99,34,0.029117647,29
3016.176593,59,79,0.59,20,0.0295,29
3015.934776,25,93,0.2,68,0.002941176,29
3015.830294,52,88,0.97,36,0.026944444,29
3015.735815,45,57,0.32,12,0.026666667,29
3015.640081,55,93,0.83,38,0.021842105,29
3015.584911,38,67,0.79,29,0.027241379,29
3015.562641,43,55,0.39,12,0.0325,29
3015.553352,52,81,0.84,29,0.028965517,29
3015.36443,71,95,0.4,24,0.016666667,29
3015.147264,73,92,0.32,19,0.016842105,29
3015.137183,33,55,0.88,22,0.04,29
3015.019806,40,46,0.25,6,0.041666667,29
3014.953937,41,45,0.16,4,0.04,29
3014.953937,40,46,0.24,6,0.04,29
3014.800771,36,60,0.76,24,0.031666667,29
3014.771516,38,49,0.42,11,0.038181818,29
3014.759624,39,56,0.54,17,0.031764706,29
3014.597459,36,52,0.57,16,0.035625,29
3014.474519,37,50,0.49,13,0.037692308,29
3014.458318,60,87,0.7,27,0.025925926,29
3014.169878,57,87,0.62,30,0.020666667,29
3014.083519,48,63,0.44,15,0.029333333,29
3013.852253,80,87,0.12,7,0.017142857,29
3013.852253,74,94,0.34,20,0.017,29
3013.827846,33,54,0.82,21,0.039047619,29
3013.706992,45,56,0.35,11,0.031818182,29
3013.494028,52,82,0.95,30,0.031666667,29
3013.473176,81,84,0.05,3,0.016666667,29
3013.369876,33,55,0.81,22,0.036818182,29
3013.29136,46,56,0.28,10,0.028,29
3013.26662,69,75,0.16,6,0.026666667,29
3013.26662,61,84,0.61,23,0.026521739,29
3013.237438,45,51,0.2,6,0.033333333,29
3013.059257,61,86,0.5,25,0.02,29
3013.042837,58,91,0.82,33,0.024848485,29
3013.031521,54,94,0.99,40,0.02475,29
3012.994915,46,65,0.49,19,0.025789474,29
3012.908325,38,48,0.4,10,0.04,29
3012.877885,50,83,0.98,33,0.02969697,29
3012.850464,39,71,0.95,32,0.0296875,29
3012.737617,39,54,0.57,15,0.038,29
3012.618288,58,73,0.44,15,0.029333333,29
3012.489807,53,69,0.59,16,0.036875,29
3012.081492,73,91,0.34,18,0.018888889,29
3012.037073,46,62,0.52,16,0.0325,29
3011.989955,33,55,0.86,22,0.039090909,29
3011.840235,52,86,0.9,34,0.026470588,29
3011.662023,70,95,0.41,25,0.0164,29
3011.42726,45,63,0.5,18,0.027777778,29
3011.178601,32,56,0.87,24,0.03625,29
3011.110939,76,89,0.22,13,0.016923077,29
3011.028552,48,58,0.34,10,0.034,29
3010.926867,25,91,0.23,66,0.003484848,29
3010.886658,41,47,0.22,6,0.036666667,29
3010.868163,50,87,0.99,37,0.026756757,29
3010.851704,40,62,0.75,22,0.034090909,29
3010.658961,39,64,0.84,25,0.0336,29
3010.471155,35,69,0.98,34,0.028823529,29
3010.401939,58,86,0.58,28,0.020714286,29
3010.343228,49,57,0.23,8,0.02875,29
3010.20635,53,84,0.86,31,0.027741935,29
3010.176168,37,66,0.99,29,0.034137931,29
3009.977008,58,90,0.82,32,0.025625,29
3009.892527,61,75,0.39,14,0.027857143,29
3009.892527,58,78,0.56,20,0.028,29
3009.838739,42,70,0.76,28,0.027142857,29
3009.639252,53,86,0.9,33,0.027272727,29
3009.562809,41,74,0.82,33,0.024848485,29
3009.429813,59,76,0.39,17,0.022941176,29
3009.413261,34,60,0.97,26,0.037307692,29
3009.197384,56,78,0.6,22,0.027272727,29
3009.134987,62,80,0.38,18,0.021111111,29
3009.021215,27,87,0.2,60,0.003333333,29
3009.006795,79,89,0.17,10,0.017,29
3008.922227,44,62,0.51,18,0.028333333,29
3008.738792,25,92,0.19,67,0.002835821,29
3008.691883,38,65,0.92,27,0.034074074,29
3008.665361,47,63,0.47,16,0.029375,29
3008.648862,41,46,0.19,5,0.038,29
3008.408721,55,62,0.19,7,0.027142857,29
3008.392456,64,80,0.43,16,0.026875,29
3008.345902,47,55,0.27,8,0.03375,29
3008.245079,47,61,0.55,14,0.039285714,29
3008.110772,37,57,0.7,20,0.035,29
3008.091921,67,99,0.54,32,0.016875,29
3007.687143,64,80,0.33,16,0.020625,29
3007.46128,44,53,0.33,9,0.036666667,29
3007.323229,37,49,0.48,12,0.04,29
3007.254256,51,57,0.16,6,0.026666667,29
3007.207936,40,61,0.57,21,0.027142857,29
3007.156953,42,68,0.77,26,0.029615385,29
3006.474566,56,79,0.66,23,0.028695652,29
3006.312296,54,79,0.73,25,0.0292,29
3006.312296,53,80,0.79,27,0.029259259,29
3006.312296,52,82,0.87,30,0.029,29
3006.312296,51,83,0.93,32,0.0290625,29
3006.281916,36,59,0.78,23,0.033913043,29
3005.989156,32,57,0.97,25,0.0388,29
3005.872917,64,79,0.31,15,0.020666667,29
3005.815934,43,60,0.47,17,0.027647059,29
3005.691529,45,64,0.57,19,0.03,29
3005.636903,70,73,0.08,3,0.026666667,29
3005.628149,54,84,0.68,30,0.022666667,29
3005.524475,34,55,0.77,21,0.036666667,29
3005.328303,50,84,0.99,34,0.029117647,29
3005.319649,43,48,0.17,5,0.034,29
3005.319649,39,53,0.47,14,0.033571429,29
3005.164732,34,53,0.79,19,0.041578947,29
3005.115973,27,88,0.17,61,0.002786885,29
3005.05944,60,78,0.49,18,0.027222222,29
3004.837901,38,62,0.83,24,0.034583333,29
3004.783466,42,69,0.79,27,0.029259259,29
3004.583638,46,64,0.53,18,0.029444444,29
3004.567409,44,46,0.08,2,0.04,29
3004.567409,43,47,0.16,4,0.04,29
3004.476539,42,71,0.85,29,0.029310345,29
3004.457263,37,53,0.61,16,0.038125,29
3004.457263,36,54,0.69,18,0.038333333,29
3004.414928,60,77,0.49,17,0.028823529,29
3004.056773,40,70,0.89,30,0.029666667,29
3004.056773,39,72,0.97,33,0.029393939,29
3003.839473,38,66,0.77,28,0.0275,29
3003.804867,36,63,0.78,27,0.028888889,29
3003.804561,53,82,0.82,29,0.028275862,29
3003.563685,47,55,0.21,8,0.02625,29
3003.547946,39,61,0.78,22,0.035454545,29
3003.408284,33,54,0.85,21,0.04047619,29
3003.348886,58,79,0.6,21,0.028571429,29
3003.348886,57,80,0.66,23,0.028695652,29
3003.318885,63,83,0.52,20,0.026,29
3003.318885,59,88,0.75,29,0.025862069,29
3003.304118,69,74,0.14,5,0.028,29
3003.304118,63,81,0.5,18,0.027777778,29
3003.303521,77,87,0.17,10,0.017,29
3003.297049,53,83,0.84,30,0.028,29
3003.297049,52,84,0.9,32,0.028125,29
3003.253744,40,58,0.65,18,0.036111111,29
3003.215973,52,96,0.98,44,0.022272727,29
3003.157578,50,59,0.27,9,0.03,29
3003.13189,36,56,0.69,20,0.0345,29
3003.125984,59,82,0.51,23,0.022173913,29
3003.0789,37,61,0.88,24,0.036666667,29
3003.068548,42,60,0.5,18,0.027777778,29
3003.034384,38,55,0.65,17,0.038235294,29
3002.965703,25,87,0.6,62,0.009677419,29
3002.954817,66,77,0.31,11,0.028181818,29
3002.937266,39,62,0.8,23,0.034782609,29
3002.927749,57,85,0.61,28,0.021785714,29
3002.926783,38,49,0.43,11,0.039090909,29
3002.926783,37,50,0.51,13,0.039230769,29
3002.883553,60,85,0.66,25,0.0264,29
3002.866091,38,49,0.4,11,0.036363636,29
3002.343983,57,88,0.86,31,0.027741935,29
3002.262223,38,56,0.62,18,0.034444444,29
3002.16713,44,60,0.41,16,0.025625,29
3002.024824,69,98,0.51,29,0.017586207,29
3001.964487,40,73,0.9,33,0.027272727,29
3001.768291,36,61,0.76,25,0.0304,29
3001.742715,59,86,0.74,27,0.027407407,29
3001.717484,39,77,0.95,38,0.025,29
3001.644968,41,46,0.18,5,0.036,29
3001.531118,46,57,0.3,11,0.027272727,29
3001.489796,59,86,0.72,27,0.026666667,29
3001.460693,56,84,0.81,28,0.028928571,29
3001.418665,50,85,0.95,35,0.027142857,29
3001.352703,52,83,0.9,31,0.029032258,29
3001.143982,76,98,0.33,22,0.015,29
3001.114134,37,60,0.75,23,0.032608696,29
3001.082653,54,81,0.76,27,0.028148148,29
3001.046958,42,71,0.8,29,0.027586207,29
3000.971639,57,89,0.84,32,0.02625,29
3000.912791,44,55,0.31,11,0.028181818,29
3000.640028,60,87,0.54,27,0.02,29
3000.63188,45,67,0.61,22,0.027727273,29
3000.159535,43,59,0.54,16,0.03375,29
3000.159535,42,60,0.61,18,0.033888889,29
3000.159535,41,61,0.68,20,0.034,29
3000.03401,42,56,0.51,14,0.036428571,29
3000.009604,52,75,0.82,23,0.035652174,29
