% profit,ema1,ema2,threshold,diff,thresh / diff,ID
3951.103002,67,69,0.06,2,0.03,0
3951.103002,66,70,0.12,4,0.03,0
3951.103002,65,71,0.18,6,0.03,0
3748.252717,59,69,0.33,10,0.033,0
3743.190374,59,70,0.36,11,0.032727273,0
3684.970476,61,68,0.23,7,0.032857143,0
3684.970476,57,73,0.52,16,0.0325,0
3684.970476,56,73,0.56,17,0.032941176,0
3647.845132,61,67,0.2,6,0.033333333,0
3647.845132,58,70,0.4,12,0.033333333,0
3617.394373,55,73,0.6,18,0.033333333,0
3607.029456,60,67,0.24,7,0.034285714,0
3606.367099,61,66,0.17,5,0.034,0
3572.358038,53,76,0.78,23,0.033913043,0
3569.874159,56,72,0.55,16,0.034375,0
3569.874159,55,73,0.62,18,0.034444444,0
3567.668086,56,72,0.54,16,0.03375,0
3566.8161,55,74,0.63,19,0.033157895,0
3566.8161,53,77,0.79,24,0.032916667,0
3566.728386,54,74,0.67,20,0.0335,0
3565.615736,58,71,0.43,13,0.033076923,0
3565.084122,60,68,0.27,8,0.03375,0
3565.084122,56,73,0.57,17,0.033529412,0
3565.053033,59,69,0.34,10,0.034,0
3565.053033,55,74,0.64,19,0.033684211,0
3564.110029,54,75,0.7,21,0.033333333,0
3560.589082,57,71,0.48,14,0.034285714,0
3557.910181,57,71,0.47,14,0.033571429,0
3550.664557,51,79,0.93,28,0.033214286,0
3550.663995,52,78,0.86,26,0.033076923,0
3546.808756,58,70,0.41,12,0.034166667,0
3546.499241,53,75,0.74,22,0.033636364,0
3545.654822,54,75,0.71,21,0.033809524,0
3544.486899,57,72,0.5,15,0.033333333,0
3544.486899,53,76,0.77,23,0.033478261,0
3540.205502,61,68,0.24,7,0.034285714,0
3524.003677,59,71,0.39,12,0.0325,0
3516.540453,58,67,0.31,9,0.034444444,0
3516.540453,57,68,0.38,11,0.034545455,0
3504.621137,52,76,0.81,24,0.03375,0
3503.007474,50,79,0.99,29,0.034137931,0
3499.083895,56,69,0.45,13,0.034615385,0
3499.083895,55,70,0.52,15,0.034666667,0
3497.800048,56,71,0.52,15,0.034666667,0
3496.425767,56,74,0.59,18,0.032777778,0
3496.162025,54,74,0.69,20,0.0345,0
3493.891575,51,78,0.92,27,0.034074074,0
3493.09665,58,69,0.38,11,0.034545455,0
3493.09665,57,70,0.45,13,0.034615385,0
3486.142286,62,65,0.1,3,0.033333333,0
3482.130095,53,77,0.8,24,0.033333333,0
3480.474651,59,68,0.3,9,0.033333333,0
3471.146392,52,77,0.85,25,0.034,0
3470.671464,55,75,0.66,20,0.033,0
3470.513799,59,68,0.31,9,0.034444444,0
3469.671148,51,77,0.89,26,0.034230769,0
3466.585698,55,73,0.61,18,0.033888889,0
3466.585698,54,74,0.68,20,0.034,0
3466.585698,52,77,0.84,25,0.0336,0
3463.140549,52,78,0.87,26,0.033461538,0
3463.140549,51,79,0.94,28,0.033571429,0
3461.99906,54,76,0.73,22,0.033181818,0
3457.78051,53,73,0.69,20,0.0345,0
3457.78051,52,74,0.76,22,0.034545455,0
3457.78051,51,75,0.83,24,0.034583333,0
3457.770451,63,75,0.35,12,0.029166667,0
3457.354219,44,49,0.19,5,0.038,0
3448.552586,53,77,0.82,24,0.034166667,0
3447.70865,51,78,0.91,27,0.033703704,0
3443.961838,59,79,0.59,20,0.0295,0
3443.010298,53,75,0.75,22,0.034090909,0
3443.010298,52,76,0.82,24,0.034166667,0
3442.101757,50,79,0.98,29,0.033793103,0
3440.425883,38,57,0.7,19,0.036842105,0
3430.226657,59,77,0.55,18,0.030555556,0
3423.524939,52,78,0.88,26,0.033846154,0
3423.524939,51,79,0.95,28,0.033928571,0
3421.142269,54,75,0.72,21,0.034285714,0
3420.136589,60,78,0.53,18,0.029444444,0
3417.806259,58,69,0.37,11,0.033636364,0
3413.997091,59,67,0.27,8,0.03375,0
3410.662629,51,62,0.34,11,0.030909091,0
3410.267512,62,76,0.41,14,0.029285714,0
3409.215837,63,66,0.1,3,0.033333333,0
3409.215837,60,69,0.3,9,0.033333333,0
3409.186069,59,70,0.37,11,0.033636364,0
3396.615239,60,77,0.51,17,0.03,0
3395.211876,40,54,0.53,14,0.037857143,0
3391.941762,61,74,0.4,13,0.030769231,0
3390.613361,55,75,0.67,20,0.0335,0
3389.262342,61,77,0.47,16,0.029375,0
3376.067932,62,73,0.34,11,0.030909091,0
3372.652066,57,70,0.44,13,0.033846154,0
3369.334558,40,54,0.52,14,0.037142857,0
3366.935246,58,68,0.34,10,0.034,0
3365.824072,49,64,0.46,15,0.030666667,0
3363.502986,67,88,0.39,21,0.018571429,0
3361.039669,57,69,0.41,12,0.034166667,0
3361.039669,56,70,0.48,14,0.034285714,0
3360.564224,65,91,0.48,26,0.018461538,0
3359.327469,49,66,0.51,17,0.03,0
3357.955879,54,76,0.74,22,0.033636364,0
3356.480695,42,69,0.92,27,0.034074074,0
3351.80412,53,77,0.81,24,0.03375,0
3350.004137,58,78,0.61,20,0.0305,0
3349.469949,55,74,0.65,19,0.034210526,0
3348.648428,61,78,0.49,17,0.028823529,0
3348.648428,60,79,0.55,19,0.028947368,0
3344.184146,58,81,0.66,23,0.028695652,0
3341.182085,70,83,0.25,13,0.019230769,0
3340.742512,62,67,0.17,5,0.034,0
3340.742512,57,72,0.51,15,0.034,0
3340.742512,56,73,0.58,17,0.034117647,0
3338.879935,49,68,0.48,19,0.025263158,0
3338.15762,47,67,0.62,20,0.031,0
3336.85872,63,67,0.13,4,0.0325,0
3336.85872,61,69,0.26,8,0.0325,0
3333.898761,58,71,0.44,13,0.033846154,0
3333.170217,66,88,0.42,22,0.019090909,0
3333.170217,65,89,0.46,24,0.019166667,0
3332.648694,56,82,0.78,26,0.03,0
3332.597162,65,72,0.21,7,0.03,0
3332.597162,64,73,0.27,9,0.03,0
3332.597162,63,74,0.33,11,0.03,0
3332.597162,62,75,0.39,13,0.03,0
3332.597162,61,76,0.45,15,0.03,0
3330.665696,37,58,0.77,21,0.036666667,0
3330.665696,36,59,0.85,23,0.036956522,0
3329.725168,54,76,0.67,22,0.030454545,0
3327.836408,59,79,0.6,20,0.03,0
3326.972877,64,92,0.52,28,0.018571429,0
3326.297764,59,71,0.41,12,0.034166667,0
3325.070403,70,84,0.26,14,0.018571429,0
3319.726717,63,93,0.56,30,0.018666667,0
3319.618249,51,77,0.88,26,0.033846154,0
3319.235944,56,71,0.51,15,0.034,0
3318.480979,57,82,0.72,25,0.0288,0
3318.124122,47,68,0.64,21,0.03047619,0
3317.27293,68,87,0.35,19,0.018421053,0
3316.810101,52,79,0.81,27,0.03,0
3316.225867,53,88,0.97,35,0.027714286,0
3315.233907,55,71,0.55,16,0.034375,0
3315.233907,54,72,0.62,18,0.034444444,0
3315.036398,63,71,0.25,8,0.03125,0
3314.781187,56,76,0.67,20,0.0335,0
3313.832093,55,72,0.58,17,0.034117647,0
3312.150176,48,64,0.51,16,0.031875,0
3312.11246,56,83,0.78,27,0.028888889,0
3309.571778,58,80,0.66,22,0.03,0
3309.571778,57,81,0.72,24,0.03,0
3309.520592,68,69,0.03,1,0.03,0
3309.520592,67,70,0.09,3,0.03,0
3309.520592,66,71,0.15,5,0.03,0
3309.283115,50,63,0.4,13,0.030769231,0
3309.241125,59,80,0.61,21,0.029047619,0
3308.864444,49,65,0.49,16,0.030625,0
3308.839861,49,67,0.48,18,0.026666667,0
3308.806708,72,81,0.17,9,0.018888889,0
3308.710323,67,86,0.36,19,0.018947368,0
3308.220648,48,63,0.49,15,0.032666667,0
3307.758831,54,73,0.65,19,0.034210526,0
3307.758831,53,74,0.72,21,0.034285714,0
3307.74789,37,58,0.79,21,0.037619048,0
3306.339109,68,86,0.34,18,0.018888889,0
3306.339109,64,90,0.49,26,0.018846154,0
3304.936761,45,70,0.77,25,0.0308,0
3302.489717,73,81,0.15,8,0.01875,0
3302.489717,69,85,0.3,16,0.01875,0
3302.489717,66,87,0.4,21,0.019047619,0
3302.48651,66,89,0.43,23,0.018695652,0
3302.48651,63,91,0.53,28,0.018928571,0
3296.143475,56,83,0.8,27,0.02962963,0
3296.143475,55,84,0.86,29,0.029655172,0
3295.895745,71,82,0.21,11,0.019090909,0
3295.892544,67,87,0.38,20,0.019,0
3294.670512,48,61,0.45,13,0.034615385,0
3294.066351,42,51,0.34,9,0.037777778,0
3290.993132,55,85,0.85,30,0.028333333,0
3290.993132,54,86,0.91,32,0.0284375,0
3290.993132,53,87,0.97,34,0.028529412,0
3289.722414,52,75,0.79,23,0.034347826,0
3289.722414,51,76,0.86,25,0.0344,0
3289.722414,50,77,0.93,27,0.034444444,0
3288.591492,49,60,0.38,11,0.034545455,0
3288.231446,38,56,0.68,18,0.037777778,0
3287.873309,54,61,0.18,7,0.025714286,0
3287.704272,59,78,0.57,19,0.03,0
3287.505031,63,72,0.28,9,0.031111111,0
3286.946054,53,78,0.75,25,0.03,0
3286.927254,65,90,0.47,25,0.0188,0
3286.927254,62,92,0.57,30,0.019,0
3286.6615,48,69,0.53,21,0.025238095,0
3286.462025,50,78,0.96,28,0.034285714,0
3286.235212,39,55,0.6,16,0.0375,0
3286.031526,58,73,0.48,15,0.032,0
3285.961431,64,91,0.51,27,0.018888889,0
3285.72604,63,93,0.55,30,0.018333333,0
3284.889637,52,79,0.89,27,0.032962963,0
3283.648646,50,82,0.97,32,0.0303125,0
3283.168655,56,76,0.58,20,0.029,0
3283.006093,58,80,0.65,22,0.029545455,0
3283.006093,57,81,0.71,24,0.029583333,0
3281.429511,62,95,0.6,33,0.018181818,0
3279.501329,54,77,0.78,23,0.033913043,0
3279.39949,63,92,0.55,29,0.018965517,0
3279.360375,51,81,0.89,30,0.029666667,0
3279.008011,50,62,0.38,12,0.031666667,0
3278.518888,55,85,0.84,30,0.028,0
3278.518888,54,86,0.9,32,0.028125,0
3277.821805,55,77,0.64,22,0.029090909,0
3277.821805,54,78,0.7,24,0.029166667,0
3277.656421,36,59,0.86,23,0.037391304,0
3277.438465,48,68,0.52,20,0.026,0
3277.284816,35,60,0.94,25,0.0376,0
3277.025137,54,85,0.93,31,0.03,0
3276.766644,58,73,0.51,15,0.034,0
3275.951865,53,80,0.89,27,0.032962963,0
3275.618653,45,65,0.69,20,0.0345,0
3275.159394,50,83,0.96,33,0.029090909,0
3274.729283,58,81,0.67,23,0.029130435,0
3274.233209,66,88,0.41,22,0.018636364,0
3273.764495,59,80,0.6,21,0.028571429,0
3273.224107,55,84,0.84,29,0.028965517,0
3273.224107,53,87,0.98,34,0.028823529,0
3272.298329,59,85,0.65,26,0.025,0
3271.908517,62,72,0.32,10,0.032,0
3271.685755,55,84,0.85,29,0.029310345,0
3271.685755,54,85,0.91,31,0.029354839,0
3271.450829,55,84,0.87,29,0.03,0
3270.950918,55,76,0.71,21,0.033809524,0
3270.761478,53,79,0.76,26,0.029230769,0
3270.761013,52,80,0.82,28,0.029285714,0
3270.761013,51,81,0.88,30,0.029333333,0
3269.69467,55,89,0.86,34,0.025294118,0
3268.75723,60,71,0.37,11,0.033636364,0
3268.05653,57,82,0.73,25,0.0292,0
3268.05653,56,83,0.79,27,0.029259259,0
3268.05653,54,86,0.93,32,0.0290625,0
3268.05653,53,87,0.99,34,0.029117647,0
3267.228745,39,54,0.56,15,0.037333333,0
3267.044653,65,88,0.44,23,0.019130435,0
3267.044653,64,89,0.48,25,0.0192,0
3266.455779,60,69,0.28,9,0.031111111,0
3265.400374,63,68,0.17,5,0.034,0
3265.059724,64,78,0.4,14,0.028571429,0
3264.920623,65,89,0.45,24,0.01875,0
3263.74708,53,79,0.87,26,0.033461538,0
3263.236497,63,90,0.52,27,0.019259259,0
3262.473973,57,75,0.6,18,0.033333333,0
3261.277182,51,80,0.96,29,0.033103448,0
3260.886358,60,74,0.44,14,0.031428571,0
3260.676308,61,72,0.36,11,0.032727273,0
3259.747266,50,82,0.96,32,0.03,0
3258.217625,51,81,0.9,30,0.03,0
3258.166953,63,68,0.16,5,0.032,0
3257.64468,60,71,0.35,11,0.031818182,0
3257.053903,60,75,0.47,15,0.031333333,0
3257.026477,59,71,0.37,12,0.030833333,0
3257.026477,58,72,0.43,14,0.030714286,0
3256.800299,54,86,0.92,32,0.02875,0
3256.106501,55,77,0.74,22,0.033636364,0
3256.092234,64,91,0.5,27,0.018518519,0
3256.092234,61,94,0.61,33,0.018484848,0
3254.35742,61,93,0.61,32,0.0190625,0
3254.194712,53,79,0.77,26,0.029615385,0
3254.19425,50,83,0.97,33,0.029393939,0
3253.362235,71,84,0.24,13,0.018461538,0
3253.178965,37,56,0.72,19,0.037894737,0
3253.117229,44,71,0.84,27,0.031111111,0
3252.328815,36,60,0.87,24,0.03625,0
3252.299625,65,90,0.46,25,0.0184,0
3252.116736,53,92,0.97,39,0.024871795,0
3252.039641,35,61,0.98,26,0.037692308,0
3251.804318,54,91,0.92,37,0.024864865,0
3251.030442,49,66,0.46,17,0.027058824,0
3249.539745,55,90,0.87,35,0.024857143,0
3249.089298,63,92,0.54,29,0.01862069,0
3248.915083,61,73,0.38,12,0.031666667,0
3248.515638,50,81,0.95,31,0.030645161,0
3248.298529,52,80,0.83,28,0.029642857,0
3248.246491,55,77,0.73,22,0.033181818,0
3247.734998,59,72,0.44,13,0.033846154,0
3247.388203,47,66,0.59,19,0.031052632,0
3246.979251,58,74,0.53,16,0.033125,0
3246.939275,63,69,0.19,6,0.031666667,0
3246.939275,60,72,0.38,12,0.031666667,0
3246.836825,38,55,0.64,17,0.037647059,0
3246.426955,60,98,0.7,38,0.018421053,0
3245.418685,46,68,0.69,22,0.031363636,0
3244.773415,63,79,0.46,16,0.02875,0
3244.334993,59,76,0.53,17,0.031176471,0
3244.221043,65,76,0.32,11,0.029090909,0
3244.221043,62,80,0.52,18,0.028888889,0
3244.182435,53,86,0.98,33,0.02969697,0
3243.24856,64,70,0.19,6,0.031666667,0
3242.521872,43,52,0.33,9,0.036666667,0
3242.289907,56,75,0.64,19,0.033684211,0
3242.289907,54,78,0.8,24,0.033333333,0
3241.706237,60,72,0.4,12,0.033333333,0
3240.307862,53,78,0.85,25,0.034,0
3239.942734,61,96,0.64,35,0.018285714,0
3239.888619,60,70,0.31,10,0.031,0
3239.734399,60,70,0.34,10,0.034,0
3239.734399,57,74,0.57,17,0.033529412,0
3239.479999,57,78,0.65,21,0.030952381,0
3239.414412,61,77,0.48,16,0.03,0
3239.414412,60,78,0.54,18,0.03,0
3238.981409,43,68,0.84,25,0.0336,0
3238.55889,60,73,0.41,13,0.031538462,0
3237.820628,56,77,0.69,21,0.032857143,0
3237.771481,59,74,0.47,15,0.031333333,0
3237.639619,58,73,0.44,15,0.029333333,0
3237.639619,57,74,0.5,17,0.029411765,0
3237.639619,56,75,0.56,19,0.029473684,0
3237.639619,55,76,0.62,21,0.02952381,0
3237.28532,37,58,0.78,21,0.037142857,0
3237.194223,58,72,0.46,14,0.032857143,0
3237.046529,62,94,0.6,32,0.01875,0
3236.750554,62,93,0.58,31,0.018709677,0
3236.750554,61,94,0.62,33,0.018787879,0
3234.681944,59,75,0.51,16,0.031875,0
3234.681944,57,77,0.64,20,0.032,0
3234.076648,67,87,0.37,20,0.0185,0
3233.997755,35,61,0.97,26,0.037307692,0
3233.982376,63,91,0.52,28,0.018571429,0
3233.420129,55,75,0.68,20,0.034,0
3233.420129,54,76,0.75,22,0.034090909,0
3233.32939,54,93,0.95,39,0.024358974,0
3233.054748,54,79,0.82,25,0.0328,0
3232.011484,51,65,0.37,14,0.026428571,0
3231.573892,60,95,0.66,35,0.018857143,0
3231.547533,60,70,0.33,10,0.033,0
3229.088887,57,73,0.53,16,0.033125,0
3229.088887,56,74,0.6,18,0.033333333,0
3228.739387,60,75,0.46,15,0.030666667,0
3228.602178,61,95,0.63,34,0.018529412,0
3228.370035,52,80,0.86,28,0.030714286,0
3228.300958,53,92,0.98,39,0.025128205,0
3227.172922,63,69,0.2,6,0.033333333,0
3226.7847,58,73,0.46,15,0.030666667,0
3226.525859,57,88,0.77,31,0.02483871,0
3226.066924,41,52,0.42,11,0.038181818,0
3225.60829,60,87,0.55,27,0.02037037,0
3224.015641,62,95,0.61,33,0.018484848,0
3223.290132,39,75,0.99,36,0.0275,0
3223.24849,54,92,0.94,38,0.024736842,0
3223.24849,53,93,0.99,40,0.02475,0
3222.996654,64,84,0.52,20,0.026,0
3222.165333,67,89,0.4,22,0.018181818,0
3221.964885,60,96,0.67,36,0.018611111,0
3221.939206,61,69,0.27,8,0.03375,0
3221.780191,54,85,0.89,31,0.028709677,0
3221.780191,53,86,0.95,33,0.028787879,0
3221.451475,63,94,0.57,31,0.018387097,0
3221.203045,61,88,0.7,27,0.025925926,0
3220.737515,62,93,0.59,31,0.019032258,0
3220.737515,61,94,0.63,33,0.019090909,0
3220.737515,59,97,0.72,38,0.018947368,0
3220.737515,58,98,0.76,40,0.019,0
3220.625212,52,58,0.2,6,0.033333333,0
3220.062783,62,92,0.56,30,0.018666667,0
3219.792771,55,80,0.78,25,0.0312,0
3219.505721,52,60,0.25,8,0.03125,0
3219.41531,53,93,0.98,40,0.0245,0
3218.757638,56,89,0.82,33,0.024848485,0
3218.439692,53,78,0.82,25,0.0328,0
3218.28937,59,74,0.49,15,0.032666667,0
3218.075166,41,53,0.45,12,0.0375,0
3217.183407,54,93,0.96,39,0.024615385,0
3216.75961,61,71,0.33,10,0.033,0
3215.602987,56,74,0.56,18,0.031111111,0
3215.553212,54,77,0.71,23,0.030869565,0
3215.450336,64,67,0.1,3,0.033333333,0
3215.450336,61,70,0.3,9,0.033333333,0
3215.358866,55,76,0.65,21,0.030952381,0
3214.81524,56,88,0.81,32,0.0253125,0
3213.516609,59,70,0.34,11,0.030909091,0
3212.957207,59,75,0.5,16,0.03125,0
3212.103634,62,94,0.59,32,0.0184375,0
3210.938762,53,88,0.96,35,0.027428571,0
3209.599023,57,73,0.49,16,0.030625,0
3209.474149,55,91,0.89,36,0.024722222,0
3208.683679,46,69,0.71,23,0.030869565,0
3207.924429,42,52,0.37,10,0.037,0
3207.879643,61,96,0.65,35,0.018571429,0
3207.879643,60,97,0.69,37,0.018648649,0
3207.879643,59,98,0.73,39,0.018717949,0
3207.640821,48,68,0.53,20,0.0265,0
3207.456201,55,78,0.75,23,0.032608696,0
3206.892534,56,73,0.53,17,0.031176471,0
3205.318845,55,75,0.61,20,0.0305,0
3204.743102,50,66,0.42,16,0.02625,0
3204.097601,61,95,0.64,34,0.018823529,0
3204.097601,60,96,0.68,36,0.018888889,0
3202.06162,47,69,0.59,22,0.026818182,0
3202.035725,59,73,0.47,14,0.033571429,0
3201.803359,46,52,0.19,6,0.031666667,0
3201.77465,54,85,0.92,31,0.029677419,0
3201.745748,54,91,0.93,37,0.025135135,0
3201.723163,63,68,0.15,5,0.03,0
3201.723163,62,69,0.21,7,0.03,0
3201.723163,61,70,0.27,9,0.03,0
3201.514778,40,57,0.61,17,0.035882353,0
3201.470438,45,49,0.15,4,0.0375,0
3200.38182,43,68,0.85,25,0.034,0
3199.704805,66,90,0.44,24,0.018333333,0
3199.131702,51,80,0.97,29,0.033448276,0
3198.70395,56,74,0.61,18,0.033888889,0
3198.675137,40,56,0.58,16,0.03625,0
3198.392667,62,76,0.42,14,0.03,0
3198.002047,68,80,0.31,12,0.025833333,0
3198.002047,67,81,0.36,14,0.025714286,0
3197.77598,56,84,0.8,28,0.028571429,0
3196.393178,53,87,0.96,34,0.028235294,0
3195.919217,60,71,0.33,11,0.03,0
3195.554638,57,72,0.47,15,0.031333333,0
3194.680499,55,83,0.84,28,0.03,0
3194.045745,64,66,0.06,2,0.03,0
3194.045745,63,67,0.12,4,0.03,0
3194.045745,62,68,0.18,6,0.03,0
3194.045745,61,69,0.24,8,0.03,0
3192.25574,63,70,0.22,7,0.031428571,0
3192.213027,41,51,0.38,10,0.038,0
3191.993962,57,78,0.58,21,0.027619048,0
3191.993962,55,80,0.69,25,0.0276,0
3191.823582,47,66,0.6,19,0.031578947,0
3191.706814,62,71,0.28,9,0.031111111,0
3191.439247,59,72,0.39,13,0.03,0
3191.439247,58,73,0.45,15,0.03,0
3191.439247,57,74,0.51,17,0.03,0
3191.439247,56,75,0.57,19,0.03,0
3191.083572,37,57,0.76,20,0.038,0
3190.353593,64,67,0.09,3,0.03,0
3189.770969,43,51,0.3,8,0.0375,0
3189.049291,59,73,0.4,14,0.028571429,0
3188.839747,60,70,0.3,10,0.03,0
3188.667569,56,77,0.68,21,0.032380952,0
3188.342812,52,78,0.8,26,0.030769231,0
3187.929713,43,72,0.87,29,0.03,0
3187.929431,63,76,0.37,13,0.028461538,0
3186.87399,44,66,0.76,22,0.034545455,0
3186.87399,43,67,0.83,24,0.034583333,0
3186.671612,49,67,0.46,18,0.025555556,0
3186.635617,56,74,0.55,18,0.030555556,0
3186.619923,55,76,0.68,21,0.032380952,0
3186.358105,59,73,0.46,14,0.032857143,0
3186.358105,56,76,0.66,20,0.033,0
3186.240568,57,75,0.59,18,0.032777778,0
3186.178723,60,94,0.65,34,0.019117647,0
3186.15475,58,82,0.68,24,0.028333333,0
3186.15475,57,83,0.74,26,0.028461538,0
3186.153061,62,69,0.23,7,0.032857143,0
3186.153061,60,72,0.39,12,0.0325,0
3185.625815,65,74,0.26,9,0.028888889,0
3185.614217,62,91,0.56,29,0.019310345,0
3185.602913,36,59,0.87,23,0.037826087,0
3185.503765,58,76,0.57,18,0.031666667,0
3185.262453,53,83,0.82,30,0.027333333,0
3184.907138,44,50,0.22,6,0.036666667,0
3183.947495,54,90,0.92,36,0.025555556,0
3183.947495,53,91,0.97,38,0.025526316,0
3183.921437,61,71,0.32,10,0.032,0
3183.921437,58,75,0.54,17,0.031764706,0
3183.727915,59,72,0.43,13,0.033076923,0
3183.312309,60,82,0.47,22,0.021363636,0
3183.088906,62,86,0.63,24,0.02625,0
3182.829536,61,92,0.6,31,0.019354839,0
3182.545129,61,73,0.37,12,0.030833333,0
3182.530085,56,75,0.58,19,0.030526316,0
3182.530085,55,76,0.64,21,0.03047619,0
3182.530085,52,80,0.85,28,0.030357143,0
3182.46117,48,67,0.57,19,0.03,0
3182.081815,51,80,0.88,29,0.030344828,0
3182.081815,50,81,0.94,31,0.030322581,0
3181.446159,49,67,0.47,18,0.026111111,0
3181.400526,46,71,0.66,25,0.0264,0
3181.359844,52,84,0.88,32,0.0275,0
3181.304256,66,73,0.2,7,0.028571429,0
3180.802573,43,49,0.23,6,0.038333333,0
3180.758318,53,78,0.77,25,0.0308,0
3180.306346,35,61,0.96,26,0.036923077,0
3179.126357,39,57,0.65,18,0.036111111,0
3178.671315,55,76,0.63,21,0.03,0
3178.039499,57,76,0.6,19,0.031578947,0
3177.861502,50,82,0.95,32,0.0296875,0
3177.065317,52,79,0.83,27,0.030740741,0
3176.540512,60,88,0.56,28,0.02,0
3176.40368,58,76,0.56,18,0.031111111,0
3175.988181,42,74,0.95,32,0.0296875,0
3175.529598,47,65,0.58,18,0.032222222,0
3174.648422,55,75,0.62,20,0.031,0
3174.515241,52,79,0.84,27,0.031111111,0
3174.130538,48,69,0.55,21,0.026190476,0
3174.112347,46,49,0.11,3,0.036666667,0
3173.259065,59,81,0.63,22,0.028636364,0
3173.071378,54,76,0.68,22,0.030909091,0
3173.025354,58,82,0.67,24,0.027916667,0
3173.025354,57,83,0.73,26,0.028076923,0
3172.85499,57,74,0.55,17,0.032352941,0
3172.258452,40,55,0.56,15,0.037333333,0
3171.953901,60,80,0.56,20,0.028,0
3171.953901,59,81,0.62,22,0.028181818,0
3171.553973,42,54,0.43,12,0.035833333,0
3171.490065,45,69,0.73,24,0.030416667,0
3171.466106,59,84,0.53,25,0.0212,0
3171.400967,37,61,0.85,24,0.035416667,0
3171.258717,56,84,0.79,28,0.028214286,0
3171.258717,53,88,0.99,35,0.028285714,0
3171.226607,57,74,0.52,17,0.030588235,0
3171.123011,55,85,0.87,30,0.029,0
3170.805376,58,79,0.63,21,0.03,0
3170.805376,57,80,0.69,23,0.03,0
3170.805376,53,85,0.96,32,0.03,0
3170.187842,55,86,0.87,31,0.028064516,0
3170.187842,54,87,0.93,33,0.028181818,0
3170.117292,45,68,0.72,23,0.031304348,0
3169.828268,37,59,0.8,22,0.036363636,0
3169.706798,60,83,0.59,23,0.025652174,0
3169.26828,47,69,0.58,22,0.026363636,0
3168.86009,58,77,0.59,19,0.031052632,0
3168.308024,51,81,0.91,30,0.030333333,0
3168.247435,48,68,0.56,20,0.028,0
3168.156471,54,85,0.9,31,0.029032258,0
3168.156471,53,86,0.96,33,0.029090909,0
3168.13798,59,71,0.4,12,0.033333333,0
3167.970231,47,70,0.6,23,0.026086957,0
3167.153626,62,72,0.31,10,0.031,0
3167.134057,47,69,0.66,22,0.03,0
3167.013074,61,82,0.44,21,0.020952381,0
3166.677622,40,52,0.46,12,0.038333333,0
3166.666034,56,82,0.77,26,0.029615385,0
3166.666034,55,83,0.83,28,0.029642857,0
3166.666034,54,84,0.89,30,0.029666667,0
3166.666034,53,85,0.95,32,0.0296875,0
3166.666034,53,86,0.97,33,0.029393939,0
3166.543934,50,82,0.98,32,0.030625,0
3166.484529,64,69,0.16,5,0.032,0
3166.442891,57,82,0.74,25,0.0296,0
3166.406161,48,67,0.51,19,0.026842105,0
3165.46629,55,78,0.73,23,0.03173913,0
3165.355096,61,81,0.58,20,0.029,0
3165.355096,60,82,0.64,22,0.029090909,0
3164.545703,61,72,0.35,11,0.031818182,0
3164.545703,59,74,0.48,15,0.032,0
3163.983374,51,80,0.9,29,0.031034483,0
3163.757477,48,67,0.58,19,0.030526316,0
3163.095078,48,65,0.53,17,0.031176471,0
3162.593893,54,87,0.96,33,0.029090909,0
3162.235067,58,83,0.68,25,0.0272,0
3161.89819,63,79,0.34,16,0.02125,0
3161.516568,51,64,0.35,13,0.026923077,0
3160.190737,55,85,0.86,30,0.028666667,0
3159.944824,51,81,0.92,30,0.030666667,0
3159.850148,49,64,0.47,15,0.031333333,0
3159.797329,46,67,0.66,21,0.031428571,0
3158.459933,64,68,0.13,4,0.0325,0
3158.459933,62,70,0.26,8,0.0325,0
3158.283251,54,87,0.91,33,0.027575758,0
3157.016287,46,67,0.67,21,0.031904762,0
3156.479879,57,75,0.52,18,0.028888889,0
3156.420009,47,67,0.61,20,0.0305,0
3156.278585,42,53,0.4,11,0.036363636,0
3156.233888,52,80,0.94,28,0.033571429,0
3155.853047,58,73,0.5,15,0.033333333,0
3155.126017,56,78,0.69,22,0.031363636,0
3155.058737,60,80,0.57,20,0.0285,0
3154.784434,45,69,0.75,24,0.03125,0
3154.615011,44,51,0.26,7,0.037142857,0
3154.169237,57,76,0.62,19,0.032631579,0
3153.86596,47,68,0.65,21,0.030952381,0
3153.793763,42,79,0.93,37,0.025135135,0
3153.436779,61,85,0.49,24,0.020416667,0
3153.433687,56,75,0.59,19,0.031052632,0
3153.290344,46,72,0.69,26,0.026538462,0
3153.088281,58,74,0.46,16,0.02875,0
3153.00905,65,82,0.45,17,0.026470588,0
3152.675998,53,78,0.76,25,0.0304,0
3152.384971,41,57,0.56,16,0.035,0
3151.430442,58,77,0.52,19,0.027368421,0
3151.430442,56,79,0.63,23,0.027391304,0
3151.35181,58,76,0.5,18,0.027777778,0
3151.025013,59,96,0.7,37,0.018918919,0
3150.402888,53,89,0.98,36,0.027222222,0
3148.328057,55,86,0.86,31,0.027741935,0
3148.328057,54,87,0.92,33,0.027878788,0
3148.120904,71,76,0.13,5,0.026,0
3147.956469,40,55,0.55,15,0.036666667,0
3147.891427,40,75,0.9,35,0.025714286,0
3147.436915,59,90,0.81,31,0.026129032,0
3146.984706,61,70,0.29,9,0.032222222,0
3146.984706,59,72,0.42,13,0.032307692,0
3146.984706,58,74,0.51,16,0.031875,0
3146.984706,56,76,0.64,20,0.032,0
3145.787773,55,85,0.88,30,0.029333333,0
3145.636857,64,69,0.14,5,0.028,0
3145.636857,58,75,0.48,17,0.028235294,0
3145.331187,55,81,0.71,26,0.027307692,0
3145.050778,54,77,0.69,23,0.03,0
3144.988911,69,73,0.11,4,0.0275,0
3144.988911,67,75,0.22,8,0.0275,0
3144.988911,66,75,0.25,9,0.027777778,0
3144.988911,65,77,0.33,12,0.0275,0
3144.988911,63,79,0.44,16,0.0275,0
3144.988911,61,81,0.55,20,0.0275,0
3144.988911,60,83,0.63,23,0.027391304,0
3144.833689,41,54,0.48,13,0.036923077,0
3144.036058,53,81,0.89,28,0.031785714,0
3144.031607,53,89,0.99,36,0.0275,0
3143.924571,39,60,0.73,21,0.034761905,0
3143.888947,52,63,0.29,11,0.026363636,0
3143.709729,52,79,0.82,27,0.03037037,0
3143.58804,61,79,0.51,18,0.028333333,0
3143.237407,63,78,0.42,15,0.028,0
3143.237407,62,80,0.5,18,0.027777778,0
3143.237407,60,82,0.61,22,0.027727273,0
3143.237407,59,84,0.69,25,0.0276,0
3142.75272,67,80,0.34,13,0.026153846,0
3142.183009,38,60,0.78,22,0.035454545,0
3141.555675,59,73,0.45,14,0.032142857,0
3141.555675,57,75,0.58,18,0.032222222,0
3141.555675,56,77,0.67,21,0.031904762,0
3141.555675,55,77,0.71,22,0.032272727,0
3141.555675,54,79,0.8,25,0.032,0
3141.453409,51,81,0.93,30,0.031,0
3141.292616,53,86,0.99,33,0.03,0
3141.002422,64,83,0.5,19,0.026315789,0
3140.696877,63,80,0.46,17,0.027058824,0
3140.687582,43,72,0.88,29,0.030344828,0
3140.592702,38,58,0.72,20,0.036,0
3140.399704,53,88,0.89,35,0.025428571,0
3140.395451,58,72,0.47,14,0.033571429,0
3140.360716,57,86,0.75,29,0.025862069,0
3140.155393,53,88,0.98,35,0.028,0
3140.065115,44,71,0.81,27,0.03,0
3139.678018,50,65,0.4,15,0.026666667,0
3139.462014,60,84,0.6,24,0.025,0
3139.345073,64,90,0.5,26,0.019230769,0
3139.345073,63,91,0.54,28,0.019285714,0
3139.174313,43,55,0.38,12,0.031666667,0
3138.947689,58,85,0.74,27,0.027407407,0
3138.904087,42,49,0.27,7,0.038571429,0
3138.890491,53,59,0.19,6,0.031666667,0
3138.823231,48,66,0.55,18,0.030555556,0
3138.444624,51,82,0.9,31,0.029032258,0
3138.388672,43,54,0.39,11,0.035454545,0
3138.388672,42,55,0.46,13,0.035384615,0
3138.383069,39,56,0.62,17,0.036470588,0
3138.328458,57,73,0.54,16,0.03375,0
3137.603098,40,74,0.92,34,0.027058824,0
3137.355245,61,80,0.56,19,0.029473684,0
3137.355245,60,81,0.62,21,0.02952381,0
3137.179014,62,81,0.52,19,0.027368421,0
3137.116669,47,69,0.62,22,0.028181818,0
3136.541623,43,53,0.36,10,0.036,0
3136.378554,56,85,0.8,29,0.027586207,0
3136.378554,54,88,0.93,34,0.027352941,0
3136.121049,42,53,0.41,11,0.037272727,0
3135.683313,62,71,0.29,9,0.032222222,0
3135.683313,60,73,0.42,13,0.032307692,0
3135.683313,58,75,0.55,17,0.032352941,0
3135.431726,57,87,0.82,30,0.027333333,0
3135.419944,58,96,0.92,38,0.024210526,0
3135.071339,63,80,0.48,17,0.028235294,0
3134.790405,55,79,0.77,24,0.032083333,0
3134.756024,65,80,0.31,15,0.020666667,0
3134.147725,54,86,0.95,32,0.0296875,0
3134.05211,51,79,0.87,28,0.031071429,0
3133.269343,54,84,0.9,30,0.03,0
3132.819139,57,84,0.75,27,0.027777778,0
3132.096346,42,73,0.94,31,0.030322581,0
3132.064322,73,82,0.17,9,0.018888889,0
3131.357489,44,53,0.32,9,0.035555556,0
3131.152333,58,86,0.76,28,0.027142857,0
3131.152333,55,90,0.95,35,0.027142857,0
3131.074203,56,85,0.81,29,0.027931034,0
3130.834048,58,98,0.95,40,0.02375,0
3130.464557,57,87,0.76,30,0.025333333,0
3130.195254,53,84,0.84,31,0.027096774,0
3129.924769,58,82,0.69,24,0.02875,0
3129.906824,46,66,0.56,20,0.028,0
3129.859947,54,89,0.91,35,0.026,0
3129.564726,46,59,0.35,13,0.026923077,0
3129.382187,59,86,0.67,27,0.024814815,0
3128.633873,53,79,0.78,26,0.03,0
3128.511991,49,66,0.45,17,0.026470588,0
3128.203138,50,83,0.98,33,0.02969697,0
3127.631302,61,86,0.5,25,0.02,0
3127.107702,39,68,0.96,29,0.033103448,0
3127.050071,68,87,0.36,19,0.018947368,0
3126.29444,43,69,0.8,26,0.030769231,0
3125.624204,56,75,0.62,19,0.032631579,0
3125.259379,58,86,0.71,28,0.025357143,0
3125.259379,56,89,0.83,33,0.025151515,0
3124.950842,61,82,0.57,21,0.027142857,0
3124.766193,54,78,0.71,24,0.029583333,0
3124.348441,64,88,0.59,24,0.024583333,0
3124.348441,61,92,0.76,31,0.024516129,0
3124.348441,60,93,0.81,33,0.024545455,0
3124.348441,60,94,0.82,34,0.024117647,0
3124.348441,59,95,0.87,36,0.024166667,0
3124.18059,64,83,0.38,19,0.02,0
3123.966698,53,61,0.25,8,0.03125,0
3123.86479,46,68,0.67,22,0.030454545,0
3123.534831,50,64,0.43,14,0.030714286,0
3123.531253,52,80,0.84,28,0.03,0
3123.228857,59,83,0.7,24,0.029166667,0
3123.228857,58,84,0.76,26,0.029230769,0
3123.228857,58,85,0.78,27,0.028888889,0
3123.103128,53,77,0.74,24,0.030833333,0
3123.043251,37,61,0.86,24,0.035833333,0
3122.802946,59,88,0.59,29,0.020344828,0
3122.608078,60,95,0.84,35,0.024,0
3122.608078,59,95,0.88,36,0.024444444,0
3122.608078,59,96,0.89,37,0.024054054,0
3122.608078,58,96,0.93,38,0.024473684,0
3122.608078,58,97,0.94,39,0.024102564,0
3122.608078,57,98,0.99,41,0.024146341,0
3122.595634,55,88,0.97,33,0.029393939,0
3121.96986,46,69,0.67,23,0.029130435,0
3121.876983,58,87,0.72,29,0.024827586,0
3121.865708,51,58,0.22,7,0.031428571,0
3121.821134,60,80,0.58,20,0.029,0
3121.717189,64,77,0.36,13,0.027692308,0
3121.56975,63,78,0.43,15,0.028666667,0
3121.177948,37,60,0.82,23,0.035652174,0
3120.804751,53,80,0.87,27,0.032222222,0
3120.236599,47,71,0.6,24,0.025,0
3120.182308,54,83,0.78,29,0.026896552,0
3120.142184,54,87,0.94,33,0.028484848,0
3119.714022,63,89,0.64,26,0.024615385,0
3119.677261,50,81,0.96,31,0.030967742,0
3119.627076,54,88,0.91,34,0.026764706,0
3118.897215,55,79,0.76,24,0.031666667,0
3118.801751,59,84,0.72,25,0.0288,0
3118.691909,51,82,0.89,31,0.028709677,0
3118.691909,50,83,0.95,33,0.028787879,0
3118.448446,54,77,0.7,23,0.030434783,0
3118.342131,54,78,0.78,24,0.0325,0
3118.329141,51,82,0.91,31,0.029354839,0
3118.049487,51,59,0.27,8,0.03375,0
3117.727639,55,90,0.88,35,0.025142857,0
3117.463723,62,81,0.54,19,0.028421053,0
3117.125413,53,91,0.98,38,0.025789474,0
3116.842873,39,58,0.69,19,0.036315789,0
3116.649537,60,85,0.62,25,0.0248,0
3115.935865,43,71,0.86,28,0.030714286,0
3115.547425,66,78,0.3,12,0.025,0
3115.547425,65,79,0.35,14,0.025,0
3115.547425,64,80,0.4,16,0.025,0
3115.547425,63,81,0.45,18,0.025,0
3115.141722,62,84,0.45,22,0.020454545,0
3115.111691,52,89,0.96,37,0.025945946,0
3115.015271,36,63,0.95,27,0.035185185,0
3114.511208,63,71,0.22,8,0.0275,0
3114.510765,61,73,0.33,12,0.0275,0
3114.06579,52,78,0.81,26,0.031153846,0
3113.342925,39,58,0.68,19,0.035789474,0
3113.163621,60,83,0.64,23,0.027826087,0
3112.931862,55,86,0.85,31,0.027419355,0
3112.896543,56,76,0.65,20,0.0325,0
3112.828434,57,89,0.79,32,0.0246875,0
3112.828434,56,90,0.84,34,0.024705882,0
3112.416857,54,81,0.85,27,0.031481481,0
3112.378401,46,68,0.68,22,0.030909091,0
3112.32592,43,73,0.9,30,0.03,0
3112.307471,52,62,0.32,10,0.032,0
3112.077542,54,87,0.84,33,0.025454545,0
3111.71896,42,69,0.93,27,0.034444444,0
3111.429779,38,61,0.8,23,0.034782609,0
3111.286431,56,88,0.88,32,0.0275,0
3110.733148,53,89,0.91,36,0.025277778,0
3110.733148,52,90,0.96,38,0.025263158,0
3110.42565,60,89,0.76,29,0.026206897,0
3110.363634,48,57,0.24,9,0.026666667,0
3110.010947,54,81,0.75,27,0.027777778,0
3110.010947,53,81,0.79,28,0.028214286,0
3110.010947,53,82,0.81,29,0.027931034,0
3109.916384,56,79,0.72,23,0.031304348,0
3109.871766,67,73,0.17,6,0.028333333,0
3109.871766,64,76,0.34,12,0.028333333,0
3109.871766,60,81,0.59,21,0.028095238,0
3109.75413,39,57,0.66,18,0.036666667,0
3109.092748,38,59,0.75,21,0.035714286,0
3108.729813,54,75,0.47,21,0.022380952,0
3108.533656,50,61,0.36,11,0.032727273,0
3108.439617,46,66,0.65,20,0.0325,0
3108.074373,62,82,0.5,20,0.025,0
3108.074373,61,83,0.55,22,0.025,0
3108.032396,46,65,0.59,19,0.031052632,0
3107.667427,43,71,0.87,28,0.031071429,0
3107.444731,38,58,0.74,20,0.037,0
3107.420087,40,67,0.89,27,0.032962963,0
3107.252596,53,62,0.24,9,0.026666667,0
3106.988419,54,77,0.75,23,0.032608696,0
3106.96435,59,94,0.86,35,0.024571429,0
3106.96435,57,97,0.98,40,0.0245,0
3106.942383,63,81,0.49,18,0.027222222,0
3106.799719,60,84,0.65,24,0.027083333,0
3106.467537,72,82,0.19,10,0.019,0
3106.265998,59,82,0.68,23,0.029565217,0
3106.169112,57,86,0.84,29,0.028965517,0
3106.169112,56,87,0.9,31,0.029032258,0
3105.932671,63,84,0.42,21,0.02,0
3105.932671,62,85,0.46,23,0.02,0
3105.847805,36,62,0.92,26,0.035384615,0
3105.69824,50,64,0.38,14,0.027142857,0
3105.56752,44,72,0.84,28,0.03,0
3105.450296,66,74,0.23,8,0.02875,0
3105.095463,53,79,0.84,26,0.032307692,0
3105.068828,58,87,0.78,29,0.026896552,0
3104.979495,52,59,0.23,7,0.032857143,0
3104.711728,61,82,0.6,21,0.028571429,0
3104.312845,57,86,0.8,29,0.027586207,0
3104.285635,59,81,0.64,22,0.029090909,0
3104.219506,52,90,0.97,38,0.025526316,0
3104.181554,58,83,0.69,25,0.0276,0
3103.939251,65,75,0.29,10,0.029,0
3103.939251,62,79,0.49,17,0.028823529,0
3103.757836,52,81,0.94,29,0.032413793,0
3103.754629,59,94,0.87,35,0.024857143,0
3103.75349,64,78,0.39,14,0.027857143,0
3103.75349,61,81,0.56,20,0.028,0
3102.906522,38,58,0.73,20,0.0365,0
3102.731807,68,81,0.33,13,0.025384615,0
3102.731807,67,82,0.38,15,0.025333333,0
3102.731807,64,85,0.54,21,0.025714286,0
3102.731807,63,87,0.61,24,0.025416667,0
3102.731807,62,88,0.66,26,0.025384615,0
3102.643125,43,69,0.81,26,0.031153846,0
3102.643125,42,70,0.87,28,0.031071429,0
3102.643125,41,72,0.96,31,0.030967742,0
3102.642652,67,75,0.17,8,0.02125,0
3102.497802,60,89,0.57,29,0.019655172,0
3102.316333,57,84,0.77,27,0.028518519,0
3102.010489,60,82,0.62,22,0.028181818,0
3101.769567,53,88,0.9,35,0.025714286,0
3101.293652,51,87,0.97,36,0.026944444,0
3101.086255,46,69,0.69,23,0.03,0
3099.731332,57,83,0.75,26,0.028846154,0
3099.731332,56,84,0.81,28,0.028928571,0
3099.731332,55,86,0.89,31,0.028709677,0
3099.731332,54,87,0.95,33,0.028787879,0
3099.500343,51,80,0.89,29,0.030689655,0
3099.49204,60,69,0.31,9,0.034444444,0
3099.283728,46,70,0.68,24,0.028333333,0
3099.274303,64,77,0.37,13,0.028461538,0
3099.274303,59,83,0.68,24,0.028333333,0
3099.069203,57,84,0.74,27,0.027407407,0
3098.999428,59,84,0.71,25,0.0284,0
3098.772371,50,82,0.99,32,0.0309375,0
3098.593761,36,60,0.89,24,0.037083333,0
3098.592364,61,80,0.53,19,0.027894737,0
3098.543194,68,70,0.06,2,0.03,0
3098.543194,67,71,0.12,4,0.03,0
3098.543194,66,72,0.18,6,0.03,0
3098.543194,65,73,0.24,8,0.03,0
3097.900292,63,77,0.4,14,0.028571429,0
3097.896356,55,92,0.9,37,0.024324324,0
3097.854926,54,78,0.72,24,0.03,0
3097.790207,42,73,0.95,31,0.030645161,0
3097.349478,40,71,0.96,31,0.030967742,0
3097.129976,64,74,0.3,10,0.03,0
3097.129976,63,75,0.36,12,0.03,0
3096.259171,57,77,0.56,20,0.028,0
3096.100214,56,71,0.54,15,0.036,0
3095.879717,55,86,0.9,31,0.029032258,0
3095.769572,41,56,0.54,15,0.036,0
3095.726776,65,76,0.31,11,0.028181818,0
3095.391972,53,78,0.83,25,0.0332,0
3095.285072,56,85,0.83,29,0.02862069,0
3095.279638,57,70,0.46,13,0.035384615,0
3095.106123,61,82,0.58,21,0.027619048,0
3095.106123,58,86,0.77,28,0.0275,0
3094.867687,56,89,0.93,33,0.028181818,0
3094.78161,55,74,0.67,19,0.035263158,0
3094.78161,54,75,0.74,21,0.035238095,0
3094.78161,53,76,0.81,23,0.035217391,0
3094.712488,60,71,0.36,11,0.032727273,0
3094.712488,58,73,0.49,15,0.032666667,0
3094.439171,46,51,0.16,5,0.032,0
3094.292804,55,88,0.86,33,0.026060606,0
3094.292804,54,89,0.92,35,0.026285714,0
3094.292804,53,90,0.97,37,0.026216216,0
3094.048985,66,76,0.28,10,0.028,0
3094.048985,63,79,0.45,16,0.028125,0
3094.031544,62,77,0.43,15,0.028666667,0
3093.949411,56,72,0.57,16,0.035625,0
3093.917049,71,88,0.3,17,0.017647059,0
3093.869062,49,67,0.5,18,0.027777778,0
3093.782677,45,66,0.66,21,0.031428571,0
3093.532951,53,79,0.85,26,0.032692308,0
3093.532951,52,80,0.92,28,0.032857143,0
3093.510719,44,71,0.82,27,0.03037037,0
3093.510719,42,74,0.96,32,0.03,0
3093.314158,67,74,0.2,7,0.028571429,0
3093.143307,61,83,0.6,22,0.027272727,0
3092.913199,59,85,0.7,26,0.026923077,0
3092.53002,63,72,0.29,9,0.032222222,0
3092.362103,61,80,0.54,19,0.028421053,0
3091.945968,51,54,0.08,3,0.026666667,0
3091.942105,49,59,0.32,10,0.032,0
3091.89555,40,72,0.9,32,0.028125,0
3091.770867,57,77,0.63,20,0.0315,0
3091.57443,62,80,0.51,18,0.028333333,0
3091.17532,44,70,0.8,26,0.030769231,0
3090.757364,44,53,0.29,9,0.032222222,0
3090.683106,62,83,0.52,21,0.024761905,0
3090.511415,70,84,0.27,14,0.019285714,0
3090.350445,56,85,0.82,29,0.028275862,0
3090.303856,51,80,0.98,29,0.033793103,0
3090.049382,62,89,0.68,27,0.025185185,0
3090.049382,60,90,0.77,30,0.025666667,0
3090.049382,59,92,0.84,33,0.025454545,0
3089.574006,52,57,0.16,5,0.032,0
3089.095248,36,97,0.12,61,0.001967213,0
3089.046308,45,70,0.75,25,0.03,0
3089.046308,43,73,0.89,30,0.029666667,0
3088.744968,59,83,0.64,24,0.026666667,0
3088.667852,60,81,0.57,21,0.027142857,0
3088.667852,58,84,0.7,26,0.026923077,0
3088.497816,56,73,0.59,17,0.034705882,0
3088.497816,55,74,0.66,19,0.034736842,0
3088.438051,37,59,0.81,22,0.036818182,0
3088.331122,56,85,0.84,29,0.028965517,0
3088.123711,52,82,0.96,30,0.032,0
3088.065045,48,62,0.33,14,0.023571429,0
3087.923597,62,90,0.69,28,0.024642857,0
3087.923597,61,91,0.74,30,0.024666667,0
3087.842696,67,83,0.34,16,0.02125,0
3087.103073,52,59,0.16,7,0.022857143,0
3087.028526,38,57,0.71,19,0.037368421,0
3087.020799,56,85,0.79,29,0.027241379,0
3087.020799,54,88,0.92,34,0.027058824,0
3086.892849,58,88,0.74,30,0.024666667,0
3086.892849,55,92,0.91,37,0.024594595,0
3086.550586,54,92,0.95,38,0.025,0
3086.401563,52,81,0.95,29,0.032758621,0
3086.202895,58,95,0.91,37,0.024594595,0
3086.173495,61,78,0.5,17,0.029411765,0
3086.159871,56,86,0.8,30,0.026666667,0
3085.91722,59,82,0.65,23,0.02826087,0
3085.577756,68,73,0.14,5,0.028,0
3085.519924,35,62,0.98,27,0.036296296,0
3085.336732,50,84,0.95,34,0.027941176,0
3085.299938,44,71,0.83,27,0.030740741,0
3085.19747,51,81,0.98,30,0.032666667,0
3085.055967,57,72,0.52,15,0.034666667,0
3084.932323,49,60,0.35,11,0.031818182,0
3084.510468,58,83,0.71,25,0.0284,0
3084.308821,62,91,0.7,29,0.024137931,0
3084.308821,61,92,0.75,31,0.024193548,0
3084.300597,58,70,0.42,12,0.035,0
3084.300597,57,71,0.49,14,0.035,0
3083.617451,55,82,0.72,27,0.026666667,0
3083.607897,44,67,0.77,23,0.033478261,0
3083.013953,60,91,0.78,31,0.02516129,0
3082.690917,57,97,0.99,40,0.02475,0
3082.602142,59,86,0.72,27,0.026666667,0
3082.602142,57,88,0.83,31,0.026774194,0
3082.284968,56,80,0.65,24,0.027083333,0
3082.143009,41,55,0.51,14,0.036428571,0
3081.848912,69,85,0.31,16,0.019375,0
3081.789219,42,71,0.88,29,0.030344828,0
3081.588141,58,85,0.77,27,0.028518519,0
3081.512612,60,95,0.83,35,0.023714286,0
3081.512612,59,96,0.88,37,0.023783784,0
3081.512612,58,97,0.93,39,0.023846154,0
3081.492448,66,75,0.26,9,0.028888889,0
3081.492448,60,82,0.63,22,0.028636364,0
3081.492448,59,83,0.69,24,0.02875,0
3081.492448,58,84,0.75,26,0.028846154,0
3081.492448,57,86,0.83,29,0.02862069,0
3081.064024,49,66,0.52,17,0.030588235,0
3080.884311,56,89,0.89,33,0.026969697,0
3080.850323,59,70,0.38,11,0.034545455,0
3080.399784,59,83,0.67,24,0.027916667,0
3080.399784,58,84,0.73,26,0.028076923,0
3080.399784,56,87,0.86,31,0.027741935,0
3080.250419,54,80,0.83,26,0.031923077,0
3079.992658,57,71,0.5,14,0.035714286,0
3079.80892,72,86,0.25,14,0.017857143,0
3079.032669,57,81,0.63,24,0.02625,0
3079.002816,60,86,0.53,26,0.020384615,0
3078.596281,40,57,0.62,17,0.036470588,0
3078.592465,67,86,0.37,19,0.019473684,0
3078.592465,66,87,0.41,21,0.01952381,0
3077.470054,69,74,0.14,5,0.028,0
3077.333939,54,77,0.76,23,0.033043478,0
3077.155309,61,79,0.5,18,0.027777778,0
3076.860182,65,77,0.34,12,0.028333333,0
3076.860182,60,83,0.65,23,0.02826087,0
3076.860182,58,85,0.76,27,0.028148148,0
3076.860182,57,86,0.82,29,0.028275862,0
3076.860182,56,88,0.9,32,0.028125,0
3076.860182,55,89,0.96,34,0.028235294,0
3076.834264,52,80,0.91,28,0.0325,0
3076.258579,40,67,0.9,27,0.033333333,0
3075.700684,50,66,0.41,16,0.025625,0
3075.390171,55,97,0.85,42,0.020238095,0
3074.914545,56,78,0.62,22,0.028181818,0
3074.602304,36,63,0.96,27,0.035555556,0
3074.527652,39,56,0.63,17,0.037058824,0
3074.338719,68,76,0.21,8,0.02625,0
3074.262504,62,89,0.57,27,0.021111111,0
3074.231076,43,72,0.89,29,0.030689655,0
3073.444411,57,76,0.61,19,0.032105263,0
3073.444411,55,78,0.74,23,0.032173913,0
3073.409569,45,69,0.76,24,0.031666667,0
3073.360694,54,88,0.94,34,0.027647059,0
3073.235438,59,85,0.71,26,0.027307692,0
3072.531133,60,84,0.66,24,0.0275,0
3072.121782,61,90,0.73,29,0.025172414,0
3072.121782,60,92,0.8,32,0.025,0
3072.121782,59,93,0.85,34,0.025,0
3072.121782,58,93,0.89,35,0.025428571,0
3072.121782,58,94,0.9,36,0.025,0
3072.121782,58,95,0.92,37,0.024864865,0
3072.121782,57,95,0.96,38,0.025263158,0
3072.121782,57,96,0.97,39,0.024871795,0
3071.933259,63,86,0.59,23,0.025652174,0
3071.141308,61,80,0.55,19,0.028947368,0
3071.129994,36,61,0.91,25,0.0364,0
3071.107161,55,84,0.75,29,0.025862069,0
3070.941795,61,81,0.57,20,0.0285,0
3070.874901,55,87,0.88,32,0.0275,0
3070.790575,61,84,0.57,23,0.024782609,0
3070.77756,50,65,0.43,15,0.028666667,0
3070.602667,56,83,0.7,27,0.025925926,0
3070.602667,55,85,0.77,30,0.025666667,0
3070.602667,54,86,0.82,32,0.025625,0
3070.480644,60,82,0.58,22,0.026363636,0
3070.480644,58,84,0.69,26,0.026538462,0
3070.480644,56,87,0.82,31,0.026451613,0
3070.436021,55,73,0.64,18,0.035555556,0
3070.40397,57,85,0.75,28,0.026785714,0
3070.380937,54,80,0.73,26,0.028076923,0
3069.996662,56,87,0.89,31,0.028709677,0
3069.828447,63,65,0.07,2,0.035,0
3069.828447,62,66,0.14,4,0.035,0
3069.828447,61,67,0.21,6,0.035,0
3069.828447,60,68,0.28,8,0.035,0
3069.828447,59,69,0.35,10,0.035,0
3069.803972,43,73,0.91,30,0.030333333,0
3069.704176,70,74,0.1,4,0.025,0
3069.704176,69,75,0.15,6,0.025,0
3069.704176,68,76,0.2,8,0.025,0
3069.704176,67,77,0.25,10,0.025,0
3069.373438,44,70,0.81,26,0.031153846,0
3069.196523,62,77,0.44,15,0.029333333,0
3069.05791,52,77,0.88,25,0.0352,0
3068.991381,55,76,0.69,21,0.032857143,0
3068.628841,36,61,0.9,25,0.036,0
3068.372455,42,72,0.94,30,0.031333333,0
3067.981635,74,81,0.13,7,0.018571429,0
3067.94896,76,81,0.09,5,0.018,0
3067.901376,56,88,0.82,32,0.025625,0
3067.901376,55,89,0.87,34,0.025588235,0
3067.901376,54,91,0.94,37,0.025405405,0
3067.901376,53,92,0.99,39,0.025384615,0
3067.728978,58,83,0.72,25,0.0288,0
3067.52958,42,74,0.97,32,0.0303125,0
3067.354358,63,80,0.47,17,0.027647059,0
3067.13838,61,83,0.59,22,0.026818182,0
3067.06086,60,79,0.56,19,0.029473684,0
3067.016582,58,71,0.45,13,0.034615385,0
3066.954431,69,84,0.29,15,0.019333333,0
3066.900304,67,76,0.23,9,0.025555556,0
3066.453752,39,56,0.64,17,0.037647059,0
3066.4069,62,92,0.72,30,0.024,0
3066.4069,61,93,0.77,32,0.0240625,0
3066.326085,61,97,0.66,36,0.018333333,0
3066.139832,45,72,0.8,27,0.02962963,0
3066.048812,53,79,0.86,26,0.033076923,0
3066.048812,52,80,0.93,28,0.033214286,0
3065.979082,41,66,0.82,25,0.0328,0
3065.796567,36,60,0.88,24,0.036666667,0
3065.496522,52,79,0.9,27,0.033333333,0
3065.470476,55,87,0.89,32,0.0278125,0
3065.470476,54,88,0.95,34,0.027941176,0
3065.086097,52,79,0.91,27,0.033703704,0
3064.89244,42,74,0.98,32,0.030625,0
3064.51025,52,85,0.9,33,0.027272727,0
3064.433721,54,82,0.77,28,0.0275,0
3064.398621,70,85,0.28,15,0.018666667,0
3064.396228,49,61,0.28,12,0.023333333,0
3063.717496,47,68,0.63,21,0.03,0
3063.657926,45,52,0.25,7,0.035714286,0
3063.628058,55,76,0.7,21,0.033333333,0
3063.451475,62,80,0.38,18,0.021111111,0
3063.394434,55,87,0.87,32,0.0271875,0
3063.171831,40,66,0.88,26,0.033846154,0
3063.171831,39,67,0.95,28,0.033928571,0
3062.736368,47,52,0.18,5,0.036,0
3062.411653,68,92,0.42,24,0.0175,0
3062.255749,45,70,0.76,25,0.0304,0
3061.752779,53,75,0.79,22,0.035909091,0
3061.537855,39,75,0.98,36,0.027222222,0
3061.106998,51,85,0.94,34,0.027647059,0
3061.039191,64,99,0.61,35,0.017428571,0
3061.02605,62,92,0.58,30,0.019333333,0
3061.02605,61,93,0.62,32,0.019375,0
3060.930665,51,89,0.99,38,0.026052632,0
3060.895741,46,69,0.72,23,0.031304348,0
3060.860097,50,60,0.31,10,0.031,0
3060.562255,65,79,0.37,14,0.026428571,0
3060.519105,58,82,0.7,24,0.029166667,0
3060.519105,57,83,0.76,26,0.029230769,0
3060.519105,56,84,0.82,28,0.029285714,0
3060.386139,45,70,0.78,25,0.0312,0
3060.367058,57,84,0.78,27,0.028888889,0
3060.097905,62,79,0.48,17,0.028235294,0
3060.097905,58,85,0.75,27,0.027777778,0
3059.990837,65,97,0.57,32,0.0178125,0
3059.462688,29,87,0.21,58,0.00362069,0
3059.312388,66,76,0.21,10,0.021,0
3059.244057,56,88,0.91,32,0.0284375,0
3059.149036,55,89,0.97,34,0.028529412,0
3058.670193,75,81,0.11,6,0.018333333,0
3058.246624,67,88,0.4,21,0.019047619,0
3057.925529,44,68,0.73,24,0.030416667,0
3057.873436,53,80,0.77,27,0.028518519,0
3057.535236,39,76,0.99,37,0.026756757,0
3057.456081,62,83,0.43,21,0.02047619,0
3057.256035,65,84,0.46,19,0.024210526,0
3057.223372,52,77,0.89,25,0.0356,0
3056.598752,60,80,0.59,20,0.0295,0
3056.451628,41,73,0.83,32,0.0259375,0
3056.070631,49,65,0.5,16,0.03125,0
3055.808843,60,83,0.66,23,0.028695652,0
3055.615344,53,81,0.9,28,0.032142857,0
3055.316836,36,62,0.94,26,0.036153846,0
3055.053748,56,87,0.81,31,0.026129032,0
3055.053748,54,90,0.93,36,0.025833333,0
3055.053748,54,90,0.94,36,0.026111111,0
3055.053748,53,91,0.99,38,0.026052632,0
3054.988764,60,81,0.6,21,0.028571429,0
3054.988764,59,82,0.66,23,0.028695652,0
3054.988764,58,84,0.74,26,0.028461538,0
3054.781947,59,72,0.4,13,0.030769231,0
3054.511807,62,78,0.46,16,0.02875,0
3054.414004,62,82,0.51,20,0.0255,0
3054.251894,49,66,0.49,17,0.028823529,0
3054.230572,69,81,0.22,12,0.018333333,0
3054.072954,58,74,0.52,16,0.0325,0
3054.001621,55,88,0.93,33,0.028181818,0
3053.989547,55,86,0.88,31,0.028387097,0
3053.928994,39,55,0.61,16,0.038125,0
3053.893111,52,83,0.86,31,0.027741935,0
3053.881045,43,71,0.9,28,0.032142857,0
3053.854955,66,77,0.3,11,0.027272727,0
3053.691915,58,94,0.91,36,0.025277778,0
3053.658214,67,76,0.25,9,0.027777778,0
3053.587408,56,91,0.73,35,0.020857143,0
3053.506267,36,64,0.97,28,0.034642857,0
3053.489934,54,77,0.77,23,0.033478261,0
3053.449755,56,78,0.7,22,0.031818182,0
3053.441147,59,81,0.65,22,0.029545455,0
3053.440111,61,89,0.72,28,0.025714286,0
3053.387363,55,89,0.94,34,0.027647059,0
3053.250646,41,66,0.83,25,0.0332,0
3053.126208,72,78,0.11,6,0.018333333,0
3053.124666,54,88,0.98,34,0.028823529,0
3053.001966,45,69,0.74,24,0.030833333,0
3052.944708,53,89,0.97,36,0.026944444,0
3052.576655,65,88,0.45,23,0.019565217,0
3052.422641,71,83,0.23,12,0.019166667,0
3052.405019,59,91,0.82,32,0.025625,0
3052.376621,56,77,0.6,21,0.028571429,0
3052.376621,55,79,0.68,24,0.028333333,0
3052.35413,59,68,0.32,9,0.035555556,0
3052.342789,66,83,0.41,17,0.024117647,0
3051.745282,55,77,0.72,22,0.032727273,0
3051.347661,61,66,0.18,5,0.036,0
3051.256879,68,75,0.18,7,0.025714286,0
3051.256879,63,81,0.46,18,0.025555556,0
3050.970112,64,75,0.32,11,0.029090909,0
3050.818536,64,81,0.35,17,0.020588235,0
3050.648469,65,78,0.36,13,0.027692308,0
3050.636289,52,89,0.95,37,0.025675676,0
3050.365783,38,59,0.77,21,0.036666667,0
3049.959179,55,87,0.91,32,0.0284375,0
3049.567373,53,79,0.79,26,0.030384615,0
3049.481642,48,66,0.56,18,0.031111111,0
3049.248135,39,59,0.71,20,0.0355,0
3048.804573,58,70,0.27,12,0.0225,0
3048.659713,57,88,0.84,31,0.027096774,0
3048.576954,37,63,0.9,26,0.034615385,0
3048.43503,67,76,0.24,9,0.026666667,0
3048.363674,35,62,0.99,27,0.036666667,0
3048.212013,40,58,0.64,18,0.035555556,0
3048.087754,68,75,0.19,7,0.027142857,0
3048.087754,64,80,0.43,16,0.026875,0
3048.087754,62,82,0.54,20,0.027,0
3048.046433,45,51,0.2,6,0.033333333,0
3047.814369,38,61,0.82,23,0.035652174,0
3047.583477,46,70,0.64,24,0.026666667,0
3047.507658,54,60,0.16,6,0.026666667,0
3047.424442,54,89,0.94,35,0.026857143,0
3047.307406,65,90,0.5,25,0.02,0
3047.020721,55,88,0.87,33,0.026363636,0
3046.88843,53,87,0.88,34,0.025882353,0
3046.708883,41,71,0.84,30,0.028,0
3046.708883,40,73,0.91,33,0.027575758,0
3046.708883,39,74,0.97,35,0.027714286,0
3046.60876,36,61,0.92,25,0.0368,0
3046.508227,39,68,0.97,29,0.033448276,0
3046.310057,51,78,0.96,27,0.035555556,0
3046.278975,43,72,0.9,29,0.031034483,0
3046.278975,42,73,0.96,31,0.030967742,0
3046.138077,60,67,0.25,7,0.035714286,0
3045.912731,66,78,0.32,12,0.026666667,0
3045.616835,43,75,0.96,32,0.03,0
3045.25607,44,69,0.79,25,0.0316,0
3045.178716,68,82,0.35,14,0.025,0
3044.908346,54,74,0.71,20,0.0355,0
3044.845788,74,84,0.18,10,0.018,0
3044.783373,36,64,0.98,28,0.035,0
3044.780525,56,59,0.08,3,0.026666667,0
3044.623332,56,96,0.81,40,0.02025,0
3044.617818,51,64,0.37,13,0.028461538,0
3044.515066,54,92,0.96,38,0.025263158,0
3044.433523,57,88,0.87,31,0.028064516,0
3044.2823,47,68,0.61,21,0.029047619,0
3044.213964,61,79,0.53,18,0.029444444,0
3044.128379,57,87,0.83,30,0.027666667,0
3044.128379,55,90,0.96,35,0.027428571,0
3043.75385,46,69,0.7,23,0.030434783,0
3043.729583,47,68,0.57,21,0.027142857,0
3043.678829,63,76,0.38,13,0.029230769,0
3043.404221,37,60,0.83,23,0.036086957,0
3043.404221,36,62,0.93,26,0.035769231,0
3043.210841,52,87,0.93,35,0.026571429,0
3043.132041,37,61,0.87,24,0.03625,0
3043.080336,56,88,0.89,32,0.0278125,0
3042.517358,45,71,0.74,26,0.028461538,0
3042.50518,45,67,0.72,22,0.032727273,0
3042.367328,67,79,0.24,12,0.02,0
3042.269998,58,85,0.7,27,0.025925926,0
3042.269998,55,89,0.88,34,0.025882353,0
3042.040412,59,84,0.7,25,0.028,0
3042.023506,51,88,0.98,37,0.026486486,0
3042.021467,61,84,0.47,23,0.020434783,0
3041.946837,67,93,0.47,26,0.018076923,0
3041.849667,60,68,0.18,8,0.0225,0
3041.762684,46,70,0.72,24,0.03,0
3041.659795,55,72,0.61,17,0.035882353,0
3041.560362,59,80,0.62,21,0.02952381,0
3041.068748,54,87,0.97,33,0.029393939,0
3040.857515,70,73,0.08,3,0.026666667,0
3040.851551,52,62,0.27,10,0.027,0
3040.817097,57,86,0.81,29,0.027931034,0
3040.748615,63,82,0.39,19,0.020526316,0
3040.501492,51,81,0.99,30,0.033,0
3040.457156,50,64,0.44,14,0.031428571,0
3040.443188,57,85,0.8,28,0.028571429,0
3040.443188,56,86,0.86,30,0.028666667,0
3040.443188,55,88,0.94,33,0.028484848,0
3040.353855,45,72,0.81,27,0.03,0
3040.348732,55,87,0.92,32,0.02875,0
3040.255549,37,59,0.82,22,0.037272727,0
3040.21274,68,79,0.21,11,0.019090909,0
3040.151811,54,89,0.95,35,0.027142857,0
3040.050337,40,76,0.91,36,0.025277778,0
3039.947236,47,63,0.54,16,0.03375,0
3039.813316,53,95,0.97,42,0.023095238,0
3039.779903,54,79,0.81,25,0.0324,0
3039.534268,42,69,0.91,27,0.033703704,0
3039.463239,66,79,0.27,13,0.020769231,0
3039.460596,54,89,0.99,35,0.028285714,0
3039.431973,59,67,0.29,8,0.03625,0
3039.418146,39,68,0.98,29,0.033793103,0
3039.075671,40,56,0.59,16,0.036875,0
3039.054153,45,66,0.6,21,0.028571429,0
3038.904184,69,74,0.13,5,0.026,0
3038.707896,62,85,0.47,23,0.020434783,0
3038.696382,54,60,0.18,6,0.03,0
3038.696382,53,61,0.24,8,0.03,0
3038.417347,52,62,0.31,10,0.031,0
3038.279629,73,84,0.2,11,0.018181818,0
3038.128457,60,95,0.67,35,0.019142857,0
3038.128457,59,96,0.71,37,0.019189189,0
3037.667057,48,67,0.55,19,0.028947368,0
3037.462779,54,78,0.79,24,0.032916667,0
3037.462779,53,80,0.88,27,0.032592593,0
3037.429492,54,89,0.96,35,0.027428571,0
3037.220168,37,60,0.84,23,0.036521739,0
3037.207096,55,90,0.89,35,0.025428571,0
3037.196072,56,86,0.85,30,0.028333333,0
3036.713059,41,72,0.95,31,0.030645161,0
3036.349652,54,86,0.94,32,0.029375,0
3036.19587,51,86,0.96,35,0.027428571,0
3036.099864,43,70,0.86,27,0.031851852,0
3035.746164,51,79,0.96,28,0.034285714,0
3035.306839,70,86,0.29,16,0.018125,0
3035.063881,56,75,0.63,19,0.033157895,0
3035.023148,61,74,0.42,13,0.032307692,0
3034.662045,50,61,0.34,11,0.030909091,0
3034.26952,57,86,0.76,29,0.026206897,0
3034.067193,57,87,0.77,30,0.025666667,0
3033.907326,62,68,0.2,6,0.033333333,0
3033.907326,57,74,0.56,17,0.032941176,0
3033.563202,66,78,0.25,12,0.020833333,0
3033.272085,57,70,0.47,13,0.036153846,0
3033.226569,57,85,0.61,28,0.021785714,0
3032.981104,68,88,0.37,20,0.0185,0
3032.884908,56,87,0.88,31,0.028387097,0
3032.557115,52,86,0.91,34,0.026764706,0
3032.497638,51,77,0.94,26,0.036153846,0
3032.413401,59,99,0.75,40,0.01875,0
3032.217221,52,82,0.85,30,0.028333333,0
3031.891024,62,81,0.4,19,0.021052632,0
3031.73556,54,94,0.91,40,0.02275,0
3031.588703,44,72,0.81,28,0.028928571,0
3031.568488,68,74,0.17,6,0.028333333,0
3031.568488,61,82,0.59,21,0.028095238,0
3031.474135,58,83,0.73,25,0.0292,0
3031.227446,49,62,0.43,13,0.033076923,0
3031.072966,61,83,0.56,22,0.025454545,0
3031.072966,59,86,0.68,27,0.025185185,0
3031.072966,58,87,0.73,29,0.025172414,0
3031.072966,57,88,0.78,31,0.02516129,0
3031.072966,56,90,0.85,34,0.025,0
3031.072966,55,91,0.9,36,0.025,0
3030.797292,52,75,0.84,23,0.036521739,0
3030.63661,67,84,0.42,17,0.024705882,0
3030.63661,66,85,0.47,19,0.024736842,0
3030.63661,65,86,0.52,21,0.024761905,0
3030.63661,64,87,0.57,23,0.024782609,0
3030.63661,63,88,0.62,25,0.0248,0
3030.627237,63,81,0.48,18,0.026666667,0
3030.429459,57,69,0.44,12,0.036666667,0
3030.093175,63,77,0.39,14,0.027857143,0
3029.981793,66,78,0.33,12,0.0275,0
3029.861538,48,60,0.39,12,0.0325,0
3029.835202,53,83,0.83,30,0.027666667,0
3029.406354,44,71,0.8,27,0.02962963,0
3029.311284,64,89,0.49,25,0.0196,0
3029.214793,44,72,0.86,28,0.030714286,0
3029.195276,54,73,0.69,19,0.036315789,0
3029.106496,65,92,0.49,27,0.018148148,0
3028.94997,62,83,0.53,21,0.025238095,0
3028.94997,61,84,0.58,23,0.025217391,0
3028.7123,64,76,0.35,12,0.029166667,0
3028.7123,63,77,0.41,14,0.029285714,0
3028.460787,64,79,0.41,15,0.027333333,0
3028.44701,42,74,0.94,32,0.029375,0
3028.336488,43,74,0.94,31,0.030322581,0
3027.943227,52,91,0.98,39,0.025128205,0
3027.556873,62,82,0.56,20,0.028,0
3027.503283,67,83,0.4,16,0.025,0
3027.503283,66,84,0.45,18,0.025,0
3027.503283,65,85,0.5,20,0.025,0
3027.489217,62,66,0.09,4,0.0225,0
3027.473183,61,86,0.51,25,0.0204,0
3027.138186,52,58,0.14,6,0.023333333,0
3027.04202,63,80,0.36,17,0.021176471,0
3027.024288,54,85,0.81,31,0.026129032,0
3026.772726,66,80,0.28,14,0.02,0
3026.772726,65,81,0.32,16,0.02,0
3026.772726,64,82,0.36,18,0.02,0
3026.43988,66,77,0.28,11,0.025454545,0
3026.372992,70,86,0.3,16,0.01875,0
3026.235416,53,74,0.74,21,0.035238095,0
3026.045584,69,87,0.33,18,0.018333333,0
3025.750808,52,83,0.87,31,0.028064516,0
3025.74932,51,85,0.93,34,0.027352941,0
3025.488804,51,74,0.81,23,0.035217391,0
3025.477879,71,87,0.29,16,0.018125,0
3025.319417,55,73,0.41,18,0.022777778,0
3025.006325,54,74,0.72,20,0.036,0
3024.95374,66,89,0.44,23,0.019130435,0
3024.95374,65,90,0.48,25,0.0192,0
3024.841875,53,78,0.84,25,0.0336,0
3024.821104,58,81,0.68,23,0.029565217,0
3024.81257,51,77,0.91,26,0.035,0
3024.81257,50,78,0.98,28,0.035,0
3024.793478,41,58,0.54,17,0.031764706,0
3024.394166,44,70,0.82,26,0.031538462,0
3024.229256,44,73,0.87,29,0.03,0
3023.905672,57,98,0.8,41,0.019512195,0
3023.856006,38,61,0.81,23,0.035217391,0
3023.821676,58,88,0.62,30,0.020666667,0
3023.796236,60,84,0.61,24,0.025416667,0
3023.796236,59,85,0.66,26,0.025384615,0
3023.787253,41,70,0.89,29,0.030689655,0
3023.787253,40,71,0.95,31,0.030645161,0
3023.275365,64,89,0.6,25,0.024,0
3023.240829,48,65,0.54,17,0.031764706,0
3022.91273,48,62,0.44,14,0.031428571,0
3022.906971,51,63,0.37,12,0.030833333,0
3022.826379,44,68,0.79,24,0.032916667,0
3022.297847,55,87,0.86,32,0.026875,0
3022.279378,79,90,0.19,11,0.017272727,0
3022.269824,55,88,0.89,33,0.026969697,0
3022.235932,57,76,0.54,19,0.028421053,0
3021.897004,50,63,0.41,13,0.031538462,0
3021.859006,39,69,0.97,30,0.032333333,0
3021.620092,63,80,0.44,17,0.025882353,0
3021.528075,40,68,0.89,28,0.031785714,0
3021.528075,39,69,0.96,30,0.032,0
3021.464872,45,68,0.73,23,0.03173913,0
3021.460293,65,66,0.03,1,0.03,0
3021.241907,72,74,0.04,2,0.02,0
3021.241907,71,75,0.08,4,0.02,0
3021.241907,70,76,0.12,6,0.02,0
3021.241907,69,77,0.16,8,0.02,0
3021.241907,68,78,0.2,10,0.02,0
3021.232906,60,85,0.52,25,0.0208,0
3021.204627,54,88,0.96,34,0.028235294,0
3021.033556,51,63,0.38,12,0.031666667,0
3020.957283,43,66,0.74,23,0.032173913,0
3020.951884,60,74,0.39,14,0.027857143,0
3020.809302,50,86,0.99,36,0.0275,0
3020.699316,58,90,0.65,32,0.0203125,0
3020.669755,62,81,0.49,19,0.025789474,0
3020.669755,61,82,0.54,21,0.025714286,0
3020.585191,38,59,0.76,21,0.036190476,0
3020.23548,60,97,0.71,37,0.019189189,0
3020.194682,40,59,0.61,19,0.032105263,0
3020.013169,43,73,0.87,30,0.029,0
3019.808841,49,76,0.98,27,0.036296296,0
3019.784599,58,97,0.76,39,0.019487179,0
3019.265202,40,53,0.49,13,0.037692308,0
3018.917321,53,74,0.75,21,0.035714286,0
3018.747376,56,89,0.9,33,0.027272727,0
3018.567615,52,76,0.86,24,0.035833333,0
3018.479424,54,88,0.78,34,0.022941176,0
3018.216578,61,79,0.52,18,0.028888889,0
3018.186618,63,85,0.57,22,0.025909091,0
3018.055775,61,86,0.61,25,0.0244,0
3018.034739,37,57,0.74,20,0.037,0
3017.963508,58,82,0.71,24,0.029583333,0
3017.963508,57,83,0.77,26,0.029615385,0
3017.963508,56,84,0.83,28,0.029642857,0
3017.963508,55,85,0.89,30,0.029666667,0
3017.760402,58,93,0.9,35,0.025714286,0
3017.685252,59,91,0.83,32,0.0259375,0
3017.677931,63,83,0.41,20,0.0205,0
3017.521629,42,73,0.99,31,0.031935484,0
3017.510037,58,78,0.54,20,0.027,0
3017.499885,57,94,0.95,37,0.025675676,0
3017.499885,57,96,0.98,39,0.025128205,0
3017.348507,45,73,0.75,28,0.026785714,0
3016.931909,54,97,0.9,43,0.020930233,0
3016.854474,58,87,0.81,29,0.027931034,0
3016.676264,64,79,0.42,15,0.028,0
3016.676264,58,86,0.78,28,0.027857143,0
3016.646024,57,94,0.96,37,0.025945946,0
3016.489077,56,90,0.95,34,0.027941176,0
3016.471902,59,82,0.63,23,0.027391304,0
3016.196908,58,98,0.94,40,0.0235,0
3015.659044,57,84,0.79,27,0.029259259,0
3015.659044,56,85,0.85,29,0.029310345,0
3015.659044,54,88,0.99,34,0.029117647,0
3015.631986,62,82,0.42,20,0.021,0
3015.542445,52,72,0.73,20,0.0365,0
3015.487303,55,69,0.51,14,0.036428571,0
3015.465707,61,72,0.31,11,0.028181818,0
3015.335683,53,60,0.22,7,0.031428571,0
3015.323248,72,79,0.17,7,0.024285714,0
3015.323248,71,80,0.22,9,0.024444444,0
3015.323248,63,90,0.65,27,0.024074074,0
3015.235626,64,78,0.3,14,0.021428571,0
3015.235626,61,81,0.43,20,0.0215,0
3015.149753,55,88,0.88,33,0.026666667,0
3015.126966,70,80,0.21,10,0.021,0
3014.900033,62,78,0.45,16,0.028125,0
3014.646302,60,97,0.76,37,0.020540541,0
3014.55117,55,72,0.59,17,0.034705882,0
3014.510147,72,85,0.24,13,0.018461538,0
3014.431103,43,72,0.91,29,0.03137931,0
3014.330836,49,77,0.98,28,0.035,0
3014.287868,62,78,0.47,16,0.029375,0
3014.287868,60,81,0.61,21,0.029047619,0
3014.287868,59,82,0.67,23,0.029130435,0
3014.287868,57,85,0.81,28,0.028928571,0
3014.247847,55,88,0.95,33,0.028787879,0
3014.055621,56,58,0.06,2,0.03,0
3013.552036,60,84,0.5,24,0.020833333,0
3013.133163,53,75,0.76,22,0.034545455,0
3013.133163,52,76,0.83,24,0.034583333,0
3013.133163,51,77,0.9,26,0.034615385,0
3013.029369,52,88,0.94,36,0.026111111,0
3012.853189,41,69,0.9,28,0.032142857,0
3012.580619,57,99,0.81,42,0.019285714,0
3012.447206,53,72,0.68,19,0.035789474,0
3012.365507,44,67,0.72,23,0.031304348,0
3012.178711,73,99,0.43,26,0.016538462,0
3011.958225,49,76,0.97,27,0.035925926,0
3011.824065,56,88,0.83,32,0.0259375,0
3011.824065,54,91,0.95,37,0.025675676,0
3011.801321,61,82,0.56,21,0.026666667,0
3011.629217,38,60,0.79,22,0.035909091,0
3011.432214,41,69,0.88,28,0.031428571,0
3011.302197,44,52,0.29,8,0.03625,0
3011.109129,65,78,0.35,13,0.026923077,0
3011.109111,45,51,0.5,6,0.083333333,0
3011.020252,67,76,0.19,9,0.021111111,0
3010.434821,64,93,0.53,29,0.018275862,0
3010.219775,57,79,0.71,22,0.032272727,0
3009.987223,51,83,0.91,32,0.0284375,0
3009.913664,53,86,0.87,33,0.026363636,0
3009.829934,60,94,0.66,34,0.019411765,0
3009.829934,59,95,0.7,36,0.019444444,0
3009.62885,50,78,0.97,28,0.034642857,0
3009.627086,70,74,0.11,4,0.0275,0
3009.627086,68,76,0.22,8,0.0275,0
3009.618909,54,90,0.96,36,0.026666667,0
3009.442319,60,85,0.63,25,0.0252,0
3009.436785,44,75,0.82,31,0.026451613,0
3009.31752,61,96,0.67,35,0.019142857,0
3009.282406,60,97,0.7,37,0.018918919,0
3009.282406,59,98,0.74,39,0.018974359,0
3009.024107,66,72,0.17,6,0.028333333,0
3008.993833,43,69,0.79,26,0.030384615,0
3008.764904,56,88,0.87,32,0.0271875,0
3008.486786,75,77,0.04,2,0.02,0
3008.486786,74,78,0.08,4,0.02,0
3008.486786,73,79,0.12,6,0.02,0
3008.486786,72,80,0.16,8,0.02,0
3008.486786,71,81,0.2,10,0.02,0
3008.486786,70,82,0.24,12,0.02,0
3008.486786,69,83,0.28,14,0.02,0
3008.486786,68,84,0.32,16,0.02,0
3008.418136,55,86,0.91,31,0.029354839,0
3008.36617,64,85,0.51,21,0.024285714,0
3008.33307,59,66,0.25,7,0.035714286,0
3008.129638,39,67,0.96,28,0.034285714,0
3007.951157,58,97,0.75,39,0.019230769,0
3007.379149,73,85,0.22,12,0.018333333,0
3007.379149,70,88,0.33,18,0.018333333,0
3007.216462,56,71,0.53,15,0.035333333,0
3007.216462,55,72,0.6,17,0.035294118,0
3007.103556,37,62,0.89,25,0.0356,0
3007.094261,50,75,0.89,25,0.0356,0
3007.02264,46,66,0.64,20,0.032,0
3007.010086,55,89,0.95,34,0.027941176,0
3006.621796,69,90,0.38,21,0.018095238,0
3006.309845,54,71,0.61,17,0.035882353,0
3006.309845,50,75,0.9,25,0.036,0
3006.192231,43,53,0.83,10,0.083,0
3006.169986,50,74,0.88,24,0.036666667,0
3006.140438,60,86,0.64,26,0.024615385,0
3006.028954,41,68,0.83,27,0.030740741,0
3006.018171,60,97,0.74,37,0.02,0
3005.963303,39,58,0.7,19,0.036842105,0
3005.937387,48,64,0.49,16,0.030625,0
3005.931911,49,76,0.96,27,0.035555556,0
3005.91922,51,86,0.95,35,0.027142857,0
3005.797353,58,88,0.75,30,0.025,0
3005.797353,57,89,0.8,32,0.025,0
3005.645105,49,75,0.96,26,0.036923077,0
3005.57208,55,68,0.48,13,0.036923077,0
3005.475826,51,62,0.35,11,0.031818182,0
3005.447394,39,69,0.98,30,0.032666667,0
3005.427979,60,83,0.49,23,0.021304348,0
3005.392039,39,49,0.36,10,0.036,0
3005.375291,53,82,0.8,29,0.027586207,0
3005.325735,50,74,0.87,24,0.03625,0
3005.324601,54,94,0.97,40,0.02425,0
3005.300191,56,78,0.61,22,0.027727273,0
3005.300191,55,79,0.67,24,0.027916667,0
3005.297125,54,59,0.16,5,0.032,0
3005.291105,51,73,0.8,22,0.036363636,0
3005.250206,48,59,0.36,11,0.032727273,0
3004.841699,41,57,0.57,16,0.035625,0
3004.833175,53,74,0.76,21,0.036190476,0
3004.639026,44,54,0.32,10,0.032,0
3004.569379,67,74,0.19,7,0.027142857,0
3004.484432,55,97,0.86,42,0.02047619,0
3004.181847,45,71,0.75,26,0.028846154,0
3004.093945,63,83,0.4,20,0.02,0
3003.792689,74,97,0.39,23,0.016956522,0
3003.774506,42,72,0.97,30,0.032333333,0
3003.650845,68,89,0.39,21,0.018571429,0
3003.650845,66,92,0.48,26,0.018461538,0
3003.619695,56,86,0.66,30,0.022,0
3003.561885,54,80,0.74,26,0.028461538,0
3003.561885,53,81,0.8,28,0.028571429,0
3003.435662,68,80,0.3,12,0.025,0
3003.435662,67,81,0.35,14,0.025,0
3003.194251,55,73,0.63,18,0.035,0
3003.138931,49,62,0.3,13,0.023076923,0
3003.034914,56,86,0.87,30,0.029,0
3003.034914,55,87,0.93,32,0.0290625,0
3003.031407,42,55,0.47,13,0.036153846,0
3003.031407,39,59,0.72,20,0.036,0
3003.016552,65,94,0.53,29,0.018275862,0
3003.012671,39,75,0.97,36,0.026944444,0
3002.947156,66,96,0.52,30,0.017333333,0
3002.911843,40,73,0.9,33,0.027272727,0
3002.539833,64,79,0.31,15,0.020666667,0
3002.45061,59,87,0.69,28,0.024642857,0
3002.45061,56,91,0.86,35,0.024571429,0
3002.260262,64,96,0.58,32,0.018125,0
3002.103418,45,72,0.71,27,0.026296296,0
3002.087386,56,87,0.87,31,0.028064516,0
3001.927723,54,93,0.97,39,0.024871795,0
3001.8134,45,67,0.62,22,0.028181818,0
3001.720853,47,66,0.52,19,0.027368421,0
3001.708989,56,86,0.81,30,0.027,0
3001.447122,37,62,0.88,25,0.0352,0
3001.257362,46,70,0.73,24,0.030416667,0
3001.051345,59,83,0.52,24,0.021666667,0
3001.047667,59,82,0.51,23,0.022173913,0
3000.92956,59,86,0.56,27,0.020740741,0
3000.851886,61,92,0.61,31,0.019677419,0
3000.662877,66,82,0.41,16,0.025625,0
3000.662877,62,87,0.64,25,0.0256,0
3000.662877,61,88,0.69,27,0.025555556,0
3000.660071,61,87,0.52,26,0.02,0
3000.515591,36,62,0.95,26,0.036538462,0
3000.439421,56,68,0.43,12,0.035833333,0
3000.439421,55,70,0.53,15,0.035333333,0
3000.279374,77,82,0.09,5,0.018,0
3000.2378,67,75,0.21,8,0.02625,0
