% profit,ema1,ema2,threshold,diff,thresh / diff,ID
4022.563519,44,48,0.15,4,0.0375,21
3914.412316,36,51,0.58,15,0.038666667,21
3857.67811,42,50,0.3,8,0.0375,21
3802.90064,35,52,0.66,17,0.038823529,21
3736.484195,37,50,0.49,13,0.037692308,21
3709.529846,33,54,0.83,21,0.03952381,21
3703.648848,36,51,0.59,15,0.039333333,21
3698.478203,40,46,0.23,6,0.038333333,21
3686.665863,44,49,0.18,5,0.036,21
3684.086522,38,49,0.41,11,0.037272727,21
3658.937162,66,81,0.29,15,0.019333333,21
3653.38117,36,51,0.57,15,0.038,21
3647.55006,34,53,0.75,19,0.039473684,21
3643.527895,35,52,0.67,17,0.039411765,21
3634.609618,39,48,0.35,9,0.038888889,21
3615.582047,37,50,0.5,13,0.038461538,21
3603.216467,42,51,0.33,9,0.036666667,21
3572.580023,71,73,0.04,2,0.02,21
3572.580023,70,74,0.08,4,0.02,21
3571.11696,41,47,0.22,6,0.036666667,21
3552.467337,38,49,0.43,11,0.039090909,21
3549.120373,35,52,0.65,17,0.038235294,21
3548.669801,40,47,0.27,7,0.038571429,21
3547.866107,40,46,0.24,6,0.04,21
3539.397972,40,53,0.48,13,0.036923077,21
3531.221812,47,49,0.07,2,0.035,21
3527.456665,39,47,0.32,8,0.04,21
3523.518836,39,54,0.55,15,0.036666667,21
3521.583726,37,51,0.52,14,0.037142857,21
3519.327667,37,50,0.51,13,0.039230769,21
3519.063013,38,48,0.4,10,0.04,21
3518.174582,51,62,0.27,11,0.024545455,21
3518.174582,50,63,0.32,13,0.024615385,21
3514.230265,41,56,0.52,15,0.034666667,21
3514.230265,40,57,0.59,17,0.034705882,21
3514.196007,43,54,0.38,11,0.034545455,21
3514.196007,42,55,0.45,13,0.034615385,21
3511.546523,43,51,0.28,8,0.035,21
3500.005694,72,73,0.02,1,0.02,21
3500.005694,71,74,0.06,3,0.02,21
3500.005694,70,75,0.1,5,0.02,21
3500.005694,69,76,0.14,7,0.02,21
3500.005694,68,77,0.18,9,0.02,21
3498.800695,44,53,0.31,9,0.034444444,21
3497.179995,41,77,0.86,36,0.023888889,21
3496.794851,39,47,0.31,8,0.03875,21
3496.562505,34,54,0.77,20,0.0385,21
3495.531073,45,70,0.61,25,0.0244,21
3493.464269,49,64,0.37,15,0.024666667,21
3491.600895,39,54,0.56,15,0.037333333,21
3490.752832,69,75,0.12,6,0.02,21
3488.421647,40,47,0.26,7,0.037142857,21
3485.70922,39,48,0.34,9,0.037777778,21
3485.438292,52,61,0.22,9,0.024444444,21
3484.330734,41,51,0.38,10,0.038,21
3482.590324,67,78,0.22,11,0.02,21
3482.590324,66,79,0.26,13,0.02,21
3482.590324,65,80,0.3,15,0.02,21
3482.50847,32,58,0.98,26,0.037692308,21
3482.300233,48,66,0.44,18,0.024444444,21
3482.20434,39,59,0.69,20,0.0345,21
3481.839903,38,50,0.44,12,0.036666667,21
3479.356421,41,46,0.19,5,0.038,21
3472.958774,42,52,0.35,10,0.035,21
3469.676957,47,67,0.49,20,0.0245,21
3460.1885,43,52,0.32,9,0.035555556,21
3459.931931,44,51,0.25,7,0.035714286,21
3457.740487,54,94,0.97,40,0.02425,21
3457.678035,38,49,0.42,11,0.038181818,21
3452.530783,40,52,0.46,12,0.038333333,21
3449.474139,46,68,0.54,22,0.024545455,21
3445.278464,44,52,0.28,8,0.035,21
3445.278464,43,53,0.35,10,0.035,21
3445.278464,42,54,0.42,12,0.035,21
3444.05609,38,60,0.76,22,0.034545455,21
3442.959874,48,65,0.42,17,0.024705882,21
3440.36141,41,53,0.44,12,0.036666667,21
3439.023499,33,55,0.86,22,0.039090909,21
3437.812466,32,56,0.94,24,0.039166667,21
3436.785748,57,69,0.41,12,0.034166667,21
3435.58908,37,61,0.84,24,0.035,21
3435.051653,34,54,0.76,20,0.038,21
3433.69977,54,90,0.91,36,0.025277778,21
3433.255118,40,48,0.3,8,0.0375,21
3431.820663,53,60,0.17,7,0.024285714,21
3431.194678,43,72,0.71,29,0.024482759,21
3431.194678,42,73,0.76,31,0.024516129,21
3430.417114,39,49,0.37,10,0.037,21
3429.637468,49,63,0.35,14,0.025,21
3429.185837,41,53,0.42,12,0.035,21
3429.185837,40,54,0.49,14,0.035,21
3427.452221,33,55,0.85,22,0.038636364,21
3424.42159,38,48,0.39,10,0.039,21
3421.723425,58,68,0.34,10,0.034,21
3420.110975,34,56,0.82,22,0.037272727,21
3419.796589,33,57,0.9,24,0.0375,21
3418.863938,34,55,0.8,21,0.038095238,21
3416.84956,39,55,0.56,16,0.035,21
3415.683289,43,46,0.11,3,0.036666667,21
3415.345549,32,57,0.96,25,0.0384,21
3414.478706,42,44,0.08,2,0.04,21
3414.478706,41,45,0.16,4,0.04,21
3412.389002,44,70,0.64,26,0.024615385,21
3407.396504,34,53,0.74,19,0.038947368,21
3407.155366,54,92,0.94,38,0.024736842,21
3406.099647,40,54,0.52,14,0.037142857,21
3406.035596,35,54,0.72,19,0.037894737,21
3405.039255,36,54,0.66,18,0.036666667,21
3402.932024,35,56,0.76,21,0.036190476,21
3401.377972,39,53,0.54,14,0.038571429,21
3401.332764,37,58,0.78,21,0.037142857,21
3400.494145,44,71,0.66,27,0.024444444,21
3400.333287,46,50,0.14,4,0.035,21
3399.340565,38,55,0.63,17,0.037058824,21
3398.289823,45,69,0.59,24,0.024583333,21
3396.616193,32,56,0.93,24,0.03875,21
3395.819095,40,57,0.6,17,0.035294118,21
3395.819095,39,58,0.67,19,0.035263158,21
3395.727546,37,57,0.72,20,0.036,21
3395.386662,72,74,0.04,2,0.02,21
3395.386662,71,75,0.08,4,0.02,21
3395.386662,70,76,0.12,6,0.02,21
3395.386662,69,77,0.16,8,0.02,21
3394.03889,40,55,0.53,15,0.035333333,21
3393.871112,34,57,0.85,23,0.036956522,21
3393.426884,45,51,0.21,6,0.035,21
3392.921399,56,90,0.84,34,0.024705882,21
3392.46654,68,78,0.2,10,0.02,21
3390.348652,39,56,0.61,17,0.035882353,21
3389.926897,38,52,0.51,14,0.036428571,21
3389.749865,47,66,0.47,19,0.024736842,21
3387.872326,33,59,0.94,26,0.036153846,21
3387.575597,39,76,0.99,37,0.026756757,21
3385.246772,41,57,0.53,16,0.033125,21
3384.571857,40,52,0.43,12,0.035833333,21
3384.42056,38,55,0.64,17,0.037647059,21
3383.844976,45,50,0.18,5,0.036,21
3383.479113,48,64,0.4,16,0.025,21
3379.621271,55,91,0.89,36,0.024722222,21
3379.172778,44,51,0.24,7,0.034285714,21
3377.512249,41,54,0.47,13,0.036153846,21
3376.942863,41,52,0.39,11,0.035454545,21
3375.10476,36,64,0.96,28,0.034285714,21
3373.892871,43,69,0.87,26,0.033461538,21
3372.751205,43,71,0.69,28,0.024642857,21
3372.12208,47,50,0.1,3,0.033333333,21
3371.822727,41,56,0.53,15,0.035333333,21
3369.722629,44,72,0.67,28,0.023928571,21
3369.350635,42,53,0.39,11,0.035454545,21
3366.433821,65,81,0.32,16,0.02,21
3364.985555,38,59,0.75,21,0.035714286,21
3364.875123,37,61,0.83,24,0.034583333,21
3363.490575,44,50,0.22,6,0.036666667,21
3363.101722,46,65,0.48,19,0.025263158,21
3362.972496,67,77,0.21,10,0.021,21
3362.292894,36,64,0.98,28,0.035,21
3361.874806,42,56,0.46,14,0.032857143,21
3361.813902,35,53,0.69,18,0.038333333,21
3360.294041,40,75,0.94,35,0.026857143,21
3360.278725,42,54,0.43,12,0.035833333,21
3359.923085,40,58,0.6,18,0.033333333,21
3357.20354,38,57,0.7,19,0.036842105,21
3355.476214,40,56,0.56,16,0.035,21
3354.539483,36,62,0.92,26,0.035384615,21
3353.85023,43,52,0.31,9,0.034444444,21
3353.794423,42,71,0.97,29,0.033448276,21
3353.660323,64,82,0.36,18,0.02,21
3353.479835,38,61,0.79,23,0.034347826,21
3351.247264,38,48,0.41,10,0.041,21
3348.100839,39,57,0.63,18,0.035,21
3347.574583,38,59,0.72,21,0.034285714,21
3347.319207,39,58,0.65,19,0.034210526,21
3346.947913,41,55,0.49,14,0.035,21
3346.814704,37,62,0.89,25,0.0356,21
3346.797809,36,52,0.61,16,0.038125,21
3345.687043,58,69,0.37,11,0.033636364,21
3345.584545,40,58,0.62,18,0.034444444,21
3345.568461,42,55,0.46,13,0.035384615,21
3345.491981,43,70,0.89,27,0.032962963,21
3345.322362,37,60,0.83,23,0.036086957,21
3343.537895,41,52,0.4,11,0.036363636,21
3341.679476,43,48,0.18,5,0.036,21
3339.821255,38,60,0.77,22,0.035,21
3339.213905,43,51,0.29,8,0.03625,21
3338.37449,41,55,0.51,14,0.036428571,21
3337.633004,36,61,0.91,25,0.0364,21
3337.240091,37,49,0.48,12,0.04,21
3337.149183,40,76,0.96,36,0.026666667,21
3336.397423,36,64,0.97,28,0.034642857,21
3334.823475,33,54,0.82,21,0.039047619,21
3334.822829,40,56,0.59,16,0.036875,21
3334.221974,38,59,0.76,21,0.036190476,21
3334.185143,39,53,0.5,14,0.035714286,21
3333.985059,41,54,0.46,13,0.035384615,21
3333.81465,46,67,0.52,21,0.024761905,21
3333.384641,39,60,0.68,21,0.032380952,21
3333.335317,32,58,0.99,26,0.038076923,21
3333.193838,47,65,0.45,18,0.025,21
3332.686482,66,82,0.31,16,0.019375,21
3331.592888,47,64,0.43,17,0.025294118,21
3331.491186,40,56,0.57,16,0.035625,21
3329.525534,40,51,0.44,11,0.04,21
3328.408051,38,54,0.62,16,0.03875,21
3328.23421,38,57,0.69,19,0.036315789,21
3328.048366,33,55,0.84,22,0.038181818,21
3326.874763,53,91,0.96,38,0.025263158,21
3325.729742,33,57,0.91,24,0.037916667,21
3325.617872,47,57,0.3,10,0.03,21
3324.739176,38,58,0.71,20,0.0355,21
3324.705221,32,55,0.91,23,0.039565217,21
3323.902507,63,83,0.4,20,0.02,21
3323.828451,42,74,0.77,32,0.0240625,21
3323.211748,41,54,0.48,13,0.036923077,21
3322.553699,40,55,0.54,15,0.036,21
3321.884078,43,72,0.78,29,0.026896552,21
3321.801641,39,57,0.66,18,0.036666667,21
3320.562892,40,55,0.55,15,0.036666667,21
3319.597111,40,57,0.61,17,0.035882353,21
3319.520451,43,73,0.72,30,0.024,21
3318.682502,33,58,0.93,25,0.0372,21
3318.29132,45,50,0.17,5,0.034,21
3317.992472,37,58,0.73,21,0.034761905,21
3316.553559,37,51,0.54,14,0.038571429,21
3315.971911,45,67,0.73,22,0.033181818,21
3315.625516,37,60,0.84,23,0.036521739,21
3314.617696,39,58,0.68,19,0.035789474,21
3314.594453,36,54,0.67,18,0.037222222,21
3313.896872,63,83,0.41,20,0.0205,21
3313.552161,53,93,0.99,40,0.02475,21
3312.956005,37,51,0.53,14,0.037857143,21
3312.918764,67,79,0.24,12,0.02,21
3312.918764,66,80,0.28,14,0.02,21
3312.284619,42,54,0.44,12,0.036666667,21
3311.680616,50,85,0.97,35,0.027714286,21
3311.109391,39,56,0.63,17,0.037058824,21
3310.987397,49,55,0.18,6,0.03,21
3310.987397,48,56,0.24,8,0.03,21
3310.695695,51,58,0.18,7,0.025714286,21
3310.403875,47,63,0.41,16,0.025625,21
3309.668021,46,66,0.5,20,0.025,21
3308.816332,54,93,0.96,39,0.024615385,21
3308.330254,42,53,0.4,11,0.036363636,21
3308.147667,38,59,0.74,21,0.035238095,21
3307.163101,45,69,0.65,24,0.027083333,21
3307.023672,38,58,0.72,20,0.036,21
3304.526389,39,57,0.64,18,0.035555556,21
3303.890571,35,55,0.75,20,0.0375,21
3303.678491,36,57,0.74,21,0.035238095,21
3303.633844,53,91,0.98,38,0.025789474,21
3303.467429,42,52,0.37,10,0.037,21
3303.225006,36,62,0.93,26,0.035769231,21
3303.067815,45,67,0.55,22,0.025,21
3302.97735,42,52,0.36,10,0.036,21
3302.782678,36,60,0.87,24,0.03625,21
3302.118406,57,70,0.44,13,0.033846154,21
3301.540188,35,53,0.7,18,0.038888889,21
3301.273955,39,47,0.33,8,0.04125,21
3301.225026,41,55,0.5,14,0.035714286,21
3301.116626,38,59,0.73,21,0.034761905,21
3301.043416,36,62,0.91,26,0.035,21
3299.970637,39,52,0.52,13,0.04,21
3299.948452,34,54,0.78,20,0.039,21
3299.465206,56,71,0.51,15,0.034,21
3299.2447,41,56,0.54,15,0.036,21
3298.701305,37,59,0.8,22,0.036363636,21
3298.333983,51,84,0.91,33,0.027575758,21
3298.289679,40,72,0.98,32,0.030625,21
3297.904528,42,71,0.96,29,0.033103448,21
3297.564842,37,62,0.87,25,0.0348,21
3297.304844,37,62,0.86,25,0.0344,21
3297.17003,39,60,0.69,21,0.032857143,21
3296.752149,39,56,0.62,17,0.036470588,21
3295.242381,66,72,0.16,6,0.026666667,21
3295.242381,63,75,0.32,12,0.026666667,21
3295.11059,43,50,0.25,7,0.035714286,21
3292.829831,36,61,0.9,25,0.036,21
3292.817063,44,68,0.8,24,0.033333333,21
3291.878676,63,81,0.38,18,0.021111111,21
3291.770923,40,56,0.58,16,0.03625,21
3291.697337,42,73,0.83,31,0.026774194,21
3291.49173,42,75,0.79,33,0.023939394,21
3289.958643,55,89,0.85,34,0.025,21
3289.073872,34,55,0.81,21,0.038571429,21
3288.523733,37,49,0.5,12,0.041666667,21
3288.154346,39,54,0.53,15,0.035333333,21
3287.324522,39,58,0.66,19,0.034736842,21
3286.711004,37,59,0.81,22,0.036818182,21
3285.781941,53,92,0.98,39,0.025128205,21
3285.298082,36,61,0.92,25,0.0368,21
3284.799944,38,51,0.49,13,0.037692308,21
3283.327448,35,51,0.67,16,0.041875,21
3283.292142,37,57,0.75,20,0.0375,21
3282.305152,55,88,0.85,33,0.025757576,21
3282.305152,53,91,0.97,38,0.025526316,21
3282.216945,54,93,0.95,39,0.024358974,21
3281.603252,36,60,0.88,24,0.036666667,21
3278.381239,39,57,0.65,18,0.036111111,21
3277.199982,42,53,0.38,11,0.034545455,21
3277.168763,35,63,0.99,28,0.035357143,21
3276.948788,57,88,0.77,31,0.02483871,21
3276.592696,55,92,0.9,37,0.024324324,21
3275.637835,41,56,0.5,15,0.033333333,21
3275.14753,37,62,0.88,25,0.0352,21
3274.409671,66,79,0.27,13,0.020769231,21
3274.353592,64,69,0.14,5,0.028,21
3274.294322,44,52,0.29,8,0.03625,21
3274.17243,43,53,0.36,10,0.036,21
3273.624561,43,52,0.33,9,0.036666667,21
3273.446431,41,48,0.26,7,0.037142857,21
3273.446431,37,53,0.59,16,0.036875,21
3273.341199,53,92,0.97,39,0.024871795,21
3272.121423,39,59,0.7,20,0.035,21
3270.850562,37,52,0.56,15,0.037333333,21
3270.812895,40,53,0.46,13,0.035384615,21
3270.517558,42,46,0.15,4,0.0375,21
3270.477809,38,61,0.78,23,0.033913043,21
3270.428954,38,58,0.73,20,0.0365,21
3269.823824,37,60,0.82,23,0.035652174,21
3269.162248,39,59,0.68,20,0.034,21
3268.260688,40,57,0.57,17,0.033529412,21
3267.597018,68,80,0.23,12,0.019166667,21
3267.373802,60,78,0.48,18,0.026666667,21
3266.467923,36,64,0.95,28,0.033928571,21
3265.66674,33,56,0.88,23,0.03826087,21
3264.565856,55,57,0.05,2,0.025,21
3264.565856,54,58,0.1,4,0.025,21
3264.565856,53,59,0.15,6,0.025,21
3263.549546,37,49,0.47,12,0.039166667,21
3262.855147,36,63,0.97,27,0.035925926,21
3262.482173,39,49,0.38,10,0.038,21
3262.431333,36,53,0.64,17,0.037647059,21
3262.122848,62,75,0.35,13,0.026923077,21
3261.975274,65,80,0.31,15,0.020666667,21
3261.53284,42,49,0.27,7,0.038571429,21
3261.057111,67,81,0.27,14,0.019285714,21
3260.415027,37,61,0.85,24,0.035416667,21
3259.836946,62,85,0.46,23,0.02,21
3259.518211,53,92,0.96,39,0.024615385,21
3258.814451,37,52,0.57,15,0.038,21
3258.461438,67,80,0.25,13,0.019230769,21
3257.867022,41,55,0.48,14,0.034285714,21
3257.803555,38,56,0.63,18,0.035,21
3257.205792,36,60,0.89,24,0.037083333,21
3256.868298,33,57,0.88,24,0.036666667,21
3256.361731,41,47,0.23,6,0.038333333,21
3256.186786,39,55,0.59,16,0.036875,21
3255.689356,36,63,0.95,27,0.035185185,21
3255.627457,37,49,0.49,12,0.040833333,21
3254.526906,38,60,0.75,22,0.034090909,21
3254.526906,37,61,0.82,24,0.034166667,21
3254.397615,32,57,0.97,25,0.0388,21
3254.329849,41,70,0.9,29,0.031034483,21
3253.627061,54,92,0.95,38,0.025,21
3253.543022,40,54,0.51,14,0.036428571,21
3251.549115,43,54,0.37,11,0.033636364,21
3250.741971,40,58,0.63,18,0.035,21
3250.471263,62,84,0.45,22,0.020454545,21
3250.113039,36,63,0.96,27,0.035555556,21
3246.856261,63,70,0.22,7,0.031428571,21
3246.773428,40,48,0.31,8,0.03875,21
3246.616018,57,82,0.66,25,0.0264,21
3246.616018,54,86,0.84,32,0.02625,21
3246.557727,36,63,0.94,27,0.034814815,21
3245.985597,57,79,0.6,22,0.027272727,21
3245.871974,39,59,0.71,20,0.0355,21
3245.625701,37,52,0.58,15,0.038666667,21
3243.042834,35,55,0.73,20,0.0365,21
3242.296636,53,88,0.91,35,0.026,21
3242.209561,37,57,0.7,20,0.035,21
3241.926947,45,68,0.57,23,0.024782609,21
3241.797923,44,53,0.3,9,0.033333333,21
3241.180624,37,50,0.48,13,0.036923077,21
3241.17636,38,55,0.65,17,0.038235294,21
3240.936263,38,54,0.57,16,0.035625,21
3240.871002,64,79,0.31,15,0.020666667,21
3240.870576,63,69,0.19,6,0.031666667,21
3240.547103,39,50,0.41,11,0.037272727,21
3239.475952,45,48,0.11,3,0.036666667,21
3239.368385,38,61,0.8,23,0.034782609,21
3239.240985,44,69,0.62,25,0.0248,21
3238.290705,59,85,0.65,26,0.025,21
3238.267937,41,53,0.43,12,0.035833333,21
3238.247927,59,77,0.49,18,0.027222222,21
3238.21852,35,53,0.66,18,0.036666667,21
3237.962977,38,51,0.47,13,0.036153846,21
3237.955601,36,58,0.83,22,0.037727273,21
3237.406564,35,55,0.74,20,0.037,21
3237.065393,43,53,0.34,10,0.034,21
3236.932598,34,61,0.94,27,0.034814815,21
3236.619741,41,74,0.81,33,0.024545455,21
3236.196056,53,92,0.99,39,0.025384615,21
3236.039777,62,86,0.46,24,0.019166667,21
3235.771065,58,76,0.5,18,0.027777778,21
3235.144973,37,59,0.79,22,0.035909091,21
3234.916561,61,66,0.17,5,0.034,21
3234.284039,57,81,0.64,24,0.026666667,21
3233.883914,44,52,0.27,8,0.03375,21
3233.466824,38,55,0.6,17,0.035294118,21
3232.770185,55,89,0.87,34,0.025588235,21
3232.488819,38,50,0.46,12,0.038333333,21
3232.364698,38,58,0.74,20,0.037,21
3230.983568,55,80,0.69,25,0.0276,21
3230.483973,69,80,0.21,11,0.019090909,21
3230.045558,43,54,0.39,11,0.035454545,21
3229.648948,38,60,0.79,22,0.035909091,21
3228.930817,46,49,0.11,3,0.036666667,21
3228.708821,45,65,0.7,20,0.035,21
3227.919305,33,58,0.92,25,0.0368,21
3227.497329,37,52,0.55,15,0.036666667,21
3227.377453,51,61,0.25,10,0.025,21
3227.112531,37,60,0.81,23,0.035217391,21
3226.088032,41,51,0.36,10,0.036,21
3226.056476,60,74,0.39,14,0.027857143,21
3226.050199,38,54,0.58,16,0.03625,21
3225.359658,55,81,0.71,26,0.027307692,21
3225.262598,57,80,0.62,23,0.026956522,21
3224.541133,41,75,0.9,34,0.026470588,21
3224.506868,36,55,0.69,19,0.036315789,21
3224.469053,34,58,0.86,24,0.035833333,21
3224.469053,33,60,0.96,27,0.035555556,21
3224.442965,42,55,0.47,13,0.036153846,21
3224.347916,60,72,0.38,12,0.031666667,21
3224.231714,45,76,0.78,31,0.02516129,21
3223.320564,40,55,0.51,15,0.034,21
3223.148113,40,77,0.97,37,0.026216216,21
3222.838156,36,55,0.7,19,0.036842105,21
3222.793187,54,89,0.91,35,0.026,21
3222.793187,53,90,0.96,37,0.025945946,21
3222.669669,45,51,0.2,6,0.033333333,21
3222.432752,45,66,0.53,21,0.025238095,21
3221.390534,38,48,0.42,10,0.042,21
3220.941919,52,60,0.2,8,0.025,21
3220.870933,36,50,0.58,14,0.041428571,21
3220.836051,54,85,0.84,31,0.027096774,21
3220.311143,37,61,0.86,24,0.035833333,21
3219.379702,56,88,0.8,32,0.025,21
3219.250214,36,52,0.6,16,0.0375,21
3219.250214,35,53,0.68,18,0.037777778,21
3218.967942,38,56,0.67,18,0.037222222,21
3218.636172,36,50,0.57,14,0.040714286,21
3218.07813,47,53,0.19,6,0.031666667,21
3217.959227,43,70,0.88,27,0.032592593,21
3217.912898,37,58,0.77,21,0.036666667,21
3217.499927,40,72,0.99,32,0.0309375,21
3217.222574,63,68,0.16,5,0.032,21
3217.208676,36,63,0.93,27,0.034444444,21
3215.802943,39,59,0.72,20,0.036,21
3215.289959,57,86,0.74,29,0.025517241,21
3215.289959,56,88,0.81,32,0.0253125,21
3215.289959,55,89,0.86,34,0.025294118,21
3214.679297,50,59,0.23,9,0.025555556,21
3214.406511,44,53,0.29,9,0.032222222,21
3214.376948,53,81,0.78,28,0.027857143,21
3214.36784,33,59,0.95,26,0.036538462,21
3214.295954,40,58,0.59,18,0.032777778,21
3214.277808,35,55,0.72,20,0.036,21
3213.60718,57,87,0.75,30,0.025,21
3213.507224,60,73,0.41,13,0.031538462,21
3213.507224,58,75,0.54,17,0.031764706,21
3213.388156,42,72,0.74,30,0.024666667,21
3212.282416,41,74,0.89,33,0.026969697,21
3211.922703,38,52,0.52,14,0.037142857,21
3211.885556,58,85,0.69,27,0.025555556,21
3211.885556,56,87,0.8,31,0.025806452,21
3211.885556,54,90,0.92,36,0.025555556,21
3211.831609,54,91,0.94,37,0.025405405,21
3211.353742,39,56,0.58,17,0.034117647,21
3211.129752,50,86,0.97,36,0.026944444,21
3211.051415,35,54,0.7,19,0.036842105,21
3210.679779,43,73,0.73,30,0.024333333,21
3210.621624,40,48,0.29,8,0.03625,21
3210.463423,39,55,0.58,16,0.03625,21
3210.317371,42,71,0.73,29,0.025172414,21
3209.925776,52,87,0.93,35,0.026571429,21
3209.877639,53,84,0.84,31,0.027096774,21
3209.700669,38,55,0.62,17,0.036470588,21
3209.306612,57,83,0.68,26,0.026153846,21
3209.250884,41,73,0.8,32,0.025,21
3209.088149,36,53,0.62,17,0.036470588,21
3208.979528,65,82,0.33,17,0.019411765,21
3208.86013,36,62,0.94,26,0.036153846,21
3207.396569,34,60,0.91,26,0.035,21
3207.173673,44,50,0.21,6,0.035,21
3207.013978,51,85,0.93,34,0.027352941,21
3206.493306,56,83,0.73,27,0.027037037,21
3206.450731,54,85,0.82,31,0.026451613,21
3206.368485,39,58,0.69,19,0.036315789,21
3205.071328,62,82,0.42,20,0.021,21
3205.017014,33,58,0.91,25,0.0364,21
3204.852146,42,74,0.78,32,0.024375,21
3204.764404,55,82,0.73,27,0.027037037,21
3203.848109,61,87,0.5,26,0.019230769,21
3203.523091,54,90,0.93,36,0.025833333,21
3203.211432,39,55,0.57,16,0.035625,21
3203.078624,36,50,0.55,14,0.039285714,21
3202.758518,35,53,0.67,18,0.037222222,21
3202.75686,66,78,0.25,12,0.020833333,21
3201.971078,54,89,0.9,35,0.025714286,21
3201.957884,34,57,0.84,23,0.036521739,21
3201.575856,42,50,0.29,8,0.03625,21
3200.914079,42,54,0.41,12,0.034166667,21
3199.955848,40,45,0.21,5,0.042,21
3199.232655,51,85,0.91,34,0.026764706,21
3199.038809,60,86,0.54,26,0.020769231,21
3198.860941,61,84,0.48,23,0.020869565,21
3198.860941,60,85,0.52,25,0.0208,21
3198.844928,41,54,0.45,13,0.034615385,21
3198.485306,67,76,0.19,9,0.021111111,21
3198.44835,61,75,0.38,14,0.027142857,21
3197.979473,46,48,0.07,2,0.035,21
3197.979473,45,49,0.14,4,0.035,21
3197.893034,42,55,0.43,13,0.033076923,21
3197.874684,36,53,0.66,17,0.038823529,21
3197.874684,34,56,0.85,22,0.038636364,21
3197.01249,35,60,0.87,25,0.0348,21
3196.493443,38,57,0.66,19,0.034736842,21
3195.821997,41,52,0.41,11,0.037272727,21
3195.571888,59,85,0.55,26,0.021153846,21
3194.492542,36,63,0.92,27,0.034074074,21
3194.476942,50,62,0.3,12,0.025,21
3193.703158,65,79,0.29,14,0.020714286,21
3193.488436,35,59,0.84,24,0.035,21
3193.48597,56,82,0.71,26,0.027307692,21
3193.197713,61,83,0.46,22,0.020909091,21
3192.857223,56,80,0.63,24,0.02625,21
3191.890813,41,71,0.92,30,0.030666667,21
3191.773893,35,52,0.68,17,0.04,21
3191.217163,38,60,0.78,22,0.035454545,21
3189.802216,42,56,0.45,14,0.032142857,21
3189.797331,33,55,0.88,22,0.04,21
3189.687589,36,61,0.89,25,0.0356,21
3189.656947,44,68,0.6,24,0.025,21
3189.309114,58,89,0.64,31,0.020645161,21
3188.948574,59,70,0.36,11,0.032727273,21
3188.173445,58,80,0.6,22,0.027272727,21
3188.135289,35,51,0.65,16,0.040625,21
3187.86213,43,50,0.26,7,0.037142857,21
3187.343924,46,68,0.55,22,0.025,21
3186.904436,36,50,0.56,14,0.04,21
3186.010804,61,85,0.49,24,0.020416667,21
3185.63459,54,88,0.9,34,0.026470588,21
3185.63459,53,90,0.97,37,0.026216216,21
3185.434439,36,64,0.94,28,0.033571429,21
3185.422652,65,83,0.35,18,0.019444444,21
3184.887362,42,70,0.7,28,0.025,21
3184.685906,34,52,0.73,18,0.040555556,21
3184.65728,36,52,0.62,16,0.03875,21
3184.548723,38,56,0.66,18,0.036666667,21
3184.045706,43,67,0.75,24,0.03125,21
3183.527114,39,56,0.59,17,0.034705882,21
3183.490789,32,57,0.95,25,0.038,21
3182.980051,58,88,0.74,30,0.024666667,21
3182.980051,57,89,0.79,32,0.0246875,21
3182.882864,35,61,0.96,26,0.036923077,21
3182.525287,56,78,0.61,22,0.027727273,21
3182.501791,53,84,0.81,31,0.026129032,21
3181.766792,53,82,0.8,29,0.027586207,21
3181.233383,63,82,0.39,19,0.020526316,21
3180.866018,56,76,0.64,20,0.032,21
3180.861792,62,83,0.43,21,0.02047619,21
3180.63864,43,58,0.47,15,0.031333333,21
3180.567121,61,86,0.5,25,0.02,21
3180.29404,35,62,0.99,27,0.036666667,21
3179.990206,59,79,0.54,20,0.027,21
3179.990206,57,81,0.65,24,0.027083333,21
3179.990206,55,84,0.78,29,0.026896552,21
3179.962774,64,78,0.3,14,0.021428571,21
3179.932885,55,83,0.75,28,0.026785714,21
3179.334264,33,56,0.89,23,0.038695652,21
3179.113546,46,67,0.68,21,0.032380952,21
3178.97614,43,68,0.63,25,0.0252,21
3178.441258,59,73,0.45,14,0.032142857,21
3178.055247,43,49,0.22,6,0.036666667,21
3178.042969,40,53,0.47,13,0.036153846,21
3177.463731,38,55,0.61,17,0.035882353,21
3177.368519,44,47,0.11,3,0.036666667,21
3176.712245,58,73,0.49,15,0.032666667,21
3176.573427,34,56,0.8,22,0.036363636,21
3175.797602,58,74,0.51,16,0.031875,21
3175.580464,44,56,0.38,12,0.031666667,21
3175.571931,45,69,0.6,24,0.025,21
3174.837534,43,69,0.65,26,0.025,21
3174.592132,52,80,0.83,28,0.029642857,21
3174.592132,51,81,0.89,30,0.029666667,21
3174.49571,60,71,0.36,11,0.032727273,21
3173.32829,53,87,0.91,34,0.026764706,21
3172.896961,35,56,0.77,21,0.036666667,21
3172.547919,56,77,0.67,21,0.031904762,21
3172.32562,41,70,0.91,29,0.03137931,21
3172.280917,64,81,0.35,17,0.020588235,21
3172.184964,40,66,0.77,26,0.029615385,21
3171.905221,58,79,0.58,21,0.027619048,21
3171.905221,57,81,0.66,24,0.0275,21
3171.706567,54,82,0.74,28,0.026428571,21
3171.697116,37,56,0.67,19,0.035263158,21
3171.423631,36,52,0.57,16,0.035625,21
3171.16706,60,86,0.53,26,0.020384615,21
3170.826232,36,59,0.85,23,0.036956522,21
3170.16426,34,56,0.83,22,0.037727273,21
3169.457584,61,71,0.32,10,0.032,21
3169.003487,54,92,0.93,38,0.024473684,21
3168.62063,33,58,0.9,25,0.036,21
3168.01756,44,66,0.69,22,0.031363636,21
3167.913401,42,71,0.95,29,0.032758621,21
3167.903736,59,78,0.52,19,0.027368421,21
3167.844813,41,57,0.52,16,0.0325,21
3167.387727,41,54,0.44,13,0.033846154,21
3167.231492,61,77,0.43,16,0.026875,21
3167.231492,56,83,0.72,27,0.026666667,21
3166.562762,32,59,0.98,27,0.036296296,21
3166.505472,57,82,0.67,25,0.0268,21
3166.312754,57,76,0.6,19,0.031578947,21
3165.072081,39,61,0.74,22,0.033636364,21
3164.975811,55,90,0.88,35,0.025142857,21
3164.918243,39,53,0.55,14,0.039285714,21
3164.793602,41,76,0.85,35,0.024285714,21
3164.766364,60,83,0.49,23,0.021304348,21
3164.243127,55,84,0.79,29,0.027241379,21
3164.200114,33,58,0.94,25,0.0376,21
3164.163381,67,70,0.08,3,0.026666667,21
3164.163381,65,73,0.21,8,0.02625,21
3164.163381,64,73,0.24,9,0.026666667,21
3164.163381,61,77,0.42,16,0.02625,21
3164.133325,46,51,0.17,5,0.034,21
3163.911672,56,89,0.82,33,0.024848485,21
3163.826128,34,60,0.92,26,0.035384615,21
3163.80184,37,61,0.87,24,0.03625,21
3163.334011,63,74,0.29,11,0.026363636,21
3163.177183,62,75,0.34,13,0.026153846,21
3161.811397,42,69,0.84,27,0.031111111,21
3161.705982,41,50,0.33,9,0.036666667,21
3161.542414,36,56,0.71,20,0.0355,21
3161.459482,68,76,0.17,8,0.02125,21
3160.905713,43,48,0.19,5,0.038,21
3160.252687,53,80,0.87,27,0.032222222,21
3160.110715,43,79,0.9,36,0.025,21
3159.995939,63,74,0.3,11,0.027272727,21
3159.707038,54,79,0.8,25,0.032,21
3159.661793,34,52,0.71,18,0.039444444,21
3159.42399,55,93,0.92,38,0.024210526,21
3159.36004,35,58,0.81,23,0.035217391,21
3159.284359,42,69,0.68,27,0.025185185,21
3158.280235,55,77,0.71,22,0.032272727,21
3157.792884,50,87,0.99,37,0.026756757,21
3157.413752,44,66,0.56,22,0.025454545,21
3156.98427,56,82,0.72,26,0.027692308,21
3156.902029,52,88,0.97,36,0.026944444,21
3156.816393,35,51,0.64,16,0.04,21
3156.143774,45,51,0.22,6,0.036666667,21
3156.032047,37,62,0.9,25,0.036,21
3155.301268,50,87,0.97,37,0.026216216,21
3154.737434,61,76,0.41,15,0.027333333,21
3154.675763,65,69,0.11,4,0.0275,21
3154.675763,63,71,0.22,8,0.0275,21
3154.014191,60,78,0.49,18,0.027222222,21
3153.850783,56,75,0.62,19,0.032631579,21
3153.850783,53,78,0.82,25,0.0328,21
3153.798173,36,58,0.77,22,0.035,21
3153.791278,57,75,0.58,18,0.032222222,21
3153.120266,58,81,0.61,23,0.026521739,21
3152.97896,53,93,0.98,40,0.0245,21
3152.893737,60,79,0.49,19,0.025789474,21
3152.785244,55,90,0.87,35,0.024857143,21
3152.751306,34,59,0.89,25,0.0356,21
3152.661875,61,70,0.29,9,0.032222222,21
3152.52247,63,67,0.13,4,0.0325,21
3152.52247,61,69,0.26,8,0.0325,21
3152.52247,59,71,0.39,12,0.0325,21
3152.52247,57,74,0.55,17,0.032352941,21
3152.075264,54,78,0.78,24,0.0325,21
3151.960238,62,75,0.36,13,0.027692308,21
3151.960238,60,77,0.47,17,0.027647059,21
3151.634818,65,71,0.16,6,0.026666667,21
3150.272649,59,73,0.41,14,0.029285714,21
3150.272649,58,74,0.47,16,0.029375,21
3150.272649,57,75,0.53,18,0.029444444,21
3149.794036,43,54,0.36,11,0.032727273,21
3149.781281,40,52,0.44,12,0.036666667,21
3149.689934,41,75,0.91,34,0.026764706,21
3149.559969,61,68,0.23,7,0.032857143,21
3149.005969,36,50,0.59,14,0.042142857,21
3148.817169,63,73,0.28,10,0.028,21
3148.577129,56,84,0.72,28,0.025714286,21
3148.335214,53,88,0.9,35,0.025714286,21
3148.24498,38,47,0.37,9,0.041111111,21
3148.054492,43,70,0.68,27,0.025185185,21
3147.983146,65,72,0.19,7,0.027142857,21
3147.604433,66,84,0.34,18,0.018888889,21
3147.408527,36,56,0.72,20,0.036,21
3147.138883,60,70,0.33,10,0.033,21
3147.1052,42,68,0.82,26,0.031538462,21
3146.870423,54,84,0.82,30,0.027333333,21
3146.633671,41,75,0.83,34,0.024411765,21
3146.625014,43,70,0.67,27,0.024814815,21
3146.127076,55,76,0.69,21,0.032857143,21
3145.986768,42,59,0.54,17,0.031764706,21
3145.785146,58,72,0.46,14,0.032857143,21
3145.785146,54,77,0.75,23,0.032608696,21
3145.489011,32,54,0.9,22,0.040909091,21
3145.448879,64,87,0.43,23,0.018695652,21
3145.401376,57,76,0.54,19,0.028421053,21
3145.401376,56,77,0.6,21,0.028571429,21
3144.297102,35,55,0.76,20,0.038,21
3144.289164,53,86,0.9,33,0.027272727,21
3143.517472,42,69,0.69,27,0.025555556,21
3143.437576,36,63,0.98,27,0.036296296,21
3143.217569,60,77,0.45,17,0.026470588,21
3143.217569,60,78,0.47,18,0.026111111,21
3143.168479,61,86,0.49,25,0.0196,21
3142.996885,36,60,0.83,24,0.034583333,21
3142.95689,67,83,0.3,16,0.01875,21
3142.828781,58,71,0.43,13,0.033076923,21
3142.744019,66,70,0.11,4,0.0275,21
3142.744019,64,72,0.22,8,0.0275,21
3142.198044,56,94,0.72,38,0.018947368,21
3141.886913,45,52,0.23,7,0.032857143,21
3141.799711,61,72,0.31,11,0.028181818,21
3141.799711,58,75,0.48,17,0.028235294,21
3141.097973,65,78,0.27,13,0.020769231,21
3140.957382,52,87,0.95,35,0.027142857,21
3140.924517,36,51,0.56,15,0.037333333,21
3140.907115,59,79,0.52,20,0.026,21
3140.907115,58,80,0.57,22,0.025909091,21
3140.624546,55,83,0.76,28,0.027142857,21
3140.550429,51,80,0.88,29,0.030344828,21
3140.414188,60,72,0.35,12,0.029166667,21
3140.335467,56,74,0.59,18,0.032777778,21
3140.335467,55,75,0.66,20,0.033,21
3140.278642,43,52,0.3,9,0.033333333,21
3139.874717,43,48,0.2,5,0.04,21
3139.874717,42,49,0.28,7,0.04,21
3139.742985,68,81,0.25,13,0.019230769,21
3139.6537,40,78,0.91,38,0.023947368,21
3139.48704,54,86,0.85,32,0.0265625,21
3139.338465,40,49,0.34,9,0.037777778,21
3138.962904,52,79,0.82,27,0.03037037,21
3138.83166,53,83,0.82,30,0.027333333,21
3138.819245,40,49,0.33,9,0.036666667,21
3138.773935,35,54,0.71,19,0.037368421,21
3138.57939,61,73,0.33,12,0.0275,21
3138.239362,47,68,0.64,21,0.03047619,21
3138.134928,52,57,0.13,5,0.026,21
3138.092611,40,71,0.96,31,0.030967742,21
3137.767457,59,75,0.44,16,0.0275,21
3137.587378,61,74,0.35,13,0.026923077,21
3137.529567,61,67,0.2,6,0.033333333,21
3137.529567,55,74,0.63,19,0.033157895,21
3137.390416,38,59,0.77,21,0.036666667,21
3137.169382,50,64,0.43,14,0.030714286,21
3137.022188,57,80,0.6,23,0.026086957,21
3136.985126,38,63,0.84,25,0.0336,21
3136.985126,37,64,0.91,27,0.033703704,21
3136.908042,45,59,0.42,14,0.03,21
3136.620885,60,75,0.4,15,0.026666667,21
3136.606414,56,83,0.7,27,0.025925926,21
3136.36782,62,81,0.4,19,0.021052632,21
3136.326642,45,61,0.47,16,0.029375,21
3136.267156,53,85,0.83,32,0.0259375,21
3136.267156,52,86,0.88,34,0.025882353,21
3136.249918,42,73,0.77,31,0.02483871,21
3136.207959,51,86,0.93,35,0.026571429,21
3136.034062,52,86,0.94,34,0.027647059,21
3135.860101,64,71,0.19,7,0.027142857,21
3135.860101,62,73,0.3,11,0.027272727,21
3134.970314,59,72,0.42,13,0.032307692,21
3134.913193,36,53,0.65,17,0.038235294,21
3134.770237,52,86,0.91,34,0.026764706,21
3134.610152,41,51,0.39,10,0.039,21
3134.610152,40,52,0.47,12,0.039166667,21
3134.604914,42,61,0.58,19,0.030526316,21
3134.308069,55,81,0.69,26,0.026538462,21
3133.852397,33,54,0.85,21,0.04047619,21
3133.850662,62,74,0.33,12,0.0275,21
3133.698157,57,79,0.58,22,0.026363636,21
3133.651725,51,81,0.9,30,0.03,21
3133.651725,50,82,0.96,32,0.03,21
3133.611029,64,83,0.37,19,0.019473684,21
3133.53412,63,66,0.1,3,0.033333333,21
3133.53412,60,69,0.3,9,0.033333333,21
3133.316517,37,48,0.45,11,0.040909091,21
3133.270167,34,56,0.84,22,0.038181818,21
3133.249515,42,51,0.32,9,0.035555556,21
3132.992943,57,72,0.5,15,0.033333333,21
3132.977131,35,54,0.73,19,0.038421053,21
3132.958579,59,88,0.59,29,0.020344828,21
3132.862541,46,74,0.72,28,0.025714286,21
3132.762535,60,87,0.53,27,0.01962963,21
3132.636595,55,83,0.77,28,0.0275,21
3132.636595,54,84,0.83,30,0.027666667,21
3132.600385,35,50,0.63,15,0.042,21
3132.379947,54,75,0.7,21,0.033333333,21
3132.076448,54,83,0.8,29,0.027586207,21
3131.89865,44,68,0.7,24,0.029166667,21
3130.861212,60,76,0.43,16,0.026875,21
3130.841284,43,69,0.76,26,0.029230769,21
3130.714659,59,78,0.53,19,0.027894737,21
3130.509363,64,74,0.26,10,0.026,21
3130.442659,35,62,0.98,27,0.036296296,21
3130.274237,64,70,0.17,6,0.028333333,21
3130.274237,61,73,0.34,12,0.028333333,21
3130.261466,67,75,0.17,8,0.02125,21
3130.181871,55,61,0.18,6,0.03,21
3130.181871,54,62,0.24,8,0.03,21
3130.181871,53,63,0.3,10,0.03,21
3130.134641,53,80,0.78,27,0.028888889,21
3130.050045,56,79,0.62,23,0.026956522,21
3130.040303,62,74,0.32,12,0.026666667,21
3129.809171,45,68,0.63,23,0.027391304,21
3129.561345,42,72,0.82,30,0.027333333,21
3129.344766,54,79,0.72,25,0.0288,21
3129.267331,39,53,0.52,14,0.037142857,21
3129.021119,57,73,0.53,16,0.033125,21
3128.763425,59,80,0.55,21,0.026190476,21
3128.743312,42,49,0.26,7,0.037142857,21
3128.459851,52,86,0.93,34,0.027352941,21
3128.40524,39,67,0.83,28,0.029642857,21
3128.208229,51,60,0.23,9,0.025555556,21
3128.083603,40,57,0.62,17,0.036470588,21
3127.6295,53,89,0.91,36,0.025277778,21
3127.396149,53,60,0.22,7,0.031428571,21
3127.352592,54,83,0.81,29,0.027931034,21
3127.344239,63,80,0.36,17,0.021176471,21
3127.315495,38,62,0.82,24,0.034166667,21
3127.269331,57,78,0.59,21,0.028095238,21
3127.093389,34,58,0.87,24,0.03625,21
3127.082091,60,77,0.46,17,0.027058824,21
3127.020639,38,54,0.59,16,0.036875,21
3126.888226,50,61,0.28,11,0.025454545,21
3126.862979,57,79,0.61,22,0.027727273,21
3126.618851,38,51,0.5,13,0.038461538,21
3126.499686,52,82,0.84,30,0.028,21
3126.499686,51,83,0.9,32,0.028125,21
3126.418244,58,80,0.59,22,0.026818182,21
3126.407287,62,77,0.39,15,0.026,21
3126.233047,51,86,0.95,35,0.027142857,21
3126.192089,40,56,0.52,16,0.0325,21
3125.617956,62,70,0.23,8,0.02875,21
3125.61745,42,71,0.72,29,0.024827586,21
3125.09546,63,84,0.41,21,0.01952381,21
3124.640416,56,79,0.65,23,0.02826087,21
3124.640416,55,80,0.71,25,0.0284,21
3124.47025,37,62,0.91,25,0.0364,21
3124.467333,52,90,0.97,38,0.025526316,21
3124.234532,50,83,0.98,33,0.02969697,21
3123.845225,50,84,0.97,34,0.028529412,21
3123.728614,62,76,0.37,14,0.026428571,21
3123.728614,61,76,0.4,15,0.026666667,21
3123.41289,57,87,0.76,30,0.025333333,21
3123.41289,54,91,0.93,37,0.025135135,21
3123.355391,51,82,0.9,31,0.029032258,21
3123.201559,60,88,0.54,28,0.019285714,21
3123.111282,63,82,0.38,19,0.02,21
3123.059159,37,59,0.78,22,0.035454545,21
3122.983576,42,71,0.82,29,0.028275862,21
3122.248964,55,92,0.72,37,0.019459459,21
3122.102499,62,72,0.28,10,0.028,21
3121.697306,57,80,0.64,23,0.027826087,21
3121.462894,44,67,0.58,23,0.025217391,21
3121.313076,35,51,0.63,16,0.039375,21
3121.209192,54,82,0.78,28,0.027857143,21
3121.082387,50,84,0.96,34,0.028235294,21
3120.648093,53,86,0.89,33,0.026969697,21
3120.44455,52,79,0.89,27,0.032962963,21
3120.173491,45,46,0.04,1,0.04,21
3120.108303,61,71,0.29,10,0.029,21
3119.940116,53,81,0.8,28,0.028571429,21
3119.940116,52,82,0.86,30,0.028666667,21
3119.75431,52,85,0.86,33,0.026060606,21
3119.718441,37,56,0.68,19,0.035789474,21
3119.658859,56,80,0.67,24,0.027916667,21
3119.658859,55,81,0.73,26,0.028076923,21
3119.658859,54,82,0.79,28,0.028214286,21
3119.658859,52,85,0.92,33,0.027878788,21
3119.526224,66,77,0.23,11,0.020909091,21
3119.184767,39,54,0.54,15,0.036,21
3119.116379,34,54,0.74,20,0.037,21
3119.073628,33,55,0.87,22,0.039545455,21
3118.857751,62,85,0.45,23,0.019565217,21
3118.850789,58,77,0.51,19,0.026842105,21
3118.772782,54,77,0.69,23,0.03,21
3118.507138,53,88,0.89,35,0.025428571,21
3118.426415,46,58,0.36,12,0.03,21
3118.278744,36,53,0.63,17,0.037058824,21
3118.271155,41,60,0.6,19,0.031578947,21
3118.141934,63,81,0.37,18,0.020555556,21
3118.129462,39,52,0.47,13,0.036153846,21
3117.923986,64,80,0.35,16,0.021875,21
3117.808056,47,66,0.48,19,0.025263158,21
3117.686447,33,57,0.93,24,0.03875,21
3117.176513,44,77,0.84,33,0.025454545,21
3116.974916,33,53,0.81,20,0.0405,21
3116.805688,54,79,0.73,25,0.0292,21
3116.805688,53,80,0.79,27,0.029259259,21
3116.736175,33,57,0.89,24,0.037083333,21
3116.553413,35,58,0.82,23,0.035652174,21
3116.48274,37,62,0.85,25,0.034,21
3116.232936,55,82,0.74,27,0.027407407,21
3116.077907,39,62,0.77,23,0.033478261,21
3115.943227,60,75,0.42,15,0.028,21
3115.917381,37,53,0.6,16,0.0375,21
3115.860082,38,51,0.48,13,0.036923077,21
3115.705902,58,81,0.6,23,0.026086957,21
3115.705902,55,84,0.76,29,0.026206897,21
3115.667602,64,80,0.33,16,0.020625,21
3115.347892,54,91,0.92,37,0.024864865,21
3115.303738,44,47,0.12,3,0.04,21
3115.095908,59,77,0.48,18,0.026666667,21
3115.060263,46,64,0.46,18,0.025555556,21
3114.992655,37,55,0.65,18,0.036111111,21
3114.915084,54,81,0.76,27,0.028148148,21
3114.891379,58,76,0.51,18,0.028333333,21
3114.634628,57,80,0.63,23,0.027391304,21
3114.376935,33,60,0.98,27,0.036296296,21
3113.937132,55,79,0.69,24,0.02875,21
3113.937132,54,80,0.75,26,0.028846154,21
3113.920833,48,55,0.23,7,0.032857143,21
3113.875887,50,60,0.26,10,0.026,21
3113.647074,50,88,0.98,38,0.025789474,21
3113.485446,59,75,0.46,16,0.02875,21
3113.453815,66,83,0.33,17,0.019411765,21
3113.375657,56,76,0.59,20,0.0295,21
3113.141644,42,47,0.19,5,0.038,21
3112.896921,53,87,0.9,34,0.026470588,21
3112.844388,51,87,0.93,36,0.025833333,21
3112.692511,53,58,0.14,5,0.028,21
3112.669356,42,72,0.75,30,0.025,21
3112.598572,55,85,0.77,30,0.025666667,21
3112.271161,40,65,0.75,25,0.03,21
3111.932734,43,70,0.76,27,0.028148148,21
3111.70087,59,78,0.51,19,0.026842105,21
3111.70087,59,79,0.53,20,0.0265,21
3111.507362,42,75,0.8,33,0.024242424,21
3111.347252,55,80,0.7,25,0.028,21
3111.249358,54,85,0.85,31,0.027419355,21
3111.228467,53,76,0.77,23,0.033478261,21
3111.133976,35,56,0.78,21,0.037142857,21
3110.898087,53,84,0.86,31,0.027741935,21
3110.853869,44,61,0.51,17,0.03,21
3110.853869,43,62,0.57,19,0.03,21
3110.589944,33,57,0.92,24,0.038333333,21
3110.560866,53,85,0.88,32,0.0275,21
3110.421994,51,86,0.92,35,0.026285714,21
3110.404192,53,87,0.88,34,0.025882353,21
3110.136447,50,87,0.98,37,0.026486486,21
3110.016252,50,82,0.97,32,0.0303125,21
3109.756285,58,86,0.7,28,0.025,21
3109.60802,64,80,0.34,16,0.02125,21
3109.5934,60,68,0.27,8,0.03375,21
3109.108247,55,78,0.66,23,0.028695652,21
3109.001132,43,51,0.27,8,0.03375,21
3108.990671,53,83,0.8,30,0.026666667,21
3108.860088,54,86,0.83,32,0.0259375,21
3108.833355,53,83,0.84,30,0.028,21
3108.714558,42,62,0.6,20,0.03,21
3108.692586,54,81,0.77,27,0.028518519,21
3108.490974,54,76,0.73,22,0.033181818,21
3108.124574,55,77,0.65,22,0.029545455,21
3107.990823,32,56,0.95,24,0.039583333,21
3107.900501,56,78,0.63,22,0.028636364,21
3107.541235,64,81,0.34,17,0.02,21
3107.449664,60,74,0.4,14,0.028571429,21
3107.373315,37,48,0.46,11,0.041818182,21
3107.266519,37,60,0.78,23,0.033913043,21
3107.201747,34,52,0.72,18,0.04,21
3107.048736,50,84,0.99,34,0.029117647,21
3107.016903,38,68,0.89,30,0.029666667,21
3106.585233,53,79,0.77,26,0.029615385,21
3106.529364,55,84,0.77,29,0.026551724,21
3106.41492,45,67,0.64,22,0.029090909,21
3106.406711,34,58,0.88,24,0.036666667,21
3106.336684,56,85,0.74,29,0.025517241,21
3106.185555,43,70,0.78,27,0.028888889,21
3105.925331,61,74,0.36,13,0.027692308,21
3105.925331,59,76,0.47,17,0.027647059,21
3105.925331,57,78,0.58,21,0.027619048,21
3105.925331,56,79,0.64,23,0.027826087,21
3105.656998,56,81,0.69,25,0.0276,21
3105.382102,55,82,0.75,27,0.027777778,21
3105.237007,50,82,0.95,32,0.0296875,21
3105.237007,50,83,0.97,33,0.029393939,21
3105.217707,52,84,0.86,32,0.026875,21
3104.901791,55,85,0.78,30,0.026,21
3104.839845,51,85,0.95,34,0.027941176,21
3104.789358,41,46,0.18,5,0.036,21
3104.765077,50,84,0.98,34,0.028823529,21
3104.520457,43,67,0.85,24,0.035416667,21
3104.23959,67,78,0.23,11,0.020909091,21
3104.092316,38,62,0.84,24,0.035,21
3104.055493,54,87,0.85,33,0.025757576,21
3103.952451,37,63,0.91,26,0.035,21
3103.856314,58,80,0.58,22,0.026363636,21
3103.589063,46,55,0.28,9,0.031111111,21
3103.535305,43,71,0.77,28,0.0275,21
3103.485392,50,83,0.96,33,0.029090909,21
3103.460392,56,80,0.66,24,0.0275,21
3103.309032,57,77,0.55,20,0.0275,21
3103.235588,45,65,0.51,20,0.0255,21
3103.135489,42,53,0.37,11,0.033636364,21
3103.058484,49,60,0.39,11,0.035454545,21
3103.042267,57,81,0.63,24,0.02625,21
3103.042267,57,82,0.65,25,0.026,21
3102.897237,35,60,0.91,25,0.0364,21
3102.740394,63,83,0.39,20,0.0195,21
3102.738127,54,78,0.71,24,0.029583333,21
3102.547844,53,89,0.96,36,0.026666667,21
3102.390787,52,89,0.97,37,0.026216216,21
3102.390317,46,66,0.58,20,0.029,21
3102.286334,52,87,0.96,35,0.027428571,21
3101.682637,45,60,0.45,15,0.03,21
3101.654869,57,83,0.67,26,0.025769231,21
3101.43411,42,81,0.96,39,0.024615385,21
3101.385222,39,51,0.44,12,0.036666667,21
3101.297629,60,81,0.47,21,0.022380952,21
3101.239359,61,75,0.39,14,0.027857143,21
3101.220476,34,59,0.88,25,0.0352,21
3101.202698,36,57,0.78,21,0.037142857,21
3101.160361,62,71,0.26,9,0.028888889,21
3101.160361,57,76,0.55,19,0.028947368,21
3101.160361,56,77,0.61,21,0.029047619,21
3101.160361,55,78,0.67,23,0.029130435,21
3101.037032,52,81,0.85,29,0.029310345,21
3100.754045,58,77,0.53,19,0.027894737,21
3100.727133,42,52,0.34,10,0.034,21
3100.653453,42,70,0.94,28,0.033571429,21
3100.457963,36,63,0.91,27,0.033703704,21
3100.366393,52,85,0.87,33,0.026363636,21
3100.13651,64,79,0.38,15,0.025333333,21
3100.061409,45,55,0.32,10,0.032,21
3100.032362,59,76,0.48,17,0.028235294,21
3100.032362,58,77,0.54,19,0.028421053,21
3100.000306,51,74,0.7,23,0.030434783,21
3099.983352,50,85,0.98,35,0.028,21
3099.760399,38,60,0.8,22,0.036363636,21
3099.689307,60,73,0.37,13,0.028461538,21
3099.486491,58,90,0.62,32,0.019375,21
3099.486227,56,90,0.67,34,0.019705882,21
3099.435456,53,82,0.83,29,0.02862069,21
3099.284869,52,89,0.96,37,0.025945946,21
3099.169066,55,86,0.79,31,0.025483871,21
3098.985717,57,77,0.57,20,0.0285,21
3098.985717,53,82,0.82,29,0.028275862,21
3098.876616,60,76,0.44,16,0.0275,21
3098.837208,43,57,0.45,14,0.032142857,21
3098.675833,42,65,0.67,23,0.029130435,21
3098.675833,41,66,0.73,25,0.0292,21
3098.588471,65,70,0.14,5,0.028,21
3098.511554,58,78,0.55,20,0.0275,21
3098.482795,49,59,0.26,10,0.026,21
3097.954962,43,71,0.76,28,0.027142857,21
3097.602617,34,61,0.99,27,0.036666667,21
3097.382006,53,88,0.95,35,0.027142857,21
3097.246865,51,82,0.91,31,0.029354839,21
3096.647848,37,56,0.69,19,0.036315789,21
3096.640647,55,81,0.72,26,0.027692308,21
3096.418009,65,79,0.28,14,0.02,21
3096.327878,36,58,0.78,22,0.035454545,21
3096.285603,60,75,0.41,15,0.027333333,21
3096.285603,58,77,0.52,19,0.027368421,21
3096.017369,57,91,0.66,34,0.019411765,21
3095.77594,58,78,0.54,20,0.027,21
3095.698877,52,89,0.95,37,0.025675676,21
3095.670446,66,75,0.2,9,0.022222222,21
3095.525532,56,78,0.62,22,0.028181818,21
3095.514282,42,71,0.84,29,0.028965517,21
3095.437305,62,83,0.44,21,0.020952381,21
3095.350621,46,75,0.73,29,0.025172414,21
3095.341397,43,67,0.76,24,0.031666667,21
3095.293943,63,70,0.2,7,0.028571429,21
3095.27658,54,87,0.84,33,0.025454545,21
3095.275182,64,80,0.32,16,0.02,21
3095.242421,56,73,0.57,17,0.033529412,21
3095.162435,61,78,0.44,17,0.025882353,21
3095.160675,37,61,0.79,24,0.032916667,21
3094.598758,48,62,0.36,14,0.025714286,21
3094.567875,41,57,0.54,16,0.03375,21
3094.30569,56,80,0.64,24,0.026666667,21
3093.720507,51,88,0.95,37,0.025675676,21
3093.66145,62,84,0.43,22,0.019545455,21
3093.41389,43,71,0.7,28,0.025,21
3093.191417,51,86,0.97,35,0.027714286,21
3092.963701,52,84,0.9,32,0.028125,21
3092.94429,56,83,0.71,27,0.026296296,21
3092.94429,53,87,0.89,34,0.026176471,21
3092.429171,50,88,0.99,38,0.026052632,21
3092.414598,41,72,0.9,31,0.029032258,21
3092.410228,36,49,0.54,13,0.041538462,21
3092.356179,51,87,0.99,36,0.0275,21
3092.314018,54,83,0.76,29,0.026206897,21
3092.175499,52,83,0.88,31,0.028387097,21
3092.084839,43,71,0.9,28,0.032142857,21
3091.940691,44,60,0.48,16,0.03,21
3091.702345,56,81,0.68,25,0.0272,21
3091.379022,53,77,0.8,24,0.033333333,21
3091.357474,52,83,0.85,31,0.027419355,21
3091.356873,42,70,0.82,28,0.029285714,21
3091.341829,37,63,0.89,26,0.034230769,21
3091.032492,66,69,0.08,3,0.026666667,21
3091.032492,63,72,0.24,9,0.026666667,21
3091.01654,47,66,0.61,19,0.032105263,21
3090.848598,55,80,0.68,25,0.0272,21
3090.848598,53,82,0.79,29,0.027241379,21
3090.668895,65,75,0.23,10,0.023,21
3090.371021,59,75,0.45,16,0.028125,21
3090.371021,55,79,0.68,24,0.028333333,21
3090.037856,54,81,0.73,27,0.027037037,21
3089.88774,41,64,0.69,23,0.03,21
3089.885032,59,77,0.5,18,0.027777778,21
3089.866959,38,58,0.66,20,0.033,21
3089.776927,39,53,0.51,14,0.036428571,21
3089.776927,37,55,0.66,18,0.036666667,21
3089.728838,38,54,0.6,16,0.0375,21
3089.683272,43,70,0.74,27,0.027407407,21
3089.511466,57,78,0.6,21,0.028571429,21
3089.503206,42,74,0.85,32,0.0265625,21
3089.487075,52,77,0.84,25,0.0336,21
3089.133617,52,64,0.36,12,0.03,21
3089.121768,61,85,0.59,24,0.024583333,21
3089.039989,44,51,0.23,7,0.032857143,21
3089.019383,60,71,0.33,11,0.03,21
3088.795688,41,69,0.89,28,0.031785714,21
3088.786716,52,87,0.9,35,0.025714286,21
3088.752251,58,78,0.53,20,0.0265,21
3088.752251,55,82,0.71,27,0.026296296,21
3088.7245,62,81,0.41,19,0.021578947,21
3088.666105,42,68,0.93,26,0.035769231,21
3088.189048,37,51,0.51,14,0.036428571,21
3088.090003,39,77,0.98,38,0.025789474,21
3088.0344,53,83,0.85,30,0.028333333,21
3087.884558,44,70,0.65,26,0.025,21
3087.719432,43,71,0.78,28,0.027857143,21
3087.719432,42,72,0.84,30,0.028,21
3087.695542,56,82,0.7,26,0.026923077,21
3087.609062,50,86,0.98,36,0.027222222,21
3087.53527,56,93,0.71,37,0.019189189,21
3087.516295,41,72,0.89,31,0.028709677,21
3087.415439,35,63,0.95,28,0.033928571,21
3087.244989,35,52,0.69,17,0.040588235,21
3087.191278,38,58,0.69,20,0.0345,21
3087.118277,58,88,0.59,30,0.019666667,21
3087.098902,54,84,0.78,30,0.026,21
3087.097,43,72,0.72,29,0.024827586,21
3087.003573,41,74,0.82,33,0.024848485,21
3086.830427,57,77,0.56,20,0.028,21
3086.768303,41,71,0.93,30,0.031,21
3086.501071,42,80,0.96,38,0.025263158,21
3086.440222,63,76,0.34,13,0.026153846,21
3086.237445,42,82,0.98,40,0.0245,21
3086.162778,54,82,0.77,28,0.0275,21
3086.162778,53,83,0.83,30,0.027666667,21
3086.067717,45,66,0.54,21,0.025714286,21
3085.843163,45,57,0.37,12,0.030833333,21
3085.572167,38,62,0.81,24,0.03375,21
3085.569763,39,50,0.39,11,0.035454545,21
3085.539664,49,61,0.31,12,0.025833333,21
3085.468398,58,75,0.49,17,0.028823529,21
3085.361614,41,63,0.66,22,0.03,21
3084.54622,40,73,0.96,33,0.029090909,21
3084.450438,39,80,0.97,41,0.023658537,21
3084.234661,63,79,0.35,16,0.021875,21
3084.22584,37,56,0.73,19,0.038421053,21
3084.208022,51,87,0.95,36,0.026388889,21
3083.808101,59,72,0.39,13,0.03,21
3083.759335,53,85,0.87,32,0.0271875,21
3083.617636,52,88,0.94,36,0.026111111,21
3083.549258,38,61,0.75,23,0.032608696,21
3083.467986,63,72,0.25,9,0.027777778,21
3083.42275,52,89,0.94,37,0.025405405,21
3082.851752,43,64,0.61,21,0.029047619,21
3082.763468,58,78,0.56,20,0.028,21
3082.730077,36,62,0.95,26,0.036538462,21
3082.579103,54,85,0.81,31,0.026129032,21
3082.503401,56,84,0.73,28,0.026071429,21
3082.449288,45,54,0.29,9,0.032222222,21
3082.388913,41,76,0.92,35,0.026285714,21
3082.230382,65,66,0.03,1,0.03,21
3082.230382,64,67,0.09,3,0.03,21
3082.230382,63,68,0.15,5,0.03,21
3082.230382,62,69,0.21,7,0.03,21
3082.230382,61,70,0.27,9,0.03,21
3082.219885,42,57,0.51,15,0.034,21
3082.219885,41,58,0.58,17,0.034117647,21
3082.139259,37,59,0.76,22,0.034545455,21
3082.102057,37,56,0.7,19,0.036842105,21
3082.038688,37,51,0.49,14,0.035,21
3081.824879,57,59,0.06,2,0.03,21
3081.731609,45,65,0.63,20,0.0315,21
3081.556058,51,85,0.92,34,0.027058824,21
3081.548437,42,69,0.94,27,0.034814815,21
3081.45642,61,75,0.37,14,0.026428571,21
3081.4351,36,54,0.69,18,0.038333333,21
3081.365283,52,87,0.97,35,0.027714286,21
3081.308778,55,69,0.43,14,0.030714286,21
3081.308778,52,73,0.64,21,0.03047619,21
3081.123326,42,72,0.83,30,0.027666667,21
3080.722831,34,56,0.81,22,0.036818182,21
3080.439996,52,88,0.93,36,0.025833333,21
3080.368549,59,89,0.58,30,0.019333333,21
3080.133458,42,77,0.82,35,0.023428571,21
3079.783528,57,64,0.22,7,0.031428571,21
3079.778636,58,91,0.63,33,0.019090909,21
3079.753579,42,59,0.53,17,0.031176471,21
3079.602402,39,57,0.59,18,0.032777778,21
3079.581522,59,93,0.66,34,0.019411765,21
3079.359642,33,61,0.98,28,0.035,21
3079.326214,40,61,0.66,21,0.031428571,21
3079.313732,41,65,0.71,24,0.029583333,21
3079.292441,61,85,0.47,24,0.019583333,21
3079.218312,64,84,0.39,20,0.0195,21
3079.170457,45,56,0.34,11,0.030909091,21
3079.000983,53,83,0.86,30,0.028666667,21
3078.978967,48,72,0.61,24,0.025416667,21
3078.971814,38,56,0.64,18,0.035555556,21
3078.794702,54,83,0.79,29,0.027241379,21
3078.733264,59,82,0.52,23,0.022608696,21
3078.706796,52,76,0.56,24,0.023333333,21
3078.636447,54,70,0.49,16,0.030625,21
3078.397173,53,84,0.87,31,0.028064516,21
3078.397173,52,85,0.93,33,0.028181818,21
3078.397173,51,86,0.99,35,0.028285714,21
3078.353285,33,61,0.99,28,0.035357143,21
3078.157709,43,75,0.76,32,0.02375,21
3077.831145,41,63,0.67,22,0.030454545,21
3077.452619,53,81,0.81,28,0.028928571,21
3077.452619,52,82,0.87,30,0.029,21
3077.452619,51,83,0.93,32,0.0290625,21
3077.281491,41,73,0.89,32,0.0278125,21
3076.987758,57,89,0.63,32,0.0196875,21
3076.909111,44,59,0.46,15,0.030666667,21
3076.566175,36,65,0.98,29,0.033793103,21
3076.192852,39,64,0.77,25,0.0308,21
3075.840251,40,46,0.25,6,0.041666667,21
3075.645969,35,59,0.92,24,0.038333333,21
3075.568962,39,59,0.67,20,0.0335,21
3075.561766,40,56,0.54,16,0.03375,21
3075.286212,39,46,0.29,7,0.041428571,21
3075.035245,41,73,0.88,32,0.0275,21
3075.009571,52,83,0.89,31,0.028709677,21
3074.924903,40,74,0.98,34,0.028823529,21
3074.848168,35,57,0.8,22,0.036363636,21
3074.638931,52,84,0.92,32,0.02875,21
3074.576358,59,78,0.5,19,0.026315789,21
3074.53469,43,61,0.54,18,0.03,21
3074.478404,58,79,0.57,21,0.027142857,21
3074.352511,43,78,0.9,35,0.025714286,21
3074.336499,52,88,0.96,36,0.026666667,21
3074.271407,38,47,0.38,9,0.042222222,21
3074.250113,55,87,0.72,32,0.0225,21
3074.230604,51,87,0.94,36,0.026111111,21
3074.213159,39,66,0.81,27,0.03,21
3074.093428,63,85,0.43,22,0.019545455,21
3074.061333,51,89,0.99,38,0.026052632,21
3073.977951,63,81,0.45,18,0.025,21
3073.977951,62,82,0.5,20,0.025,21
3073.977951,59,86,0.67,27,0.024814815,21
3073.621907,38,54,0.63,16,0.039375,21
3073.619692,63,73,0.27,10,0.027,21
3073.523782,68,75,0.15,7,0.021428571,21
3073.49227,40,52,0.45,12,0.0375,21
3073.33976,58,87,0.58,29,0.02,21
3073.290333,52,59,0.18,7,0.025714286,21
3073.281048,51,85,0.96,34,0.028235294,21
3073.03356,56,86,0.67,30,0.022333333,21
3072.856534,51,84,0.93,33,0.028181818,21
3072.799164,68,74,0.13,6,0.021666667,21
3072.708709,53,86,0.91,33,0.027575758,21
3072.497704,51,84,0.94,33,0.028484848,21
3072.456765,44,69,0.63,25,0.0252,21
3072.354716,41,51,0.37,10,0.037,21
3072.114897,56,81,0.66,25,0.0264,21
3072.027468,53,84,0.85,31,0.027419355,21
3072.027468,52,85,0.91,33,0.027575758,21
3072.027468,51,87,0.98,36,0.027222222,21
3071.892183,46,63,0.44,17,0.025882353,21
3071.374946,52,87,0.94,35,0.026857143,21
3071.374946,51,88,0.99,37,0.026756757,21
3071.36547,65,77,0.32,12,0.026666667,21
3070.971052,52,86,0.89,34,0.026176471,21
3070.958088,41,72,0.78,31,0.02516129,21
3070.925966,57,92,0.67,35,0.019142857,21
3070.765337,45,75,0.78,30,0.026,21
3070.615091,38,58,0.7,20,0.035,21
3070.46165,60,84,0.6,24,0.025,21
3070.405244,52,84,0.89,32,0.0278125,21
3070.370191,47,63,0.56,16,0.035,21
3070.363677,57,80,0.61,23,0.026521739,21
3070.315823,51,90,0.99,39,0.025384615,21
3070.24051,56,87,0.79,31,0.025483871,21
3070.215904,51,65,0.42,14,0.03,21
3070.073321,38,61,0.76,23,0.033043478,21
3070.053044,58,82,0.62,24,0.025833333,21
3069.859954,43,80,0.91,37,0.024594595,21
3069.817433,35,51,0.66,16,0.04125,21
3069.72136,40,77,0.98,37,0.026486486,21
3069.274813,38,63,0.85,25,0.034,21
3069.23695,34,57,0.86,23,0.037391304,21
3069.107476,50,85,0.99,35,0.028285714,21
3069.102146,57,64,0.18,7,0.025714286,21
3069.068634,38,52,0.53,14,0.037857143,21
3069.068634,37,53,0.61,16,0.038125,21
3069.065125,45,69,0.77,24,0.032083333,21
3068.78946,59,74,0.43,15,0.028666667,21
3068.750242,36,65,0.99,29,0.034137931,21
3068.731202,58,79,0.56,21,0.026666667,21
3068.731202,56,81,0.67,25,0.0268,21
3068.731202,55,83,0.74,28,0.026428571,21
3068.497913,43,57,0.47,14,0.033571429,21
3068.273601,62,83,0.42,21,0.02,21
3068.045364,54,85,0.83,31,0.026774194,21
3068.045364,53,86,0.88,33,0.026666667,21
3068.045364,52,88,0.95,36,0.026388889,21
3068.044211,65,78,0.28,13,0.021538462,21
3067.975191,36,52,0.59,16,0.036875,21
3067.700793,33,52,0.8,19,0.042105263,21
3067.635531,54,78,0.72,24,0.03,21
3067.375249,43,60,0.52,17,0.030588235,21
3067.360129,37,55,0.71,18,0.039444444,21
3067.316471,56,68,0.37,12,0.030833333,21
3067.185582,54,81,0.75,27,0.027777778,21
3067.171822,51,89,0.97,38,0.025526316,21
3067.034777,36,58,0.81,22,0.036818182,21
3067.021344,47,67,0.5,20,0.025,21
3066.890121,51,88,0.96,37,0.025945946,21
3066.796259,38,61,0.82,23,0.035652174,21
3066.793657,53,86,0.87,33,0.026363636,21
3066.724778,42,82,0.97,40,0.02425,21
3066.701858,39,55,0.6,16,0.0375,21
3066.340924,61,74,0.37,13,0.028461538,21
3066.340924,60,76,0.45,16,0.028125,21
3066.340924,57,79,0.62,22,0.028181818,21
3066.191049,34,60,0.98,26,0.037692308,21
3066.169548,41,65,0.77,24,0.032083333,21
3066.110411,39,53,0.53,14,0.037857143,21
3066.109504,37,57,0.73,20,0.0365,21
3066.00486,41,48,0.27,7,0.038571429,21
3065.582054,41,71,0.76,30,0.025333333,21
3065.411831,37,57,0.71,20,0.0355,21
3065.404395,56,82,0.69,26,0.026538462,21
3065.392916,55,91,0.9,36,0.025,21
3065.136271,38,71,0.94,33,0.028484848,21
3065.118995,43,63,0.59,20,0.0295,21
3064.948422,40,74,0.92,34,0.027058824,21
3064.841232,61,72,0.32,11,0.029090909,21
3064.765605,44,69,0.71,25,0.0284,21
3064.74247,40,61,0.7,21,0.033333333,21
3064.701721,59,87,0.55,28,0.019642857,21
3064.226,56,80,0.65,24,0.027083333,21
3064.18834,63,71,0.23,8,0.02875,21
3064.186513,61,82,0.45,21,0.021428571,21
3063.825997,51,85,0.98,34,0.028823529,21
3063.799933,47,52,0.17,5,0.034,21
3063.741368,40,71,0.97,31,0.031290323,21
3063.66994,39,69,0.87,30,0.029,21
3063.487487,51,86,0.98,35,0.028,21
3063.406745,41,73,0.9,32,0.028125,21
3063.406745,40,74,0.96,34,0.028235294,21
3063.380233,39,50,0.42,11,0.038181818,21
3063.221109,35,53,0.64,18,0.035555556,21
3063.157965,68,76,0.16,8,0.02,21
3063.157965,67,77,0.2,10,0.02,21
3063.101363,35,60,0.89,25,0.0356,21
3063.086583,32,54,0.89,22,0.040454545,21
3062.818848,62,73,0.31,11,0.028181818,21
3062.746274,34,51,0.72,17,0.042352941,21
3062.615991,60,79,0.5,19,0.026315789,21
3062.524733,55,83,0.73,28,0.026071429,21
3062.441312,51,82,0.92,31,0.029677419,21
3062.397787,47,63,0.42,16,0.02625,21
3062.183053,53,81,0.79,28,0.028214286,21
3062.183053,52,82,0.85,30,0.028333333,21
3062.183053,51,83,0.91,32,0.0284375,21
3062.167031,40,79,0.92,39,0.023589744,21
3061.780124,65,76,0.25,11,0.022727273,21
3061.708144,58,79,0.55,21,0.026190476,21
3061.547615,64,80,0.4,16,0.025,21
3061.298954,49,63,0.36,14,0.025714286,21
3061.245033,54,83,0.82,29,0.028275862,21
3061.245033,53,85,0.89,32,0.0278125,21
3061.245033,52,86,0.95,34,0.027941176,21
3060.994271,45,68,0.58,23,0.025217391,21
3060.887469,40,50,0.37,10,0.037,21
3060.874758,53,83,0.81,30,0.027,21
3060.851616,66,78,0.24,12,0.02,21
3060.81725,61,84,0.46,23,0.02,21
3060.710207,40,51,0.41,11,0.037272727,21
3060.04065,54,93,0.76,39,0.019487179,21
3060.019006,62,88,0.5,26,0.019230769,21
3059.957931,33,54,0.84,21,0.04,21
3059.839229,40,60,0.67,20,0.0335,21
3059.788445,33,53,0.82,20,0.041,21
3059.688714,54,84,0.81,30,0.027,21
3059.688714,53,85,0.86,32,0.026875,21
3059.688714,52,86,0.92,34,0.027058824,21
3059.677195,55,78,0.74,23,0.032173913,21
3059.645938,65,79,0.3,14,0.021428571,21
3059.183381,56,60,0.12,4,0.03,21
3059.061546,36,55,0.68,19,0.035789474,21
3058.895744,42,71,0.83,29,0.02862069,21
3058.780473,37,64,0.9,27,0.033333333,21
3058.633494,53,87,0.87,34,0.025588235,21
3058.633494,52,88,0.92,36,0.025555556,21
3058.588412,52,84,0.91,32,0.0284375,21
3058.22613,39,64,0.76,25,0.0304,21
3058.185392,41,78,0.88,37,0.023783784,21
3058.183124,55,80,0.72,25,0.0288,21
3058.183124,54,81,0.78,27,0.028888889,21
3057.805058,36,60,0.85,24,0.035416667,21
3057.480701,62,81,0.48,19,0.025263158,21
3057.428867,62,81,0.49,19,0.025789474,21
3057.246708,41,72,0.88,31,0.028387097,21
3057.217037,34,53,0.76,19,0.04,21
3056.970268,47,70,0.68,23,0.029565217,21
3056.685565,44,46,0.08,2,0.04,21
3056.685565,43,47,0.16,4,0.04,21
3056.676103,33,55,0.81,22,0.036818182,21
3056.667251,41,50,0.35,9,0.038888889,21
3056.587797,59,86,0.54,27,0.02,21
3056.41258,52,81,0.84,29,0.028965517,21
3056.377383,37,64,0.93,27,0.034444444,21
3056.36769,50,81,0.94,31,0.030322581,21
3056.122303,65,81,0.33,16,0.020625,21
3056.019356,32,59,0.99,27,0.036666667,21
3055.785345,48,63,0.38,15,0.025333333,21
3055.696461,46,65,0.66,19,0.034736842,21
3055.425093,52,90,0.96,38,0.025263158,21
3055.264486,43,70,0.77,27,0.028518519,21
3055.09645,45,68,0.65,23,0.02826087,21
3055.084823,53,85,0.84,32,0.02625,21
3055.058192,58,69,0.27,11,0.024545455,21
3055.058192,57,70,0.32,13,0.024615385,21
3054.905482,63,87,0.46,24,0.019166667,21
3054.826421,33,55,0.82,22,0.037272727,21
3054.736283,52,85,0.88,33,0.026666667,21
3054.693293,54,80,0.74,26,0.028461538,21
3054.688359,52,83,0.9,31,0.029032258,21
3054.688359,51,84,0.96,33,0.029090909,21
3054.679407,38,65,0.83,27,0.030740741,21
3054.675422,40,51,0.4,11,0.036363636,21
3054.450604,54,77,0.7,23,0.030434783,21
3054.450604,53,78,0.76,25,0.0304,21
3054.321517,34,53,0.79,19,0.041578947,21
3054.041604,35,55,0.77,20,0.0385,21
3054.024563,64,79,0.32,15,0.021333333,21
3053.929222,44,58,0.43,14,0.030714286,21
3053.90691,58,73,0.45,15,0.03,21
3053.90691,57,74,0.51,17,0.03,21
3053.90691,56,75,0.57,19,0.03,21
3053.886889,40,75,0.97,35,0.027714286,21
3053.843089,33,59,0.93,26,0.035769231,21
3053.781956,48,65,0.43,17,0.025294118,21
3053.77999,37,55,0.64,18,0.035555556,21
3053.692913,59,83,0.53,24,0.022083333,21
3053.578675,55,79,0.67,24,0.027916667,21
3053.578675,54,80,0.73,26,0.028076923,21
3053.304233,56,79,0.66,23,0.028695652,21
3053.304233,54,82,0.8,28,0.028571429,21
3053.226171,65,85,0.38,20,0.019,21
3053.014441,54,84,0.8,30,0.026666667,21
3052.983116,40,62,0.69,22,0.031363636,21
3052.660429,44,70,0.71,26,0.027307692,21
3052.538325,44,71,0.67,27,0.024814815,21
3052.494022,51,88,0.97,37,0.026216216,21
3052.442558,49,61,0.42,12,0.035,21
3052.442558,48,62,0.49,14,0.035,21
3052.060909,39,50,0.4,11,0.036363636,21
3052.057502,50,63,0.41,13,0.031538462,21
3052.057502,48,65,0.54,17,0.031764706,21
3051.874551,40,74,0.94,34,0.027647059,21
3051.857587,43,79,0.91,36,0.025277778,21
3051.742508,51,83,0.92,32,0.02875,21
3051.647804,37,63,0.88,26,0.033846154,21
3051.401491,49,62,0.33,13,0.025384615,21
3051.393265,34,61,0.95,27,0.035185185,21
3051.305014,48,64,0.41,16,0.025625,21
3051.061323,52,88,0.98,36,0.027222222,21
3051.023179,43,55,0.41,12,0.034166667,21
3051.018006,41,58,0.59,17,0.034705882,21
3050.97681,62,73,0.34,11,0.030909091,21
3050.782236,36,52,0.63,16,0.039375,21
3050.747556,63,86,0.45,23,0.019565217,21
3050.725784,35,56,0.75,21,0.035714286,21
3050.725083,44,62,0.53,18,0.029444444,21
3050.388843,55,85,0.79,30,0.026333333,21
3050.118678,32,56,0.96,24,0.04,21
3049.691482,36,54,0.68,18,0.037777778,21
3049.356343,48,57,0.27,9,0.03,21
3049.251638,53,84,0.82,31,0.026451613,21
3049.237674,34,55,0.73,21,0.034761905,21
3048.96692,47,51,0.13,4,0.0325,21
3048.881689,51,85,0.97,34,0.028529412,21
3048.686961,38,64,0.81,26,0.031153846,21
3048.524701,40,59,0.67,19,0.035263158,21
3048.495529,50,83,0.99,33,0.03,21
3048.22737,42,60,0.56,18,0.031111111,21
3048.124127,37,53,0.58,16,0.03625,21
3047.96623,42,76,0.81,34,0.023823529,21
3047.778059,50,59,0.32,9,0.035555556,21
3047.600243,55,76,0.63,21,0.03,21
3047.499662,42,68,0.67,26,0.025769231,21
3047.192658,52,80,0.84,28,0.03,21
3047.000899,59,76,0.46,17,0.027058824,21
3046.991281,35,58,0.85,23,0.036956522,21
3046.98775,44,54,0.33,10,0.033,21
3046.883735,41,54,0.43,13,0.033076923,21
3046.775533,46,64,0.63,18,0.035,21
3046.714247,35,58,0.83,23,0.036086957,21
3046.634028,36,58,0.82,22,0.037272727,21
3046.329034,34,58,0.85,24,0.035416667,21
3045.791445,58,85,0.59,27,0.021851852,21
3045.683885,51,84,0.95,33,0.028787879,21
3045.570881,61,83,0.55,22,0.025,21
3045.570881,58,87,0.72,29,0.024827586,21
3045.557147,56,91,0.86,35,0.024571429,21
3045.557147,55,92,0.91,37,0.024594595,21
3045.516197,34,55,0.79,21,0.037619048,21
3045.516197,33,56,0.87,23,0.037826087,21
3045.478872,66,78,0.26,12,0.021666667,21
3045.353215,38,64,0.82,26,0.031538462,21
3045.216935,41,55,0.47,14,0.033571429,21
3045.082509,41,50,0.34,9,0.037777778,21
3045.048875,53,75,0.51,22,0.023181818,21
3044.889784,53,86,0.85,33,0.025757576,21
3044.889784,52,87,0.91,35,0.026,21
3044.889784,51,89,0.98,38,0.025789474,21
3044.835798,42,56,0.48,14,0.034285714,21
3044.648907,39,54,0.57,15,0.038,21
3044.607457,37,64,0.92,27,0.034074074,21
3044.556456,54,86,0.82,32,0.025625,21
3044.53193,61,84,0.57,23,0.024782609,21
3044.53193,60,85,0.62,25,0.0248,21
3044.501278,65,77,0.31,12,0.025833333,21
3044.46537,58,76,0.52,18,0.028888889,21
3044.37166,61,88,0.53,27,0.01962963,21
3044.212321,36,62,0.87,26,0.033461538,21
3044.181693,40,75,0.95,35,0.027142857,21
3044.178813,52,82,0.88,30,0.029333333,21
3044.178813,51,83,0.94,32,0.029375,21
3044.008337,55,95,0.77,40,0.01925,21
3043.875139,32,54,0.91,22,0.041363636,21
3043.705701,52,86,0.96,34,0.028235294,21
3043.663513,59,85,0.66,26,0.025384615,21
3043.435049,39,60,0.72,21,0.034285714,21
3043.37574,36,64,0.99,28,0.035357143,21
3043.085639,37,67,0.92,30,0.030666667,21
3042.887574,52,84,0.87,32,0.0271875,21
3042.745783,43,56,0.44,13,0.033846154,21
3042.635196,45,64,0.49,19,0.025789474,21
3042.105663,67,82,0.29,15,0.019333333,21
3042.025742,41,74,0.9,33,0.027272727,21
3041.999596,57,86,0.64,29,0.022068966,21
3041.974616,56,81,0.7,25,0.028,21
3041.974616,55,82,0.76,27,0.028148148,21
3041.935702,51,78,0.62,27,0.022962963,21
3041.841374,33,56,0.86,23,0.037391304,21
3041.714242,58,84,0.58,26,0.022307692,21
3041.142686,58,74,0.48,16,0.03,21
3041.142686,57,75,0.54,18,0.03,21
3041.050553,67,75,0.21,8,0.02625,21
3041.050553,64,78,0.37,14,0.026428571,21
3040.771951,33,59,0.92,26,0.035384615,21
3040.658594,38,65,0.84,27,0.031111111,21
3040.185532,39,79,0.96,40,0.024,21
3039.803459,45,52,0.24,7,0.034285714,21
3039.600668,40,60,0.68,20,0.034,21
3039.55335,60,85,0.5,25,0.02,21
3039.352128,61,85,0.5,24,0.020833333,21
3039.134172,54,82,0.75,28,0.026785714,21
3039.023489,38,53,0.57,15,0.038,21
3038.886337,64,82,0.37,18,0.020555556,21
3038.784782,47,63,0.5,16,0.03125,21
3038.67211,52,87,0.98,35,0.028,21
3038.645318,53,82,0.84,29,0.028965517,21
3038.539479,36,57,0.75,21,0.035714286,21
3038.280749,44,70,0.84,26,0.032307692,21
3038.24292,37,54,0.61,17,0.035882353,21
3038.220818,60,85,0.53,25,0.0212,21
3038.207225,35,57,0.79,22,0.035909091,21
3038.027256,53,79,0.78,26,0.03,21
3037.930014,42,66,0.69,24,0.02875,21
3037.923234,58,70,0.4,12,0.033333333,21
3037.904105,40,59,0.65,19,0.034210526,21
3037.797021,56,76,0.65,20,0.0325,21
3037.716879,35,58,0.86,23,0.037391304,21
3037.643404,63,80,0.43,17,0.025294118,21
3037.375979,42,65,0.68,23,0.029565217,21
3037.317225,44,49,0.19,5,0.038,21
3037.042592,38,72,0.97,34,0.028529412,21
3036.998585,54,85,0.8,31,0.025806452,21
3036.649616,39,52,0.49,13,0.037692308,21
3036.360273,42,51,0.34,9,0.037777778,21
3036.287506,60,75,0.43,15,0.028666667,21
3036.287506,55,81,0.74,26,0.028461538,21
3036.159751,43,49,0.21,6,0.035,21
3036.159751,42,50,0.28,8,0.035,21
3036.005364,40,59,0.6,19,0.031578947,21
3035.920507,73,75,0.04,2,0.02,21
3035.920507,72,76,0.08,4,0.02,21
3035.920507,71,77,0.12,6,0.02,21
3035.920507,70,78,0.16,8,0.02,21
3035.860567,66,77,0.28,11,0.025454545,21
3035.860567,65,78,0.33,13,0.025384615,21
3035.842965,37,64,0.94,27,0.034814815,21
3035.698856,44,57,0.41,13,0.031538462,21
3035.674456,58,74,0.52,16,0.0325,21
3035.662265,56,92,0.87,36,0.024166667,21
3035.457911,55,79,0.7,24,0.029166667,21
3035.052983,57,78,0.57,21,0.027142857,21
3034.99539,56,86,0.68,30,0.022666667,21
3034.939959,54,81,0.74,27,0.027407407,21
3034.210439,42,72,0.96,30,0.032,21
3033.927466,34,59,0.94,25,0.0376,21
3033.525932,52,83,0.86,31,0.027741935,21
3033.525932,51,84,0.92,33,0.027878788,21
3033.525932,50,86,0.99,36,0.0275,21
3033.434877,35,59,0.9,24,0.0375,21
3033.382286,43,59,0.5,16,0.03125,21
3032.823116,56,72,0.37,16,0.023125,21
3032.820378,54,83,0.77,29,0.026551724,21
3032.792724,62,86,0.48,24,0.02,21
3032.792724,61,87,0.52,26,0.02,21
3032.792724,60,88,0.56,28,0.02,21
3032.672611,32,58,0.97,26,0.037307692,21
3032.640416,67,76,0.23,9,0.025555556,21
3032.640416,60,84,0.61,24,0.025416667,21
3032.576108,66,76,0.26,10,0.026,21
3032.56864,35,52,0.64,17,0.037647059,21
3032.555646,45,66,0.72,21,0.034285714,21
3032.3011,64,85,0.41,21,0.01952381,21
3032.24622,40,65,0.74,25,0.0296,21
3032.213516,65,77,0.26,12,0.021666667,21
3032.137617,58,94,0.71,36,0.019722222,21
3032.057132,62,78,0.37,16,0.023125,21
3032.002687,58,83,0.57,25,0.0228,21
3031.564596,34,57,0.87,23,0.037826087,21
3031.52632,42,64,0.65,22,0.029545455,21
3031.38358,60,67,0.17,7,0.024285714,21
3031.288851,40,67,0.79,27,0.029259259,21
3031.211178,46,56,0.31,10,0.031,21
3031.022731,43,68,0.87,25,0.0348,21
3030.992193,67,80,0.26,13,0.02,21
3030.812774,57,71,0.47,14,0.033571429,21
3030.791955,36,51,0.6,15,0.04,21
3030.698697,54,96,0.89,42,0.021190476,21
3030.408446,62,72,0.29,10,0.029,21
3030.396722,56,80,0.68,24,0.028333333,21
3030.380298,60,72,0.39,12,0.0325,21
3030.356136,34,51,0.71,17,0.041764706,21
3030.232025,51,63,0.37,12,0.030833333,21
3030.150214,52,85,0.94,33,0.028484848,21
3030.105655,56,82,0.68,26,0.026153846,21
3030.105655,53,86,0.86,33,0.026060606,21
3030.071815,69,79,0.19,10,0.019,21
3029.716859,66,81,0.3,15,0.02,21
3029.716859,65,82,0.34,17,0.02,21
3029.589055,55,63,0.21,8,0.02625,21
3029.515178,54,77,0.76,23,0.033043478,21
3029.514342,42,73,0.99,31,0.031935484,21
3029.452404,39,67,0.82,28,0.029285714,21
3029.04234,55,73,0.42,18,0.023333333,21
3028.994318,36,54,0.65,18,0.036111111,21
3028.978053,38,63,0.8,25,0.032,21
3028.852791,44,77,0.85,33,0.025757576,21
3028.835631,56,89,0.83,33,0.025151515,21
3028.424558,54,83,0.83,29,0.02862069,21
3028.327495,42,70,0.86,28,0.030714286,21
3028.271181,56,76,0.6,20,0.03,21
3028.271181,55,77,0.66,22,0.03,21
3028.255325,59,68,0.22,9,0.024444444,21
3027.927694,34,57,0.82,23,0.035652174,21
3027.833383,59,82,0.53,23,0.023043478,21
3027.279616,62,79,0.38,17,0.022352941,21
3027.242466,60,92,0.62,32,0.019375,21
3027.230855,39,60,0.74,21,0.035238095,21
3027.208487,63,79,0.43,16,0.026875,21
3026.867975,41,57,0.55,16,0.034375,21
3026.784328,59,86,0.59,27,0.021851852,21
3026.749474,61,74,0.4,13,0.030769231,21
3026.733999,48,63,0.42,15,0.028,21
3026.412258,42,58,0.54,16,0.03375,21
3025.935162,34,59,0.93,25,0.0372,21
3025.932395,33,56,0.91,23,0.039565217,21
3025.873121,44,52,0.26,8,0.0325,21
3025.782342,52,60,0.18,8,0.0225,21
3025.223543,55,83,0.78,28,0.027857143,21
3025.223543,54,84,0.84,30,0.028,21
3025.223543,53,85,0.9,32,0.028125,21
3025.060772,50,65,0.46,15,0.030666667,21
3025.012429,58,75,0.5,17,0.029411765,21
3025.012429,57,76,0.56,19,0.029473684,21
3025.012429,54,80,0.76,26,0.029230769,21
3025.012429,53,81,0.82,28,0.029285714,21
3024.900493,37,62,0.82,25,0.0328,21
3024.537208,34,53,0.77,19,0.040526316,21
3024.446985,69,79,0.2,10,0.02,21
3024.189134,51,81,0.91,30,0.030333333,21
3024.164863,35,59,0.89,24,0.037083333,21
3024.140482,43,67,0.86,24,0.035833333,21
3023.732982,57,89,0.8,32,0.025,21
3023.539396,57,88,0.66,31,0.021290323,21
3023.343164,41,49,0.29,8,0.03625,21
3023.343164,38,53,0.54,15,0.036,21
3023.304926,47,62,0.39,15,0.026,21
3023.048817,60,73,0.38,13,0.029230769,21
3023.048817,59,74,0.44,15,0.029333333,21
3023.048817,57,77,0.58,20,0.029,21
3023.039377,56,90,0.72,34,0.021176471,21
3022.90534,46,71,0.74,25,0.0296,21
3022.750848,55,75,0.67,20,0.0335,21
3022.530386,36,65,0.93,29,0.032068966,21
3022.150509,50,79,0.67,29,0.023103448,21
3022.096096,55,94,0.75,39,0.019230769,21
3021.799502,33,58,0.95,25,0.038,21
3021.788401,44,61,0.55,17,0.032352941,21
3021.661462,51,83,0.95,32,0.0296875,21
3021.53711,41,56,0.48,15,0.032,21
3021.228932,57,67,0.3,10,0.03,21
3021.192333,59,67,0.19,8,0.02375,21
3021.192333,55,72,0.4,17,0.023529412,21
3021.135578,32,58,0.96,26,0.036923077,21
3020.929025,59,87,0.58,28,0.020714286,21
3020.921764,35,60,0.9,25,0.036,21
3020.913418,59,86,0.58,27,0.021481481,21
3020.868069,44,67,0.79,23,0.034347826,21
3020.783743,63,82,0.4,19,0.021052632,21
3020.690208,48,65,0.55,17,0.032352941,21
3020.647598,56,78,0.64,22,0.029090909,21
3020.514438,39,60,0.67,21,0.031904762,21
3020.455308,43,59,0.49,16,0.030625,21
3020.21142,41,73,0.92,32,0.02875,21
3019.982878,44,77,0.96,33,0.029090909,21
3019.956047,55,92,0.92,37,0.024864865,21
3019.924548,40,75,0.98,35,0.028,21
3019.824899,42,73,0.84,31,0.027096774,21
3019.630591,36,57,0.77,21,0.036666667,21
3019.429015,47,54,0.22,7,0.031428571,21
3019.145647,39,58,0.63,19,0.033157895,21
3019.145647,38,59,0.7,21,0.033333333,21
3018.983132,57,88,0.78,31,0.02516129,21
3018.950859,55,77,0.72,22,0.032727273,21
3018.806212,68,73,0.11,5,0.022,21
3018.410996,61,83,0.47,22,0.021363636,21
3018.259861,38,69,0.91,31,0.029354839,21
3018.212658,41,68,0.77,27,0.028518519,21
3018.006601,40,78,0.93,38,0.024473684,21
3017.983196,56,74,0.6,18,0.033333333,21
3017.882592,55,80,0.73,25,0.0292,21
3017.882303,54,95,0.99,41,0.024146341,21
3017.810498,42,70,0.96,28,0.034285714,21
3017.585665,57,74,0.56,17,0.032941176,21
3017.347787,67,81,0.28,14,0.02,21
3017.347787,66,82,0.32,16,0.02,21
3017.347787,65,83,0.36,18,0.02,21
3017.313829,47,64,0.44,17,0.025882353,21
3017.212673,45,68,0.75,23,0.032608696,21
3017.119736,38,61,0.81,23,0.035217391,21
3017.072277,69,75,0.13,6,0.021666667,21
3016.975399,54,89,0.78,35,0.022285714,21
3016.966782,59,85,0.67,26,0.025769231,21
3016.783893,57,84,0.62,27,0.022962963,21
3016.752228,55,91,0.91,36,0.025277778,21
3016.739854,52,53,0.03,1,0.03,21
3016.700277,36,56,0.74,20,0.037,21
3016.629706,49,63,0.32,14,0.022857143,21
3016.593642,38,63,0.86,25,0.0344,21
3016.33137,61,81,0.44,20,0.022,21
3016.282706,52,85,0.9,33,0.027272727,21
3016.282706,51,86,0.96,35,0.027428571,21
3016.196193,63,77,0.32,14,0.022857143,21
3016.102307,38,50,0.45,12,0.0375,21
3015.993844,39,48,0.33,9,0.036666667,21
3015.964445,39,63,0.74,24,0.030833333,21
3015.791981,47,59,0.34,12,0.028333333,21
3015.604688,65,84,0.37,19,0.019473684,21
3015.545673,45,53,0.26,8,0.0325,21
3015.545673,43,55,0.39,12,0.0325,21
3015.50424,38,49,0.4,11,0.036363636,21
3015.301857,60,83,0.5,23,0.02173913,21
3014.800674,41,60,0.59,19,0.031052632,21
3014.663558,60,81,0.48,21,0.022857143,21
3014.561681,56,79,0.63,23,0.027391304,21
3014.300472,42,67,0.69,25,0.0276,21
3014.272553,51,86,0.94,35,0.026857143,21
3013.998179,38,62,0.83,24,0.034583333,21
3013.828042,62,79,0.39,17,0.022941176,21
3013.822728,57,85,0.62,28,0.022142857,21
3013.518303,53,98,0.95,45,0.021111111,21
3013.408509,40,73,0.95,33,0.028787879,21
3013.172916,39,61,0.75,22,0.034090909,21
3013.156846,52,84,0.88,32,0.0275,21
3013.156846,51,85,0.94,34,0.027647059,21
3012.991296,44,68,0.61,24,0.025416667,21
3012.981419,40,60,0.64,20,0.032,21
3012.825332,59,84,0.64,25,0.0256,21
3012.769491,62,69,0.23,7,0.032857143,21
3012.748096,59,70,0.37,11,0.033636364,21
3012.626828,62,68,0.2,6,0.033333333,21
3012.626828,59,71,0.4,12,0.033333333,21
3012.588797,40,62,0.68,22,0.030909091,21
3012.433542,40,59,0.62,19,0.032631579,21
3012.162608,55,84,0.75,29,0.025862069,21
3011.903968,50,62,0.39,12,0.0325,21
3011.808597,63,81,0.39,18,0.021666667,21
3011.76826,54,79,0.81,25,0.0324,21
3011.720922,58,86,0.61,28,0.021785714,21
3011.546759,59,84,0.55,25,0.022,21
3011.302211,53,84,0.88,31,0.028387097,21
3011.006155,40,52,0.42,12,0.035,21
3010.775121,40,64,0.73,24,0.030416667,21
3010.686577,56,66,0.31,10,0.031,21
3010.684062,46,65,0.49,19,0.025789474,21
3010.599431,44,71,0.86,27,0.031851852,21
3010.491386,68,80,0.24,12,0.02,21
3010.431778,44,68,0.81,24,0.03375,21
3010.40333,64,77,0.29,13,0.022307692,21
3010.325912,56,72,0.54,16,0.03375,21
3010.322592,40,75,0.96,35,0.027428571,21
3010.319474,63,79,0.36,16,0.0225,21
3010.229241,60,82,0.49,22,0.022272727,21
3010.030195,37,55,0.68,18,0.037777778,21
3010.011392,35,59,0.88,24,0.036666667,21
3009.959651,53,78,0.83,25,0.0332,21
3009.935214,39,58,0.64,19,0.033684211,21
3009.892564,33,59,0.96,26,0.036923077,21
3009.829539,40,73,0.94,33,0.028484848,21
3009.637431,40,63,0.7,23,0.030434783,21
3009.617894,36,56,0.76,20,0.038,21
3009.413132,62,82,0.43,20,0.0215,21
3009.413132,60,84,0.52,24,0.021666667,21
3009.413132,58,87,0.62,29,0.02137931,21
3009.394303,44,80,0.88,36,0.024444444,21
3009.343725,47,52,0.16,5,0.032,21
3009.284859,39,60,0.71,21,0.033809524,21
3009.047345,55,88,0.73,33,0.022121212,21
3008.907146,36,58,0.79,22,0.035909091,21
3008.907146,35,59,0.87,24,0.03625,21
3008.807377,55,81,0.7,26,0.026923077,21
3008.807377,55,82,0.72,27,0.026666667,21
3008.807377,53,84,0.83,31,0.026774194,21
3008.794803,59,86,0.57,27,0.021111111,21
3008.685019,36,65,0.91,29,0.03137931,21
3008.519961,41,61,0.62,20,0.031,21
3008.148409,37,56,0.74,19,0.038947368,21
3008.01748,57,79,0.59,22,0.026818182,21
3007.837879,62,80,0.4,18,0.022222222,21
3007.804809,40,76,0.93,36,0.025833333,21
3007.467409,38,57,0.65,19,0.034210526,21
3007.069741,41,58,0.54,17,0.031764706,21
3007.060429,45,68,0.59,23,0.025652174,21
3007.015765,43,66,0.63,23,0.027391304,21
3006.920819,56,90,0.85,34,0.025,21
3006.768173,60,86,0.64,26,0.024615385,21
3006.768173,59,87,0.69,28,0.024642857,21
3006.768173,58,87,0.73,29,0.025172414,21
3006.596448,37,68,0.94,31,0.030322581,21
3006.441295,60,75,0.46,15,0.030666667,21
3006.417108,52,86,0.9,34,0.026470588,21
3006.312964,59,85,0.56,26,0.021538462,21
3006.312964,57,87,0.65,30,0.021666667,21
3006.312964,56,89,0.71,33,0.021515152,21
3006.213407,66,76,0.22,10,0.022,21
3006.102242,52,62,0.31,10,0.031,21
3006.050896,47,58,0.33,11,0.03,21
3006.036719,39,59,0.73,20,0.0365,21
3005.988317,46,59,0.37,13,0.028461538,21
3005.77304,47,65,0.41,18,0.022777778,21
3005.770573,43,68,0.86,25,0.0344,21
3005.755598,71,73,0.05,2,0.025,21
3005.755598,70,74,0.1,4,0.025,21
3005.755598,69,75,0.15,6,0.025,21
3005.755598,68,76,0.2,8,0.025,21
3005.755598,67,77,0.25,10,0.025,21
3005.755598,66,78,0.3,12,0.025,21
3005.755598,65,79,0.35,14,0.025,21
3005.755598,63,82,0.47,19,0.024736842,21
3005.755598,62,83,0.52,21,0.024761905,21
3005.631483,34,63,0.99,29,0.034137931,21
3005.60402,36,59,0.86,23,0.037391304,21
3005.420945,39,61,0.76,22,0.034545455,21
3005.275881,55,96,0.84,41,0.020487805,21
3005.237558,53,83,0.87,30,0.029,21
3005.166107,57,93,0.75,36,0.020833333,21
3004.319788,35,64,0.95,29,0.032758621,21
3004.158274,61,84,0.58,23,0.025217391,21
3004.158274,60,85,0.63,25,0.0252,21
3004.158274,59,86,0.68,27,0.025185185,21
3004.158274,58,88,0.75,30,0.025,21
3004.103367,56,77,0.62,21,0.02952381,21
3004.103367,55,78,0.68,23,0.029565217,21
3004.103367,54,79,0.74,25,0.0296,21
3004.103367,53,80,0.8,27,0.02962963,21
3004.103367,52,81,0.86,29,0.029655172,21
3003.87905,47,62,0.54,15,0.036,21
3003.87905,46,63,0.61,17,0.035882353,21
3003.807816,50,66,0.48,16,0.03,21
3003.800473,41,74,0.91,33,0.027575758,21
3003.782246,44,65,0.76,21,0.036190476,21
3003.757896,40,69,0.84,29,0.028965517,21
3003.556665,39,71,0.91,32,0.0284375,21
3003.366104,37,50,0.52,13,0.04,21
3003.164211,54,93,0.97,39,0.024871795,21
3003.130586,52,81,0.87,29,0.03,21
3003.130586,51,82,0.93,31,0.03,21
3003.077498,40,58,0.61,18,0.033888889,21
3002.997516,61,63,0.06,2,0.03,21
3002.997516,60,64,0.12,4,0.03,21
3002.997516,59,65,0.18,6,0.03,21
3002.997516,58,66,0.24,8,0.03,21
3002.763993,34,57,0.83,23,0.036086957,21
3002.585179,51,87,0.96,36,0.026666667,21
3002.516782,34,52,0.74,18,0.041111111,21
3002.501769,37,53,0.56,16,0.035,21
3002.388123,53,79,0.85,26,0.032692308,21
3002.01413,59,72,0.43,13,0.033076923,21
3001.754986,38,93,0.07,55,0.001272727,21
3001.618187,53,85,0.85,32,0.0265625,21
3001.602245,54,74,0.47,20,0.0235,21
3001.564889,32,56,0.97,24,0.040416667,21
3001.527797,54,62,0.19,8,0.02375,21
3001.471412,62,80,0.39,18,0.021666667,21
3001.25676,56,85,0.66,29,0.022758621,21
3001.25676,55,86,0.71,31,0.022903226,21
3001.09381,44,66,0.78,22,0.035454545,21
3001.057017,61,73,0.35,12,0.029166667,21
3001.057017,56,79,0.67,23,0.029130435,21
3000.970678,62,82,0.51,20,0.0255,21
3000.970678,61,83,0.56,22,0.025454545,21
3000.966198,50,63,0.33,13,0.025384615,21
3000.966198,49,64,0.38,15,0.025333333,21
3000.929839,54,81,0.79,27,0.029259259,21
3000.830117,54,84,0.79,30,0.026333333,21
3000.54408,64,81,0.36,17,0.021176471,21
3000.40192,50,76,0.76,26,0.029230769,21
3000.390966,56,68,0.36,12,0.03,21
3000.390966,55,69,0.42,14,0.03,21
3000.380779,61,83,0.48,22,0.021818182,21
3000.341861,66,77,0.24,11,0.021818182,21
3000.135113,62,80,0.49,18,0.027222222,21
3000.105303,53,82,0.81,29,0.027931034,21
3000.105303,52,83,0.87,31,0.028064516,21
3000.078244,42,73,0.82,31,0.026451613,21
3000.053007,44,70,0.83,26,0.031923077,21
