% profit,ema1,ema2,threshold,diff,thresh / diff,ID
3527.262397,43,48,0.19,5,0.038,55
3519.752702,5,12,0.42,7,0.06,55
3464.735444,42,76,0.8,34,0.023529412,55
3451.551245,40,51,0.42,11,0.038181818,55
3432.41823,42,75,0.81,33,0.024545455,55
3422.318641,41,50,0.34,9,0.037777778,55
3406.152919,41,77,0.88,36,0.024444444,55
3393.31869,61,66,0.17,5,0.034,55
3380.60724,43,75,0.76,32,0.02375,55
3371.032365,37,60,0.8,23,0.034782609,55
3365.705047,45,50,0.18,5,0.036,55
3359.599986,4,14,0.53,10,0.053,55
3354.555161,47,61,0.36,14,0.025714286,55
3346.01314,53,74,0.73,21,0.034761905,55
3341.128016,38,59,0.73,21,0.034761905,55
3340.539057,41,55,0.49,14,0.035,55
3337.709315,47,58,0.29,11,0.026363636,55
3332.020047,41,50,0.31,9,0.034444444,55
3329.851338,45,60,0.4,15,0.026666667,55
3329.758296,36,62,0.92,26,0.035384615,55
3328.130146,46,59,0.34,13,0.026153846,55
3324.306538,46,62,0.41,16,0.025625,55
3323.513861,4,13,0.54,9,0.06,55
3316.649408,35,63,0.99,28,0.035357143,55
3316.001698,40,56,0.57,16,0.035625,55
3314.21156,48,57,0.24,9,0.026666667,55
3312.631491,41,51,0.34,10,0.034,55
3311.663148,40,52,0.41,12,0.034166667,55
3311.495222,43,62,0.51,19,0.026842105,55
3311.218687,42,49,0.24,7,0.034285714,55
3310.543742,40,73,0.92,33,0.027878788,55
3308.990159,38,58,0.72,20,0.036,55
3306.938234,35,62,0.97,27,0.035925926,55
3300.865906,49,63,0.45,14,0.032142857,55
3296.338756,41,51,0.37,10,0.037,55
3293.787922,51,56,0.13,5,0.026,55
3287.958607,39,53,0.48,14,0.034285714,55
3285.606897,41,54,0.48,13,0.036923077,55
3281.517232,49,59,0.26,10,0.026,55
3281.382241,40,72,0.93,32,0.0290625,55
3281.19188,48,60,0.31,12,0.025833333,55
3279.456694,43,63,0.52,20,0.026,55
3277.480452,51,63,0.29,12,0.024166667,55
3275.561736,43,63,0.53,20,0.0265,55
3275.366791,37,59,0.8,22,0.036363636,55
3273.092807,49,55,0.16,6,0.026666667,55
3272.739493,36,61,0.9,25,0.036,55
3271.659019,37,60,0.81,23,0.035217391,55
3271.659019,36,61,0.88,25,0.0352,55
3271.355947,39,75,0.98,36,0.027222222,55
3268.794442,37,60,0.82,23,0.035652174,55
3267.786183,50,65,0.36,15,0.024,55
3267.786183,49,66,0.41,17,0.024117647,55
3266.724898,36,61,0.89,25,0.0356,55
3266.146226,39,57,0.64,18,0.035555556,55
3265.964148,51,54,0.08,3,0.026666667,55
3265.50248,44,61,0.45,17,0.026470588,55
3264.429381,36,62,0.91,26,0.035,55
3263.254261,49,65,0.39,16,0.024375,55
3262.958793,42,53,0.4,11,0.036363636,55
3262.958793,39,57,0.65,18,0.036111111,55
3262.133206,50,64,0.34,14,0.024285714,55
3260.049606,36,62,0.9,26,0.034615385,55
3259.302313,46,58,0.32,12,0.026666667,55
3258.934815,46,57,0.3,11,0.027272727,55
3257.773339,40,70,0.96,30,0.032,55
3249.863305,45,59,0.38,14,0.027142857,55
3248.861842,48,55,0.19,7,0.027142857,55
3245.254297,42,70,0.69,28,0.024642857,55
3241.574896,53,54,0.03,1,0.03,55
3239.297106,37,60,0.84,23,0.036521739,55
3232.278197,48,67,0.46,19,0.024210526,55
3230.728756,41,77,0.85,36,0.023611111,55
3228.672322,45,61,0.42,16,0.02625,55
3225.313563,38,59,0.74,21,0.035238095,55
3224.01339,43,52,0.33,9,0.036666667,55
3223.745496,45,65,0.51,20,0.0255,55
3221.166139,42,65,0.6,23,0.026086957,55
3220.049336,51,61,0.32,10,0.032,55
3219.938176,46,60,0.37,14,0.026428571,55
3219.862242,37,56,0.64,19,0.033684211,55
3218.641985,44,62,0.48,18,0.026666667,55
3218.21714,35,64,0.99,29,0.034137931,55
3217.647366,45,64,0.48,19,0.025263158,55
3217.112244,44,60,0.43,16,0.026875,55
3215.483937,35,63,0.98,28,0.035,55
3215.325523,39,57,0.66,18,0.036666667,55
3212.702651,47,57,0.27,10,0.027,55
3212.218855,43,68,0.62,25,0.0248,55
3210.847578,44,65,0.53,21,0.025238095,55
3210.607,34,58,0.82,24,0.034166667,55
3208.018638,36,60,0.87,24,0.03625,55
3205.959476,34,59,0.84,25,0.0336,55
3205.413837,43,66,0.59,23,0.025652174,55
3202.923481,48,58,0.26,10,0.026,55
3202.544882,44,62,0.47,18,0.026111111,55
3200.582243,50,53,0.08,3,0.026666667,55
3196.589449,44,46,0.07,2,0.035,55
3192.374934,36,61,0.92,25,0.0368,55
3190.712526,50,59,0.23,9,0.025555556,55
3188.738283,36,62,0.89,26,0.034230769,55
3187.677183,35,62,0.98,27,0.036296296,55
3187.045695,43,69,0.64,26,0.024615385,55
3186.871954,8,13,0.18,5,0.036,55
3185.56258,41,54,0.47,13,0.036153846,55
3184.900177,37,60,0.83,23,0.036086957,55
3184.803298,39,74,0.98,35,0.028,55
3179.929027,38,58,0.71,20,0.0355,55
3177.744794,46,55,0.3,9,0.033333333,55
3177.49991,40,70,0.95,30,0.031666667,55
3177.416833,7,8,0.07,1,0.07,55
3175.129145,37,59,0.79,22,0.035909091,55
3174.958428,57,73,0.53,16,0.033125,55
3174.222549,35,62,0.99,27,0.036666667,55
3173.340206,47,56,0.24,9,0.026666667,55
3173.231519,60,68,0.27,8,0.03375,55
3170.398854,44,68,0.59,24,0.024583333,55
3169.602483,39,73,0.99,34,0.029117647,55
3169.325137,42,64,0.59,22,0.026818182,55
3169.202408,39,73,0.98,34,0.028823529,55
3168.6531,36,61,0.91,25,0.0364,55
3168.222369,45,69,0.74,24,0.030833333,55
3168.214426,51,58,0.18,7,0.025714286,55
3168.049808,42,75,0.8,33,0.024242424,55
3166.869243,35,61,0.97,26,0.037307692,55
3166.211334,56,74,0.6,18,0.033333333,55
3166.112607,40,69,0.93,29,0.032068966,55
3165.665472,40,74,0.85,34,0.025,55
3164.966648,60,67,0.24,7,0.034285714,55
3161.896352,49,60,0.28,11,0.025454545,55
3160.705992,53,60,0.17,7,0.024285714,55
3160.141639,41,77,0.86,36,0.023888889,55
3159.055164,55,85,0.84,30,0.028,55
3158.325237,53,88,0.98,35,0.028,55
3157.988098,44,59,0.41,15,0.027333333,55
3157.725838,43,67,0.61,24,0.025416667,55
3157.495211,49,61,0.3,12,0.025,55
3156.411319,39,50,0.39,11,0.035454545,55
3155.883258,34,59,0.85,25,0.034,55
3155.58118,43,75,0.75,32,0.0234375,55
3155.154488,41,69,0.88,28,0.031428571,55
3154.515543,40,55,0.54,15,0.036,55
3154.464307,41,54,0.46,13,0.035384615,55
3154.464307,40,56,0.56,16,0.035,55
3154.016502,35,61,0.96,26,0.036923077,55
3153.665541,59,69,0.34,10,0.034,55
3153.639896,43,47,0.14,4,0.035,55
3153.639896,42,48,0.21,6,0.035,55
3153.33897,35,58,0.77,23,0.033478261,55
3152.396199,54,86,0.9,32,0.028125,55
3152.396199,53,87,0.96,34,0.028235294,55
3152.255289,42,65,0.61,23,0.026521739,55
3150.565644,39,56,0.63,17,0.037058824,55
3150.193509,42,76,0.81,34,0.023823529,55
3149.695462,36,57,0.7,21,0.033333333,55
3147.974991,40,69,0.94,29,0.032413793,55
3147.737114,50,60,0.25,10,0.025,55
3147.231439,42,68,0.66,26,0.025384615,55
3147.139318,41,68,0.86,27,0.031851852,55
3146.79314,36,56,0.68,20,0.034,55
3146.773205,43,74,0.76,31,0.024516129,55
3146.234483,50,57,0.18,7,0.025714286,55
3145.791748,56,73,0.57,17,0.033529412,55
3145.776152,63,66,0.1,3,0.033333333,55
3145.776152,60,69,0.3,9,0.033333333,55
3145.714179,44,65,0.54,21,0.025714286,55
3145.458634,55,74,0.64,19,0.033684211,55
3144.663364,44,67,0.57,23,0.024782609,55
3144.628872,48,62,0.35,14,0.025,55
3142.370811,50,56,0.16,6,0.026666667,55
3142.06724,59,70,0.37,11,0.033636364,55
3140.632008,47,59,0.31,12,0.025833333,55
3139.998812,52,59,0.23,7,0.032857143,55
3139.915536,40,56,0.58,16,0.03625,55
3138.829165,39,56,0.62,17,0.036470588,55
3138.821111,47,63,0.4,16,0.025,55
3137.802384,44,63,0.49,19,0.025789474,55
3137.705872,38,54,0.54,16,0.03375,55
3137.541604,48,65,0.41,17,0.024117647,55
3137.344991,4,14,0.54,10,0.054,55
3137.094406,53,88,0.97,35,0.027714286,55
3136.210514,44,66,0.56,22,0.025454545,55
3136.130589,46,59,0.35,13,0.026923077,55
3135.332125,39,52,0.5,13,0.038461538,55
3134.343416,38,53,0.51,15,0.034,55
3131.292163,42,67,0.79,25,0.0316,55
3131.181054,37,59,0.81,22,0.036818182,55
3130.737427,41,70,0.87,29,0.03,55
3130.311244,38,58,0.73,20,0.0365,55
3129.426501,36,61,0.87,25,0.0348,55
3127.218494,38,66,0.95,28,0.033928571,55
3126.84367,37,58,0.78,21,0.037142857,55
3124.662999,39,74,0.99,35,0.028285714,55
3124.615543,42,66,0.62,24,0.025833333,55
3124.573059,43,74,0.75,31,0.024193548,55
3124.168704,43,52,0.32,9,0.035555556,55
3123.907512,43,64,0.55,21,0.026190476,55
3122.696416,45,72,0.65,27,0.024074074,55
3122.696416,44,73,0.7,29,0.024137931,55
3121.755311,43,68,0.7,25,0.028,55
3121.515577,44,61,0.46,17,0.027058824,55
3121.011991,41,61,0.69,20,0.0345,55
3120.74933,42,50,0.27,8,0.03375,55
3120.589269,53,88,0.96,35,0.027428571,55
3119.51041,49,58,0.23,9,0.025555556,55
3119.428152,36,57,0.71,21,0.033809524,55
3119.428152,35,58,0.78,23,0.033913043,55
3118.975856,41,77,0.87,36,0.024166667,55
3118.607759,53,87,0.97,34,0.028529412,55
3116.474201,42,53,0.39,11,0.035454545,55
3115.892207,39,49,0.36,10,0.036,55
3115.829677,47,59,0.32,12,0.026666667,55
3114.868276,52,54,0.06,2,0.03,55
3114.868276,51,55,0.12,4,0.03,55
3114.868276,50,56,0.18,6,0.03,55
3114.460875,44,51,0.25,7,0.035714286,55
3114.015103,52,55,0.09,3,0.03,55
3114.015103,51,56,0.15,5,0.03,55
3113.368622,58,70,0.41,12,0.034166667,55
3113.368622,57,71,0.48,14,0.034285714,55
3112.557871,60,70,0.33,10,0.033,55
3112.512421,40,68,0.93,28,0.033214286,55
3112.509417,48,61,0.33,13,0.025384615,55
3112.17498,47,66,0.46,19,0.024210526,55
3111.282236,40,72,0.94,32,0.029375,55
3111.254979,46,65,0.47,19,0.024736842,55
3111.059734,40,70,0.94,30,0.031333333,55
3110.312639,57,73,0.33,16,0.020625,55
3110.220436,45,72,0.64,27,0.023703704,55
3109.050197,50,57,0.21,7,0.03,55
3109.050197,49,58,0.27,9,0.03,55
3108.581612,40,51,0.38,11,0.034545455,55
3108.215772,56,72,0.55,16,0.034375,55
3108.215772,55,73,0.62,18,0.034444444,55
3108.215772,54,74,0.69,20,0.0345,55
3108.215772,53,75,0.76,22,0.034545455,55
3107.906702,49,57,0.24,8,0.03,55
3106.437232,47,67,0.54,20,0.027,55
3106.238851,38,66,0.94,28,0.033571429,55
3105.885926,39,57,0.63,18,0.035,55
3105.731823,38,57,0.7,19,0.036842105,55
3105.504387,54,77,0.76,23,0.033043478,55
3104.973198,42,61,0.62,19,0.032631579,55
3104.397267,48,58,0.3,10,0.03,55
3103.987443,35,57,0.75,22,0.034090909,55
3102.481132,38,58,0.74,20,0.037,55
3101.382703,37,54,0.59,17,0.034705882,55
3100.91701,50,74,0.87,24,0.03625,55
3100.20279,36,53,0.65,17,0.038235294,55
3099.882411,39,49,0.39,10,0.039,55
3099.513833,55,75,0.67,20,0.0335,55
3099.280402,42,66,0.79,24,0.032916667,55
3098.702357,54,70,0.57,16,0.035625,55
3098.232017,36,60,0.88,24,0.036666667,55
3097.89743,56,74,0.37,18,0.020555556,55
3097.661207,36,60,0.89,24,0.037083333,55
3096.887604,49,57,0.21,8,0.02625,55
3096.797114,40,78,0.94,38,0.024736842,55
3096.340587,45,66,0.52,21,0.024761905,55
3095.948432,47,66,0.47,19,0.024736842,55
3095.515407,59,68,0.31,9,0.034444444,55
3095.215018,50,63,0.36,13,0.027692308,55
3095.065217,46,64,0.45,18,0.025,55
3094.350477,60,69,0.31,9,0.034444444,55
3093.943239,40,64,0.78,24,0.0325,55
3093.668102,44,73,0.71,29,0.024482759,55
3093.336049,45,62,0.44,17,0.025882353,55
3093.239535,53,77,0.81,24,0.03375,55
3092.959988,56,67,0.4,11,0.036363636,55
3092.959988,53,71,0.65,18,0.036111111,55
3091.373081,54,87,0.91,33,0.027575758,55
3090.67929,41,67,0.85,26,0.032692308,55
3090.391185,58,69,0.38,11,0.034545455,55
3090.391185,57,70,0.45,13,0.034615385,55
3090.391185,56,71,0.52,15,0.034666667,55
3090.391185,55,72,0.59,17,0.034705882,55
3090.391185,54,73,0.66,19,0.034736842,55
3090.335216,41,62,0.69,21,0.032857143,55
3089.638773,46,63,0.44,17,0.025882353,55
3089.414093,53,61,0.19,8,0.02375,55
3089.153272,41,68,0.87,27,0.032222222,55
3088.763642,42,76,0.83,34,0.024411765,55
3087.934061,45,64,0.49,19,0.025789474,55
3087.859246,54,76,0.75,22,0.034090909,55
3087.362443,46,63,0.43,17,0.025294118,55
3086.101393,47,62,0.38,15,0.025333333,55
3085.967921,41,76,0.85,35,0.024285714,55
3085.728946,45,65,0.5,20,0.025,55
3085.728946,44,66,0.55,22,0.025,55
3085.49523,41,73,0.87,32,0.0271875,55
3084.90918,67,75,0.17,8,0.02125,55
3083.780211,37,55,0.61,18,0.033888889,55
3083.494257,41,67,0.68,26,0.026153846,55
3083.288324,41,72,0.87,31,0.028064516,55
3083.13156,38,51,0.46,13,0.035384615,55
3082.351851,53,77,0.82,24,0.034166667,55
3082.351851,52,78,0.89,26,0.034230769,55
3082.343879,52,76,0.83,24,0.034583333,55
3081.291934,49,63,0.34,14,0.024285714,55
3080.532457,4,14,0.58,10,0.058,55
3080.115489,46,62,0.42,16,0.02625,55
3079.822692,49,52,0.1,3,0.033333333,55
3079.355633,39,65,0.85,26,0.032692308,55
3079.06749,41,49,0.28,8,0.035,55
3078.971573,40,50,0.35,10,0.035,55
3078.839116,44,65,0.62,21,0.02952381,55
3078.598511,43,67,0.6,24,0.025,55
3078.59274,46,53,0.25,7,0.035714286,55
3078.513744,42,63,0.57,21,0.027142857,55
3077.996661,54,75,0.71,21,0.033809524,55
3077.826072,44,50,0.22,6,0.036666667,55
3077.607427,49,59,0.29,10,0.029,55
3076.885421,35,54,0.73,19,0.038421053,55
3076.875292,53,92,0.99,39,0.025384615,55
3076.59932,43,59,0.53,16,0.033125,55
3075.809757,48,59,0.29,11,0.026363636,55
3075.142924,47,65,0.45,18,0.025,55
3074.382795,47,61,0.42,14,0.03,55
3073.948963,38,54,0.55,16,0.034375,55
3073.876845,49,65,0.44,16,0.0275,55
3073.876845,47,67,0.55,20,0.0275,55
3073.341728,48,66,0.45,18,0.025,55
3073.308879,57,66,0.33,9,0.036666667,55
3073.308879,54,69,0.55,15,0.036666667,55
3073.226233,43,68,0.71,25,0.0284,55
3072.759059,48,65,0.47,17,0.027647059,55
3072.370345,53,76,0.78,23,0.033913043,55
3072.370345,52,77,0.85,25,0.034,55
3071.912839,4,14,0.55,10,0.055,55
3070.507547,42,60,0.61,18,0.033888889,55
3070.32203,43,73,0.81,30,0.027,55
3070.311318,47,66,0.53,19,0.027894737,55
3070.151234,62,64,0.07,2,0.035,55
3070.151234,61,65,0.14,4,0.035,55
3070.151234,60,66,0.21,6,0.035,55
3070.151234,59,67,0.28,8,0.035,55
3070.151234,58,68,0.35,10,0.035,55
3068.660433,57,72,0.51,15,0.034,55
3068.496773,46,69,0.63,23,0.027391304,55
3068.070991,56,88,0.82,32,0.025625,55
3067.853026,56,85,0.8,29,0.027586207,55
3067.796649,54,87,0.92,33,0.027878788,55
3067.475337,40,63,0.78,23,0.033913043,55
3067.227732,45,57,0.33,12,0.0275,55
3067.203577,62,67,0.17,5,0.034,55
3067.149228,40,69,0.95,29,0.032758621,55
3066.618736,38,53,0.52,15,0.034666667,55
3066.446185,52,77,0.86,25,0.0344,55
3066.049831,53,79,0.79,26,0.030384615,55
3065.936305,52,61,0.25,9,0.027777778,55
3065.860285,46,69,0.62,23,0.026956522,55
3064.322224,42,71,0.71,29,0.024482759,55
3063.920372,39,65,0.86,26,0.033076923,55
3063.920372,38,66,0.93,28,0.033214286,55
3063.915439,55,68,0.47,13,0.036153846,55
3063.915439,52,72,0.72,20,0.036,55
3063.915439,51,73,0.79,22,0.035909091,55
3063.717619,62,68,0.2,6,0.033333333,55
3063.717619,59,71,0.4,12,0.033333333,55
3063.693198,47,60,0.34,13,0.026153846,55
3062.501481,46,67,0.51,21,0.024285714,55
3062.335228,35,62,0.96,27,0.035555556,55
3061.831342,40,55,0.55,15,0.036666667,55
3061.431634,55,86,0.85,31,0.027419355,55
3060.620813,41,52,0.37,11,0.033636364,55
3059.943508,41,70,0.81,29,0.027931034,55
3059.840226,45,62,0.5,17,0.029411765,55
3059.287809,61,68,0.24,7,0.034285714,55
3059.218398,52,78,0.88,26,0.033846154,55
3059.119066,59,64,0.18,5,0.036,55
3057.805158,54,76,0.74,22,0.033636364,55
3057.535444,49,56,0.18,7,0.025714286,55
3057.281489,45,70,0.68,25,0.0272,55
3057.281489,44,71,0.74,27,0.027407407,55
3056.142836,44,63,0.5,19,0.026315789,55
3056.124482,51,73,0.8,22,0.036363636,55
3055.874308,48,66,0.44,18,0.024444444,55
3055.575538,40,74,0.93,34,0.027352941,55
3054.425468,40,63,0.76,23,0.033043478,55
3054.251057,41,48,0.27,7,0.038571429,55
3053.467206,46,61,0.45,15,0.03,55
3053.118942,53,55,0.05,2,0.025,55
3052.118664,45,58,0.36,13,0.027692308,55
3052.079731,40,48,0.31,8,0.03875,55
3051.924692,45,62,0.45,17,0.026470588,55
3051.038429,59,83,0.64,24,0.026666667,55
3050.791163,49,76,0.98,27,0.036296296,55
3050.222176,49,75,0.96,26,0.036923077,55
3050.203614,38,67,0.94,29,0.032413793,55
3050.176382,47,67,0.5,20,0.025,55
3049.843646,41,71,0.85,30,0.028333333,55
3049.829595,47,60,0.38,13,0.029230769,55
3049.829595,46,61,0.44,15,0.029333333,55
3049.494015,58,65,0.25,7,0.035714286,55
3049.428223,43,47,0.15,4,0.0375,55
3049.247777,8,10,0.1,2,0.05,55
3048.733032,42,72,0.81,30,0.027,55
3048.553161,41,67,0.86,26,0.033076923,55
3048.298369,41,59,0.63,18,0.035,55
3047.336471,41,58,0.6,17,0.035294118,55
3047.15569,53,89,0.99,36,0.0275,55
3046.825147,54,72,0.63,18,0.035,55
3046.136603,46,68,0.61,22,0.027727273,55
3045.753633,50,55,0.13,5,0.026,55
3045.524561,41,72,0.78,31,0.02516129,55
3045.433926,53,89,0.98,36,0.027222222,55
3045.233037,54,59,0.14,5,0.028,55
3044.892427,40,74,0.94,34,0.027647059,55
3044.87681,44,70,0.81,26,0.031153846,55
3044.86941,46,65,0.48,19,0.025263158,55
3044.27766,55,74,0.65,19,0.034210526,55
3044.27766,54,75,0.72,21,0.034285714,55
3044.27766,53,76,0.79,23,0.034347826,55
3043.561135,47,56,0.3,9,0.033333333,55
3042.917136,46,61,0.39,15,0.026,55
3042.876901,57,87,0.76,30,0.025333333,55
3042.876901,56,88,0.81,32,0.0253125,55
3042.876901,55,89,0.86,34,0.025294118,55
3042.876901,55,89,0.87,34,0.025588235,55
3042.876901,55,90,0.88,35,0.025142857,55
3042.876901,54,90,0.92,36,0.025555556,55
3042.876901,54,91,0.93,37,0.025135135,55
3042.876901,53,92,0.98,39,0.025128205,55
3042.494631,40,72,0.95,32,0.0296875,55
3042.446074,35,57,0.76,22,0.034545455,55
3042.345935,56,73,0.58,17,0.034117647,55
3042.299869,39,60,0.76,21,0.036190476,55
3042.001823,58,85,0.7,27,0.025925926,55
3041.765954,38,63,0.87,25,0.0348,55
3041.267923,44,66,0.63,22,0.028636364,55
3040.995492,59,71,0.41,12,0.034166667,55
3040.35833,60,70,0.34,10,0.034,55
3039.450977,40,63,0.77,23,0.033478261,55
3038.872926,53,78,0.83,25,0.0332,55
3038.736165,40,71,0.93,31,0.03,55
3038.552228,44,55,0.39,11,0.035454545,55
3038.377285,5,13,0.41,8,0.05125,55
3038.233855,45,57,0.41,12,0.034166667,55
3038.120124,42,68,0.74,26,0.028461538,55
3037.889792,42,73,0.95,31,0.030645161,55
3037.730638,42,76,0.82,34,0.024117647,55
3037.715453,50,53,0.1,3,0.033333333,55
3036.700077,52,72,0.73,20,0.0365,55
3036.654542,65,66,0.02,1,0.02,55
3036.654542,64,67,0.06,3,0.02,55
3036.654542,63,68,0.1,5,0.02,55
3036.654542,62,69,0.14,7,0.02,55
3036.247097,43,59,0.54,16,0.03375,55
3035.869197,44,72,0.75,28,0.026785714,55
3035.56906,58,72,0.48,14,0.034285714,55
3034.8934,41,62,0.7,21,0.033333333,55
3034.462411,58,71,0.44,13,0.033846154,55
3034.423427,51,79,0.95,28,0.033928571,55
3034.276383,41,78,0.87,37,0.023513514,55
3034.166822,60,83,0.59,23,0.025652174,55
3034.163698,44,58,0.48,14,0.034285714,55
3034.156153,47,60,0.39,13,0.03,55
3034.061133,55,86,0.86,31,0.027741935,55
3033.89899,42,45,0.11,3,0.036666667,55
3033.885941,50,74,0.88,24,0.036666667,55
3033.744431,45,58,0.35,13,0.026923077,55
3033.435982,54,77,0.47,23,0.020434783,55
3033.398198,48,60,0.35,12,0.029166667,55
3033.398198,47,61,0.41,14,0.029285714,55
3032.730183,49,66,0.42,17,0.024705882,55
3032.730183,48,67,0.47,19,0.024736842,55
3032.576024,56,85,0.79,29,0.027241379,55
3031.644527,42,63,0.69,21,0.032857143,55
3031.603673,45,69,0.66,24,0.0275,55
3030.907742,40,48,0.29,8,0.03625,55
3030.871424,46,67,0.53,21,0.025238095,55
3030.853697,56,87,0.81,31,0.026129032,55
3030.853697,55,89,0.88,34,0.025882353,55
3030.853697,54,90,0.93,36,0.025833333,55
3030.72934,36,53,0.66,17,0.038823529,55
3030.607071,53,91,0.99,38,0.026052632,55
3030.587239,60,82,0.58,22,0.026363636,55
3030.587239,58,84,0.69,26,0.026538462,55
3030.587239,57,86,0.76,29,0.026206897,55
3030.340633,57,85,0.75,28,0.026785714,55
3030.340633,55,88,0.87,33,0.026363636,55
3029.845884,47,66,0.6,19,0.031578947,55
3029.398758,46,54,0.27,8,0.03375,55
3029.256751,55,71,0.56,16,0.035,55
3028.940855,39,61,0.78,22,0.035454545,55
3028.876546,50,64,0.38,14,0.027142857,55
3028.876546,48,66,0.49,18,0.027222222,55
3028.289696,49,64,0.42,15,0.028,55
3028.074313,34,55,0.82,21,0.039047619,55
3026.662595,41,72,0.76,31,0.024516129,55
3026.550658,40,78,0.92,38,0.024210526,55
3026.532763,63,69,0.17,6,0.028333333,55
3026.44589,55,87,0.87,32,0.0271875,55
3025.495397,41,70,0.82,29,0.028275862,55
3025.174598,39,63,0.83,24,0.034583333,55
3025.121727,44,64,0.52,20,0.026,55
3024.994158,44,65,0.69,21,0.032857143,55
3024.584468,49,76,0.97,27,0.035925926,55
3024.466503,61,70,0.18,9,0.02,55
3024.03923,43,73,0.71,30,0.023666667,55
3023.928272,39,62,0.8,23,0.034782609,55
3023.189635,40,68,0.92,28,0.032857143,55
3022.952707,50,54,0.11,4,0.0275,55
3022.952707,48,56,0.22,8,0.0275,55
3022.553467,45,65,0.57,20,0.0285,55
3022.499355,43,61,0.49,18,0.027222222,55
3022.161798,44,64,0.51,20,0.0255,55
3021.683235,45,54,0.32,9,0.035555556,55
3021.505123,49,53,0.11,4,0.0275,55
3021.505123,47,55,0.22,8,0.0275,55
3021.077261,40,73,0.83,33,0.025151515,55
3020.002231,52,80,0.85,28,0.030357143,55
3019.534197,39,52,0.45,13,0.034615385,55
3018.895757,53,89,0.97,36,0.026944444,55
3018.708167,44,54,0.36,10,0.036,55
3018.269735,40,72,0.81,32,0.0253125,55
3017.901795,53,80,0.76,27,0.028148148,55
3017.524998,38,62,0.86,24,0.035833333,55
3016.704119,51,63,0.27,12,0.0225,55
3016.48129,40,59,0.68,19,0.035789474,55
3016.440491,5,13,0.45,8,0.05625,55
3016.419976,5,12,0.41,7,0.058571429,55
3016.000943,50,83,0.66,33,0.02,55
3015.620766,36,54,0.63,18,0.035,55
3015.365458,39,66,0.9,27,0.033333333,55
3015.286691,57,84,0.74,27,0.027407407,55
3014.968963,33,57,0.93,24,0.03875,55
3014.784878,42,58,0.56,16,0.035,55
3014.478054,40,69,0.92,29,0.031724138,55
3014.478054,39,70,0.99,31,0.031935484,55
3014.239592,53,78,0.84,25,0.0336,55
3014.160664,38,62,0.85,24,0.035416667,55
3013.543985,42,57,0.53,15,0.035333333,55
3013.13209,41,58,0.61,17,0.035882353,55
3013.106385,43,65,0.64,22,0.029090909,55
3012.737757,54,57,0.1,3,0.033333333,55
3012.737757,51,60,0.3,9,0.033333333,55
3012.599396,43,72,0.89,29,0.030689655,55
3012.538449,45,63,0.46,18,0.025555556,55
3012.033083,35,54,0.74,19,0.038947368,55
3012.031091,39,51,0.45,12,0.0375,55
3011.650213,38,67,0.95,29,0.032758621,55
3011.445606,52,79,0.91,27,0.033703704,55
3011.370309,33,60,0.92,27,0.034074074,55
3011.36061,40,71,0.87,31,0.028064516,55
3010.927826,38,68,0.96,30,0.032,55
3010.918593,40,60,0.7,20,0.035,55
3010.310956,42,71,0.72,29,0.024827586,55
3010.226902,42,74,0.8,32,0.025,55
3010.183816,33,59,0.9,26,0.034615385,55
3009.88349,46,68,0.6,22,0.027272727,55
3009.772742,44,58,0.46,14,0.032857143,55
3009.588945,41,76,0.87,35,0.024857143,55
3009.573983,61,69,0.27,8,0.03375,55
3009.100921,47,62,0.43,15,0.028666667,55
3009.100921,46,63,0.49,17,0.028823529,55
3009.100921,45,64,0.55,19,0.028947368,55
3008.839864,42,66,0.63,24,0.02625,55
3008.642638,37,54,0.58,17,0.034117647,55
3008.376643,57,86,0.75,29,0.025862069,55
3008.328495,45,66,0.53,21,0.025238095,55
3007.728661,46,67,0.52,21,0.024761905,55
3007.68669,43,69,0.65,26,0.025,55
3007.524418,51,79,0.86,28,0.030714286,55
3007.378067,46,63,0.5,17,0.029411765,55
3007.378067,45,64,0.56,19,0.029473684,55
3007.270166,48,64,0.52,16,0.0325,55
3007.262515,58,83,0.68,25,0.0272,55
3007.250541,54,88,0.93,34,0.027352941,55
3007.239952,42,57,0.54,15,0.036,55
3007.1801,40,72,0.89,32,0.0278125,55
3007.083263,50,62,0.39,12,0.0325,55
3006.94272,52,79,0.92,27,0.034074074,55
3006.903339,60,71,0.36,11,0.032727273,55
3006.903339,58,73,0.49,15,0.032666667,55
3006.856164,57,73,0.54,16,0.03375,55
3006.804861,37,63,0.93,26,0.035769231,55
3006.582043,42,69,0.76,27,0.028148148,55
3006.569844,54,88,0.91,34,0.026764706,55
3006.510065,57,68,0.39,11,0.035454545,55
3006.456196,55,75,0.68,20,0.034,55
3006.456196,51,80,0.98,29,0.033793103,55
3005.213705,43,65,0.57,22,0.025909091,55
3004.91265,42,52,0.37,10,0.037,55
3004.247187,53,91,0.98,38,0.025789474,55
3004.079569,55,77,0.44,22,0.02,55
3004.068803,56,74,0.61,18,0.033888889,55
3003.822094,57,74,0.56,17,0.032941176,55
3003.63976,8,12,0.16,4,0.04,55
3003.544726,48,64,0.39,16,0.024375,55
3003.041889,55,76,0.64,21,0.03047619,55
3002.074356,40,49,0.32,9,0.035555556,55
3001.402768,33,57,0.91,24,0.037916667,55
3001.144268,40,61,0.73,21,0.034761905,55
3000.518072,38,55,0.57,17,0.033529412,55
3000.1656,41,59,0.64,18,0.035555556,55
3000.054009,57,73,0.49,16,0.030625,55
2999.738818,60,72,0.34,12,0.028333333,55
2999.520326,42,60,0.6,18,0.033333333,55
2999.39252,33,61,0.93,28,0.033214286,55
2999.324749,43,67,0.68,24,0.028333333,55
2998.925385,55,88,0.88,33,0.026666667,55
2998.749804,53,70,0.63,17,0.037058824,55
2998.563199,6,11,0.29,5,0.058,55
2997.891937,40,50,0.4,10,0.04,55
2997.636821,58,72,0.47,14,0.033571429,55
2997.47189,40,70,0.86,30,0.028666667,55
2997.408038,44,56,0.42,12,0.035,55
2996.887502,42,69,0.77,27,0.028518519,55
2996.733646,40,53,0.44,13,0.033846154,55
2996.466847,54,77,0.7,23,0.030434783,55
2996.358208,45,61,0.41,16,0.025625,55
2995.949254,40,78,0.95,38,0.025,55
2995.266004,50,61,0.37,11,0.033636364,55
2994.987163,54,88,0.92,34,0.027058824,55
2994.552362,42,62,0.55,20,0.0275,55
2994.490897,54,90,0.94,36,0.026111111,55
2994.227534,56,87,0.82,31,0.026451613,55
2994.227534,54,89,0.93,35,0.026571429,55
2994.224158,41,71,0.86,30,0.028666667,55
2994.198581,43,49,0.22,6,0.036666667,55
2994.195533,43,56,0.46,13,0.035384615,55
2994.1234,41,68,0.7,27,0.025925926,55
2993.902204,41,57,0.58,16,0.03625,55
2993.422884,51,73,0.81,22,0.036818182,55
2993.268668,44,57,0.45,13,0.034615385,55
2992.771665,46,69,0.57,23,0.024782609,55
2992.68447,46,70,0.6,24,0.025,55
2992.68447,45,71,0.65,26,0.025,55
2992.201048,48,60,0.36,12,0.03,55
2992.052814,46,57,0.37,11,0.033636364,55
2992.049423,44,70,0.72,26,0.027692308,55
2991.862262,7,15,0.27,8,0.03375,55
2991.596833,45,62,0.51,17,0.03,55
2991.243145,42,74,0.81,32,0.0253125,55
2990.994313,37,48,0.44,11,0.04,55
2990.882986,41,75,0.94,34,0.027647059,55
2989.931724,45,68,0.73,23,0.03173913,55
2989.781387,40,62,0.76,22,0.034545455,55
2989.636618,57,75,0.51,18,0.028333333,55
2989.611101,49,57,0.25,8,0.03125,55
2989.233269,47,61,0.35,14,0.025,55
2989.100196,40,73,0.91,33,0.027575758,55
2989.071836,42,67,0.64,25,0.0256,55
2988.861138,40,78,0.93,38,0.024473684,55
2988.597895,43,62,0.62,19,0.032631579,55
2988.498301,43,67,0.7,24,0.029166667,55
2988.317462,41,72,0.77,31,0.02483871,55
2988.306002,38,55,0.56,17,0.032941176,55
2987.756267,43,61,0.48,18,0.026666667,55
2987.49705,40,73,0.9,33,0.027272727,55
2987.443198,41,71,0.76,30,0.025333333,55
2987.097105,41,77,0.89,36,0.024722222,55
2987.096628,44,72,0.67,28,0.023928571,55
2987.096628,43,73,0.72,30,0.024,55
2986.807554,46,70,0.53,24,0.022083333,55
2986.712972,52,62,0.24,10,0.024,55
2986.336422,46,68,0.54,22,0.024545455,55
2986.102633,42,69,0.69,27,0.025555556,55
2986.026639,40,60,0.71,20,0.0355,55
2985.91624,45,71,0.69,26,0.026538462,55
2985.666185,5,13,0.44,8,0.055,55
2985.469196,42,47,0.19,5,0.038,55
2985.431375,44,70,0.64,26,0.024615385,55
2985.197091,44,65,0.6,21,0.028571429,55
2984.66052,55,88,0.86,33,0.026060606,55
2984.350458,46,57,0.36,11,0.032727273,55
2984.175373,46,56,0.34,10,0.034,55
2984.155027,56,86,0.8,30,0.026666667,55
2983.633304,38,65,0.92,27,0.034074074,55
2983.554122,50,58,0.2,8,0.025,55
2983.554122,49,59,0.25,10,0.025,55
2983.507011,47,68,0.52,21,0.024761905,55
2983.477188,37,51,0.54,14,0.038571429,55
2983.477188,36,52,0.62,16,0.03875,55
2982.917311,45,63,0.47,18,0.026111111,55
2982.750321,43,55,0.43,12,0.035833333,55
2982.533693,37,66,0.99,29,0.034137931,55
2982.42054,37,64,0.95,27,0.035185185,55
2982.417705,56,86,0.81,30,0.027,55
2982.299521,39,65,0.88,26,0.033846154,55
2982.029779,53,78,0.51,25,0.0204,55
2981.743655,43,62,0.52,19,0.027368421,55
2981.706156,38,52,0.49,14,0.035,55
2981.351212,33,57,0.92,24,0.038333333,55
2980.448881,42,59,0.59,17,0.034705882,55
2980.117786,43,57,0.49,14,0.035,55
2979.867011,56,76,0.65,20,0.0325,55
2979.374313,41,73,0.88,32,0.0275,55
2979.363359,40,73,0.94,33,0.028484848,55
2978.872389,41,68,0.78,27,0.028888889,55
2978.834508,42,70,0.68,28,0.024285714,55
2978.752074,42,69,0.78,27,0.028888889,55
2978.642173,45,64,0.57,19,0.03,55
2978.638197,38,52,0.53,14,0.037857143,55
2978.533093,50,83,0.99,33,0.03,55
2978.47344,42,70,0.71,28,0.025357143,55
2978.270334,47,66,0.61,19,0.032105263,55
2978.203317,37,55,0.62,18,0.034444444,55
2978.053477,55,91,0.9,36,0.025,55
2978.047266,48,59,0.33,11,0.03,55
2978.003816,41,76,0.86,35,0.024571429,55
2976.990592,47,68,0.51,21,0.024285714,55
2976.877629,40,72,0.9,32,0.028125,55
2976.83156,37,51,0.51,14,0.036428571,55
2976.661319,47,58,0.3,11,0.027272727,55
2976.391719,44,61,0.55,17,0.032352941,55
2976.280838,44,59,0.49,15,0.032666667,55
2976.066403,45,68,0.64,23,0.027826087,55
2974.829861,38,55,0.55,17,0.032352941,55
2974.286667,37,66,0.98,29,0.033793103,55
2973.989253,59,73,0.4,14,0.028571429,55
2973.500108,60,71,0.22,11,0.02,55
2973.482058,53,86,0.95,33,0.028787879,55
2973.445925,59,80,0.6,21,0.028571429,55
2973.407995,53,56,0.07,3,0.023333333,55
2973.190974,43,74,0.77,31,0.02483871,55
2973.104815,45,60,0.41,15,0.027333333,55
2973.01075,51,54,0.1,3,0.033333333,55
2973.01075,48,57,0.3,9,0.033333333,55
2972.677188,49,56,0.23,7,0.032857143,55
2972.62463,46,62,0.48,16,0.03,55
2972.623771,39,64,0.85,25,0.034,55
2972.617993,54,91,0.94,37,0.025405405,55
2972.599349,41,49,0.32,8,0.04,55
2972.364325,46,70,0.59,24,0.024583333,55
2972.342085,39,61,0.79,22,0.035909091,55
2971.894006,41,71,0.83,30,0.027666667,55
2971.795542,34,56,0.84,22,0.038181818,55
2971.659141,42,70,0.7,28,0.025,55
2971.483751,49,58,0.24,9,0.026666667,55
2971.394299,54,92,0.95,38,0.025,55
2971.297829,39,53,0.53,14,0.037857143,55
2971.230545,36,63,0.92,27,0.034074074,55
2970.89973,41,71,0.75,30,0.025,55
2970.897526,60,80,0.56,20,0.028,55
2970.668833,45,61,0.52,16,0.0325,55
2970.664476,49,56,0.19,7,0.027142857,55
2970.588739,52,55,0.08,3,0.026666667,55
2970.247697,4,14,0.57,10,0.057,55
2970.12569,43,68,0.63,25,0.0252,55
2970.101253,48,60,0.3,12,0.025,55
2970.042297,43,56,0.47,13,0.036153846,55
2969.668421,8,12,0.17,4,0.0425,55
2969.43112,44,66,0.62,22,0.028181818,55
2969.18586,43,75,0.77,32,0.0240625,55
2969.074592,42,61,0.64,19,0.033684211,55
2968.497125,40,52,0.45,12,0.0375,55
2968.474953,41,69,0.8,28,0.028571429,55
2968.473064,39,67,0.75,28,0.026785714,55
2968.28239,39,74,0.96,35,0.027428571,55
2968.152057,41,69,0.89,28,0.031785714,55
2967.974522,42,61,0.63,19,0.033157895,55
2967.95461,34,56,0.85,22,0.038636364,55
2967.883215,39,51,0.48,12,0.04,55
2967.788051,41,59,0.6,18,0.033333333,55
2967.063324,43,69,0.62,26,0.023846154,55
2966.990753,54,89,0.91,35,0.026,55
2966.893534,40,71,0.99,31,0.031935484,55
2966.853039,45,69,0.75,24,0.03125,55
2966.847189,47,63,0.43,16,0.026875,55
2966.349653,41,71,0.84,30,0.028,55
2965.56307,41,51,0.33,10,0.033,55
2965.436139,42,72,0.95,30,0.031666667,55
2965.41924,38,60,0.76,22,0.034545455,55
2965.383725,54,89,0.94,35,0.026857143,55
2965.10147,52,75,0.8,23,0.034782609,55
2965.067085,38,68,0.97,30,0.032333333,55
2965.066252,44,68,0.57,24,0.02375,55
2965.059845,34,57,0.81,23,0.035217391,55
2964.92581,47,60,0.4,13,0.030769231,55
2964.575952,41,70,0.73,29,0.025172414,55
2964.530042,42,69,0.68,27,0.025185185,55
2964.273536,39,72,0.99,33,0.03,55
2963.887738,41,61,0.68,20,0.034,55
2963.130576,37,53,0.56,16,0.035,55
2962.882325,56,89,0.84,33,0.025454545,55
2962.593644,41,78,0.88,37,0.023783784,55
2962.235821,39,73,0.96,34,0.028235294,55
2961.42187,38,65,0.93,27,0.034444444,55
2961.294407,54,79,0.7,25,0.028,55
2960.529149,54,89,0.95,35,0.027142857,55
2960.366522,57,72,0.46,15,0.030666667,55
2960.097397,56,69,0.46,13,0.035384615,55
2960.097397,55,70,0.53,15,0.035333333,55
2959.980025,50,61,0.27,11,0.024545455,55
2959.68146,44,59,0.5,15,0.033333333,55
2959.59157,45,70,0.67,25,0.0268,55
2959.520019,63,85,0.6,22,0.027272727,55
2959.46319,41,65,0.77,24,0.032083333,55
2959.436326,45,55,0.34,10,0.034,55
2959.350668,42,49,0.26,7,0.037142857,55
2959.342802,53,91,0.97,38,0.025526316,55
2959.323695,51,57,0.14,6,0.023333333,55
2959.273557,47,61,0.46,14,0.032857143,55
2959.237069,41,62,0.71,21,0.033809524,55
2958.801149,58,71,0.27,13,0.020769231,55
2958.719725,52,56,0.1,4,0.025,55
2958.363026,57,75,0.53,18,0.029444444,55
2958.363026,56,76,0.59,20,0.0295,55
2958.363026,55,77,0.65,22,0.029545455,55
2958.363026,54,78,0.71,24,0.029583333,55
2958.256831,33,58,0.95,25,0.038,55
2958.24768,40,64,0.79,24,0.032916667,55
2958.096649,43,49,0.2,6,0.033333333,55
2957.982387,41,70,0.91,29,0.03137931,55
2957.62792,41,64,0.63,23,0.027391304,55
2957.598067,43,75,0.78,32,0.024375,55
2957.500463,45,69,0.59,24,0.024583333,55
2957.473632,57,87,0.77,30,0.025666667,55
2957.447986,37,57,0.67,20,0.0335,55
2957.126507,55,77,0.72,22,0.032727273,55
2957.063485,45,70,0.62,25,0.0248,55
2956.808951,42,60,0.62,18,0.034444444,55
2956.763363,43,60,0.56,17,0.032941176,55
2956.635937,44,67,0.59,23,0.025652174,55
2956.465521,44,63,0.58,19,0.030526316,55
2956.338104,45,68,0.59,23,0.025652174,55
2955.86553,43,66,0.66,23,0.028695652,55
2955.86553,42,67,0.72,25,0.0288,55
2955.770869,57,67,0.36,10,0.036,55
2955.766702,37,64,0.96,27,0.035555556,55
2955.60979,42,59,0.58,17,0.034117647,55
2955.568482,40,68,0.95,28,0.033928571,55
2955.40383,41,63,0.73,22,0.033181818,55
2955.364987,45,53,0.29,8,0.03625,55
2955.247031,40,71,0.97,31,0.031290323,55
2955.224977,46,68,0.51,22,0.023181818,55
2955.001414,46,60,0.46,14,0.032857143,55
2954.626233,53,78,0.76,25,0.0304,55
2954.556443,7,10,0.17,3,0.056666667,55
2954.456756,47,68,0.48,21,0.022857143,55
2953.974365,41,60,0.66,19,0.034736842,55
2953.86628,59,81,0.5,22,0.022727273,55
2953.431953,42,75,0.82,33,0.024848485,55
2953.280955,48,54,0.2,6,0.033333333,55
2953.266379,59,90,0.83,31,0.026774194,55
2953.150096,40,75,0.96,35,0.027428571,55
2952.964966,62,86,0.65,24,0.027083333,55
2952.866124,35,55,0.76,20,0.038,55
2952.731775,41,70,0.74,29,0.025517241,55
2952.699385,38,66,0.92,28,0.032857143,55
2952.592325,35,59,0.8,24,0.033333333,55
2952.439445,43,71,0.88,28,0.031428571,55
2951.84865,43,67,0.69,24,0.02875,55
2951.765057,60,83,0.6,23,0.026086957,55
2951.75297,44,46,0.08,2,0.04,55
2951.75297,43,47,0.16,4,0.04,55
2951.75297,42,48,0.24,6,0.04,55
2951.661425,33,58,0.94,25,0.0376,55
2951.517717,34,55,0.81,21,0.038571429,55
2951.341296,36,54,0.68,18,0.037777778,55
2950.996738,42,56,0.51,14,0.036428571,55
2950.981299,39,67,0.9,28,0.032142857,55
2950.886093,63,75,0.35,12,0.029166667,55
2950.886093,58,81,0.66,23,0.028695652,55
2950.886093,57,82,0.72,25,0.0288,55
2950.878566,53,79,0.74,26,0.028461538,55
2950.568484,48,62,0.36,14,0.025714286,55
2948.937774,42,62,0.65,20,0.0325,55
2948.844241,55,85,0.85,30,0.028333333,55
2948.709181,42,49,0.27,7,0.038571429,55
2948.660852,54,86,0.91,32,0.0284375,55
2948.528357,43,72,0.81,29,0.027931034,55
2948.33613,44,73,0.72,29,0.024827586,55
2948.227015,38,69,0.81,31,0.026129032,55
2948.178106,51,72,0.77,21,0.036666667,55
2948.016232,54,78,0.68,24,0.028333333,55
2947.876059,51,76,0.87,25,0.0348,55
2947.639161,54,89,0.92,35,0.026285714,55
2947.639161,53,90,0.97,37,0.026216216,55
2947.139734,55,87,0.86,32,0.026875,55
2947.139734,53,90,0.98,37,0.026486486,55
2947.045267,42,74,0.97,32,0.0303125,55
2947.042823,40,66,0.84,26,0.032307692,55
2946.618859,40,52,0.4,12,0.033333333,55
2946.538807,47,59,0.39,12,0.0325,55
2946.497741,37,63,0.87,26,0.033461538,55
2946.491195,43,58,0.52,15,0.034666667,55
2946.469448,42,58,0.53,16,0.033125,55
2946.316148,45,55,0.35,10,0.035,55
2946.199866,42,58,0.57,16,0.035625,55
2946.052539,45,58,0.43,13,0.033076923,55
2946.051264,64,75,0.25,11,0.022727273,55
2945.515561,54,78,0.48,24,0.02,55
2945.426355,39,67,0.91,28,0.0325,55
2945.315486,45,60,0.39,15,0.026,55
2945.28218,59,81,0.62,22,0.028181818,55
2945.112661,56,89,0.83,33,0.025151515,55
2944.820498,45,56,0.37,11,0.033636364,55
2944.749267,40,65,0.82,25,0.0328,55
2944.2976,36,64,0.96,28,0.034285714,55
2944.125728,44,72,0.76,28,0.027142857,55
2943.928217,36,63,0.93,27,0.034444444,55
2943.839313,48,55,0.23,7,0.032857143,55
2943.640716,39,65,0.87,26,0.033461538,55
2943.551416,42,75,0.79,33,0.023939394,55
2943.411594,46,64,0.46,18,0.025555556,55
2943.186704,40,67,0.7,27,0.025925926,55
2942.900108,54,71,0.6,17,0.035294118,55
2942.900108,53,72,0.67,19,0.035263158,55
2942.900108,53,73,0.7,20,0.035,55
2942.78575,41,78,0.86,37,0.023243243,55
2942.050299,63,85,0.59,22,0.026818182,55
2941.749992,70,77,0.19,7,0.027142857,55
2941.687476,42,68,0.75,26,0.028846154,55
2941.58099,40,68,0.94,28,0.033571429,55
2941.543457,37,56,0.71,19,0.037368421,55
2941.466289,40,79,0.95,39,0.024358974,55
2941.354922,40,71,0.98,31,0.031612903,55
2941.293014,42,64,0.71,22,0.032272727,55
2940.381541,38,65,0.91,27,0.033703704,55
2940.272541,44,72,0.71,28,0.025357143,55
2939.932338,48,64,0.41,16,0.025625,55
2939.87948,60,71,0.32,11,0.029090909,55
2939.735347,58,86,0.71,28,0.025357143,55
2939.718044,58,74,0.52,16,0.0325,55
2939.687921,39,66,0.87,27,0.032222222,55
2939.60018,40,75,0.87,35,0.024857143,55
2939.31047,58,73,0.45,15,0.03,55
2939.31047,57,74,0.51,17,0.03,55
2938.912412,40,74,0.92,34,0.027058824,55
2938.760232,46,62,0.53,16,0.033125,55
2938.751874,58,74,0.45,16,0.028125,55
2938.385897,40,62,0.75,22,0.034090909,55
2938.217137,43,73,0.73,30,0.024333333,55
2938.179323,38,64,0.9,26,0.034615385,55
2938.135261,45,69,0.65,24,0.027083333,55
2938.130231,45,63,0.54,18,0.03,55
2938.12699,44,56,0.41,12,0.034166667,55
2938.12699,43,57,0.48,14,0.034285714,55
2938.12699,42,58,0.55,16,0.034375,55
2938.089814,48,67,0.43,19,0.022631579,55
2937.846516,40,77,0.98,37,0.026486486,55
2937.666397,65,66,0.03,1,0.03,55
2937.666397,64,67,0.09,3,0.03,55
2937.666397,63,68,0.15,5,0.03,55
2937.666397,62,69,0.21,7,0.03,55
2937.666397,61,70,0.27,9,0.03,55
2937.666397,60,71,0.33,11,0.03,55
2937.666397,59,72,0.39,13,0.03,55
2937.422026,36,55,0.71,19,0.037368421,55
2937.27084,49,76,0.99,27,0.036666667,55
2937.186145,61,79,0.5,18,0.027777778,55
2937.162228,38,59,0.72,21,0.034285714,55
2936.994972,45,71,0.66,26,0.025384615,55
2936.747553,42,68,0.82,26,0.031538462,55
2936.664791,61,81,0.53,20,0.0265,55
2936.576228,45,56,0.38,11,0.034545455,55
2936.293342,49,57,0.26,8,0.0325,55
2936.256104,51,82,0.91,31,0.029354839,55
2935.949074,36,54,0.64,18,0.035555556,55
2935.910224,40,64,0.8,24,0.033333333,55
2935.885768,38,64,0.85,26,0.032692308,55
2935.635302,45,61,0.43,16,0.026875,55
2935.337099,43,48,0.17,5,0.034,55
2935.333777,55,77,0.66,22,0.03,55
2935.333777,54,78,0.72,24,0.03,55
2935.333777,53,79,0.78,26,0.03,55
2935.256894,57,75,0.59,18,0.032777778,55
2935.239753,34,58,0.83,24,0.034583333,55
2935.076695,40,64,0.72,24,0.03,55
2935.015483,50,59,0.21,9,0.023333333,55
2934.892105,55,79,0.77,24,0.032083333,55
2934.829284,56,90,0.85,34,0.025,55
2934.559381,51,77,0.9,26,0.034615385,55
2934.477438,50,83,0.93,33,0.028181818,55
2934.448555,44,65,0.61,21,0.029047619,55
2934.386545,42,48,0.23,6,0.038333333,55
2934.32047,5,12,0.43,7,0.061428571,55
2934.148299,34,60,0.86,26,0.033076923,55
2934.031217,39,67,0.74,28,0.026428571,55
2933.974252,42,71,0.7,29,0.024137931,55
2933.932964,37,61,0.84,24,0.035,55
2933.869659,43,53,0.35,10,0.035,55
2933.444506,47,57,0.33,10,0.033,55
2933.424687,43,72,0.78,29,0.026896552,55
2932.993734,59,72,0.43,13,0.033076923,55
2932.981421,43,69,0.63,26,0.024230769,55
2932.931741,56,75,0.63,19,0.033157895,55
2932.87299,41,72,0.88,31,0.028387097,55
2932.815111,33,62,0.96,29,0.033103448,55
2932.517849,44,55,0.37,11,0.033636364,55
2932.511297,62,69,0.23,7,0.032857143,55
2932.484131,40,69,0.96,29,0.033103448,55
2932.39074,39,68,0.76,29,0.026206897,55
2932.30472,55,90,0.89,35,0.025428571,55
2932.2665,37,63,0.88,26,0.033846154,55
2932.202069,51,57,0.15,6,0.025,55
2932.162545,41,63,0.72,22,0.032727273,55
2931.532544,50,58,0.19,8,0.02375,55
2930.790882,37,54,0.64,17,0.037647059,55
2930.77044,40,59,0.69,19,0.036315789,55
2930.767245,51,82,0.92,31,0.029677419,55
2930.357236,42,68,0.67,26,0.025769231,55
2930.130811,58,71,0.4,13,0.030769231,55
2930.103868,59,85,0.66,26,0.025384615,55
2930.103868,57,88,0.78,31,0.02516129,55
2929.658881,41,60,0.65,19,0.034210526,55
2929.373337,48,62,0.37,14,0.026428571,55
2929.275443,59,72,0.38,13,0.029230769,55
2929.103397,47,53,0.21,6,0.035,55
2929.103397,46,54,0.28,8,0.035,55
2929.075954,44,58,0.47,14,0.033571429,55
2928.985243,40,71,0.88,31,0.028387097,55
2928.73029,40,73,0.95,33,0.028787879,55
2928.694003,47,68,0.47,21,0.022380952,55
2928.58785,45,59,0.46,14,0.032857143,55
2928.583535,49,74,0.92,25,0.0368,55
2928.499394,52,74,0.77,22,0.035,55
2928.421459,42,57,0.51,15,0.034,55
2928.379806,41,58,0.58,17,0.034117647,55
2928.355729,60,79,0.5,19,0.026315789,55
2928.269582,33,56,0.9,23,0.039130435,55
2928.21464,35,56,0.73,21,0.034761905,55
2928.142799,56,73,0.52,17,0.030588235,55
2928.132843,35,55,0.71,20,0.0355,55
2928.11094,43,74,0.83,31,0.026774194,55
2928.042506,56,74,0.55,18,0.030555556,55
2927.588258,37,65,0.97,28,0.034642857,55
2927.547457,54,92,0.96,38,0.025263158,55
2927.458755,43,58,0.51,15,0.034,55
2927.399316,58,76,0.5,18,0.027777778,55
2927.174905,43,72,0.71,29,0.024482759,55
2927.061794,43,66,0.67,23,0.029130435,55
2926.900748,58,86,0.72,28,0.025714286,55
2926.691313,41,48,0.25,7,0.035714286,55
2926.556227,41,64,0.75,23,0.032608696,55
2926.434059,57,75,0.52,18,0.028888889,55
2926.41181,50,82,0.97,32,0.0303125,55
2926.064482,40,60,0.67,20,0.0335,55
2925.788121,52,77,0.77,25,0.0308,55
2925.77055,39,61,0.74,22,0.033636364,55
2925.733988,51,81,0.91,30,0.030333333,55
2925.332012,62,78,0.36,16,0.0225,55
2925.171309,44,63,0.48,19,0.025263158,55
2925.011708,50,82,0.65,32,0.0203125,55
2924.936092,46,56,0.33,10,0.033,55
2924.753058,61,82,0.54,21,0.025714286,55
2924.693807,43,73,0.8,30,0.026666667,55
2924.669604,50,78,0.97,28,0.034642857,55
2924.640687,44,62,0.55,18,0.030555556,55
2924.616772,39,66,0.88,27,0.032592593,55
2924.402303,44,67,0.58,23,0.025217391,55
2924.351528,63,76,0.37,13,0.028461538,55
2924.347032,44,72,0.7,28,0.025,55
2924.07189,49,81,0.98,32,0.030625,55
2924.03551,55,76,0.71,21,0.033809524,55
2923.983923,39,65,0.84,26,0.032307692,55
2923.921682,39,50,0.42,11,0.038181818,55
2923.694748,40,74,0.87,34,0.025588235,55
2923.650717,38,52,0.56,14,0.04,55
2923.326337,53,87,0.95,34,0.027941176,55
2923.164847,42,54,0.42,12,0.035,55
2923.098486,47,69,0.52,22,0.023636364,55
2922.93575,38,53,0.56,15,0.037333333,55
2922.69913,43,56,0.44,13,0.033846154,55
2922.653897,42,74,0.86,32,0.026875,55
2922.575657,67,76,0.19,9,0.021111111,55
2922.513646,40,61,0.72,21,0.034285714,55
2922.277402,40,76,0.96,36,0.026666667,55
2922.237519,57,80,0.66,23,0.028695652,55
2922.229315,56,68,0.43,12,0.035833333,55
2922.111679,45,61,0.53,16,0.033125,55
2921.947051,45,63,0.53,18,0.029444444,55
2921.600851,37,58,0.8,21,0.038095238,55
2921.565809,40,80,0.96,40,0.024,55
2921.555594,59,84,0.65,25,0.026,55
2921.536773,51,60,0.23,9,0.025555556,55
2921.298438,63,79,0.42,16,0.02625,55
2921.147726,54,92,0.97,38,0.025526316,55
2921.080764,42,74,0.85,32,0.0265625,55
2920.985733,58,91,0.9,33,0.027272727,55
2920.976612,54,69,0.54,15,0.036,55
2920.940602,40,62,0.72,22,0.032727273,55
2920.900388,56,88,0.84,32,0.02625,55
2920.526391,57,88,0.61,31,0.019677419,55
2920.424799,40,70,0.97,30,0.032333333,55
2920.117284,44,71,0.73,27,0.027037037,55
2919.937024,43,66,0.68,23,0.029565217,55
2919.859717,57,81,0.64,24,0.026666667,55
2919.686786,4,14,0.56,10,0.056,55
2919.598776,46,67,0.58,21,0.027619048,55
2919.584134,43,60,0.57,17,0.033529412,55
2919.583417,63,72,0.28,9,0.031111111,55
2919.085895,40,75,0.95,35,0.027142857,55
2918.81114,52,80,0.94,28,0.033571429,55
2918.738999,36,55,0.66,19,0.034736842,55
2918.727125,5,12,0.39,7,0.055714286,55
2918.648853,56,84,0.73,28,0.026071429,55
2918.527281,58,73,0.44,15,0.029333333,55
2918.496302,60,79,0.55,19,0.028947368,55
2918.491769,60,78,0.53,18,0.029444444,55
2918.319412,38,62,0.8,24,0.033333333,55
2918.098762,59,69,0.21,10,0.021,55
2917.546593,56,77,0.68,21,0.032380952,55
2917.301664,56,87,0.83,31,0.026774194,55
2917.301664,55,88,0.89,33,0.026969697,55
2917.008065,52,73,0.75,21,0.035714286,55
2916.984451,50,76,0.93,26,0.035769231,55
2916.709811,44,50,0.23,6,0.038333333,55
2916.593424,50,83,0.98,33,0.02969697,55
2916.522991,38,63,0.88,25,0.0352,55
2916.245222,54,79,0.75,25,0.03,55
2916.110979,44,69,0.8,25,0.032,55
2916.110979,43,71,0.89,28,0.031785714,55
2915.839825,57,74,0.57,17,0.033529412,55
2915.837643,41,66,0.85,25,0.034,55
2915.741374,50,58,0.21,8,0.02625,55
2915.695978,56,76,0.58,20,0.029,55
2915.695978,55,77,0.64,22,0.029090909,55
2915.665497,53,79,0.77,26,0.029615385,55
2915.66507,44,71,0.66,27,0.024444444,55
2915.615996,41,55,0.5,14,0.035714286,55
2915.590616,43,61,0.6,18,0.033333333,55
2915.542352,40,65,0.81,25,0.0324,55
2915.511581,43,60,0.47,17,0.027647059,55
2915.310585,53,70,0.62,17,0.036470588,55
2915.263401,50,73,0.84,23,0.036521739,55
2915.248016,62,76,0.41,14,0.029285714,55
2915.236503,47,65,0.59,18,0.032777778,55
2914.536953,45,67,0.52,22,0.023636364,55
2914.246743,61,70,0.26,9,0.028888889,55
2914.029666,45,57,0.4,12,0.033333333,55
2914.007908,42,67,0.74,25,0.0296,55
2913.545801,44,57,0.44,13,0.033846154,55
2913.513019,42,64,0.67,22,0.030454545,55
2913.339063,55,81,0.71,26,0.027307692,55
2913.132671,39,66,0.89,27,0.032962963,55
2913.106021,42,65,0.78,23,0.033913043,55
2913.012873,49,75,0.95,26,0.036538462,55
2912.983406,36,64,0.95,28,0.033928571,55
2912.956635,45,66,0.5,21,0.023809524,55
2912.861695,41,70,0.83,29,0.02862069,55
2912.7484,44,60,0.53,16,0.033125,55
2912.655752,39,51,0.42,12,0.035,55
2912.276625,44,73,0.69,29,0.023793103,55
2912.175041,38,67,0.96,29,0.033103448,55
2912.155168,39,60,0.71,21,0.033809524,55
2912.047055,46,66,0.52,20,0.026,55
2912.00936,44,70,0.71,26,0.027307692,55
2911.856977,43,74,0.74,31,0.023870968,55
2911.770895,49,63,0.35,14,0.025,55
2911.737783,54,76,0.67,22,0.030454545,55
2911.737783,53,77,0.73,24,0.030416667,55
2911.538083,39,75,0.99,36,0.0275,55
2911.367481,43,59,0.55,16,0.034375,55
2911.314519,42,59,0.56,17,0.032941176,55
2911.21655,37,63,0.94,26,0.036153846,55
2911.136563,57,83,0.73,26,0.028076923,55
2911.136563,56,84,0.79,28,0.028214286,55
2910.706328,41,68,0.8,27,0.02962963,55
2910.576053,53,90,0.99,37,0.026756757,55
2910.184598,42,74,0.77,32,0.0240625,55
2909.989624,45,65,0.58,20,0.029,55
2909.972341,41,72,0.8,31,0.025806452,55
2909.708438,36,61,0.93,25,0.0372,55
2909.69749,39,53,0.47,14,0.033571429,55
2909.655722,47,63,0.42,16,0.02625,55
2909.522306,51,58,0.16,7,0.022857143,55
2909.493866,41,53,0.46,12,0.038333333,55
2909.382709,43,61,0.59,18,0.032777778,55
2909.382709,42,62,0.66,20,0.033,55
2909.0487,41,75,0.92,34,0.027058824,55
2908.637174,56,77,0.63,21,0.03,55
2908.637174,55,78,0.69,23,0.03,55
2908.626715,55,76,0.63,21,0.03,55
2908.434297,45,70,0.6,25,0.024,55
2908.394362,55,74,0.58,19,0.030526316,55
2908.31563,44,66,0.65,22,0.029545455,55
2908.042319,56,83,0.76,27,0.028148148,55
2907.739707,44,64,0.58,20,0.029,55
2907.408625,57,82,0.66,25,0.0264,55
2906.969923,44,60,0.52,16,0.0325,55
2906.929311,56,75,0.57,19,0.03,55
2906.801634,64,68,0.13,4,0.0325,55
2906.801634,62,70,0.26,8,0.0325,55
2906.801634,60,72,0.39,12,0.0325,55
2906.597474,40,74,0.96,34,0.028235294,55
2906.573537,38,62,0.82,24,0.034166667,55
2906.491711,62,86,0.66,24,0.0275,55
2906.422338,46,65,0.45,19,0.023684211,55
2906.29265,61,72,0.35,11,0.031818182,55
2906.146105,45,62,0.43,17,0.025294118,55
2906.143793,54,77,0.78,23,0.033913043,55
2906.143793,53,78,0.85,25,0.034,55
2906.135189,50,73,0.85,23,0.036956522,55
2905.989945,42,68,0.76,26,0.029230769,55
2905.940168,49,82,0.98,33,0.02969697,55
2905.460618,41,75,0.91,34,0.026764706,55
2905.383806,46,62,0.47,16,0.029375,55
2905.377252,54,90,0.96,36,0.026666667,55
2905.292187,45,63,0.52,18,0.028888889,55
2905.244839,51,74,0.82,23,0.035652174,55
2905.241003,43,70,0.87,27,0.032222222,55
2905.205434,37,63,0.89,26,0.034230769,55
2905.025641,37,66,0.94,29,0.032413793,55
2904.81351,44,70,0.65,26,0.025,55
2904.773397,41,70,0.85,29,0.029310345,55
2904.764367,41,54,0.5,13,0.038461538,55
2904.678885,56,76,0.57,20,0.0285,55
2904.612704,45,71,0.64,26,0.024615385,55
2904.57085,54,78,0.79,24,0.032916667,55
2904.537187,38,69,0.82,31,0.026451613,55
2904.296859,45,68,0.58,23,0.025217391,55
2904.262493,55,76,0.7,21,0.033333333,55
2904.262493,54,77,0.77,23,0.033478261,55
2904.189524,40,74,0.86,34,0.025294118,55
2904.05455,56,75,0.64,19,0.033684211,55
2903.916446,55,69,0.5,14,0.035714286,55
2902.98334,46,70,0.57,24,0.02375,55
2902.704983,53,56,0.08,3,0.026666667,55
2902.690586,39,56,0.65,17,0.038235294,55
2902.6275,36,56,0.69,20,0.0345,55
2902.286271,57,83,0.68,26,0.026153846,55
2902.267041,42,73,0.84,31,0.027096774,55
2902.15206,62,77,0.43,15,0.028666667,55
2902.15206,61,78,0.49,17,0.028823529,55
2902.040394,39,74,0.97,35,0.027714286,55
2902.038038,53,72,0.68,19,0.035789474,55
2902.038038,52,74,0.78,22,0.035454545,55
2902.017787,44,64,0.6,20,0.03,55
2902.017787,43,65,0.66,22,0.03,55
2902.016863,33,63,0.97,30,0.032333333,55
2901.989331,41,74,0.93,33,0.028181818,55
2901.887907,42,63,0.68,21,0.032380952,55
2901.85088,51,82,0.94,31,0.030322581,55
2901.848761,38,64,0.91,26,0.035,55
2901.528298,59,79,0.59,20,0.0295,55
2901.528298,58,80,0.65,22,0.029545455,55
2901.211869,40,61,0.69,21,0.032857143,55
2901.177569,44,62,0.6,18,0.033333333,55
2900.788563,41,65,0.64,24,0.026666667,55
2900.713855,52,81,0.81,29,0.027931034,55
2900.410591,52,71,0.69,19,0.036315789,55
2900.404178,49,74,0.93,25,0.0372,55
2900.363513,59,74,0.48,15,0.032,55
2900.363513,57,76,0.61,19,0.032105263,55
2900.338939,64,69,0.14,5,0.028,55
2899.976333,52,61,0.22,9,0.024444444,55
2899.818049,55,91,0.91,36,0.025277778,55
2899.818049,54,93,0.97,39,0.024871795,55
2899.627252,45,61,0.48,16,0.03,55
2899.627252,44,62,0.54,18,0.03,55
2899.516398,44,65,0.68,21,0.032380952,55
2898.751889,61,79,0.47,18,0.026111111,55
2898.269939,37,62,0.85,25,0.034,55
2898.264219,52,91,0.99,39,0.025384615,55
2898.234675,37,52,0.58,15,0.038666667,55
2898.137506,53,79,0.86,26,0.033076923,55
2898.133465,61,75,0.38,14,0.027142857,55
2898.133465,57,80,0.62,23,0.026956522,55
2898.101549,39,64,0.83,25,0.0332,55
2897.844598,54,70,0.58,16,0.03625,55
2897.844598,51,74,0.83,23,0.036086957,55
2897.844598,50,75,0.9,25,0.036,55
2897.829809,52,80,0.93,28,0.033214286,55
2897.364013,41,61,0.67,20,0.0335,55
2897.364013,40,62,0.74,22,0.033636364,55
2897.358897,54,59,0.12,5,0.024,55
2897.285628,34,60,0.88,26,0.033846154,55
2897.07436,55,90,0.69,35,0.019714286,55
2896.893489,55,75,0.61,20,0.0305,55
2896.713035,6,11,0.28,5,0.056,55
2896.671591,49,63,0.46,14,0.032857143,55
2896.664705,47,69,0.53,22,0.024090909,55
2896.564526,47,52,0.17,5,0.034,55
2896.556476,45,71,0.59,26,0.022692308,55
2896.429803,56,77,0.59,21,0.028095238,55
2896.365446,34,57,0.87,23,0.037826087,55
2896.287549,54,91,0.96,37,0.025945946,55
2896.268568,57,87,0.78,30,0.026,55
2896.032544,55,90,0.91,35,0.026,55
2895.888511,58,72,0.42,14,0.03,55
2895.888511,57,73,0.48,16,0.03,55
2895.543854,36,64,0.99,28,0.035357143,55
2895.504399,48,64,0.4,16,0.025,55
2895.485535,42,74,0.87,32,0.0271875,55
2895.452559,41,71,0.74,30,0.024666667,55
2895.308222,40,69,0.87,29,0.03,55
2894.880941,61,71,0.28,10,0.028,55
2894.851719,42,68,0.85,26,0.032692308,55
2894.714245,7,10,0.16,3,0.053333333,55
2894.664063,40,54,0.54,14,0.038571429,55
2894.503727,40,55,0.57,15,0.038,55
2894.454849,33,61,0.94,28,0.033571429,55
2894.322258,56,81,0.72,25,0.0288,55
2894.190909,41,64,0.61,23,0.026521739,55
2894.173081,46,68,0.53,22,0.024090909,55
2894.169448,48,53,0.14,5,0.028,55
2894.159381,37,54,0.67,17,0.039411765,55
2894.15214,59,77,0.49,18,0.027222222,55
2894.15214,57,79,0.6,22,0.027272727,55
2894.053915,44,68,0.7,24,0.029166667,55
2893.916031,46,69,0.53,23,0.023043478,55
2893.711648,52,57,0.13,5,0.026,55
2893.53338,58,74,0.46,16,0.02875,55
2893.472117,38,68,0.98,30,0.032666667,55
2893.467783,48,59,0.34,11,0.030909091,55
2893.328827,38,62,0.81,24,0.03375,55
2893.291537,62,68,0.18,6,0.03,55
2893.291537,61,69,0.24,8,0.03,55
2893.291537,60,70,0.3,10,0.03,55
2893.208079,52,79,0.82,27,0.03037037,55
2893.208079,52,80,0.84,28,0.03,55
2893.208079,51,80,0.88,29,0.030344828,55
2893.208079,51,81,0.9,30,0.03,55
2893.022829,51,82,0.87,31,0.028064516,55
2892.930027,58,87,0.56,29,0.019310345,55
2892.679037,37,65,0.98,28,0.035,55
2892.649341,47,65,0.44,18,0.024444444,55
2892.599229,6,9,0.21,3,0.07,55
2892.586133,39,64,0.84,25,0.0336,55
2892.199526,46,63,0.42,17,0.024705882,55
2892.117531,61,71,0.3,10,0.03,55
2892.117531,60,72,0.36,12,0.03,55
2892.098512,38,63,0.83,25,0.0332,55
2892.066626,39,62,0.76,23,0.033043478,55
2892.022107,44,67,0.55,23,0.023913043,55
2891.98098,55,90,0.9,35,0.025714286,55
2891.865905,46,67,0.59,21,0.028095238,55
2891.772811,64,83,0.52,19,0.027368421,55
2891.73119,65,76,0.24,11,0.021818182,55
2891.678723,41,54,0.49,13,0.037692308,55
2891.66609,36,62,0.93,26,0.035769231,55
2891.64755,34,60,0.87,26,0.033461538,55
2891.606793,42,66,0.72,24,0.03,55
2891.412679,58,77,0.52,19,0.027368421,55
2891.382864,41,67,0.87,26,0.033461538,55
2891.319435,55,78,0.64,23,0.027826087,55
2891.319435,53,80,0.75,27,0.027777778,55
2891.119241,53,59,0.17,6,0.028333333,55
2890.926977,50,57,0.19,7,0.027142857,55
2890.7419,55,89,0.89,34,0.026176471,55
2890.7419,54,90,0.95,36,0.026388889,55
2890.596652,47,62,0.44,15,0.029333333,55
2890.429469,41,65,0.65,24,0.027083333,55
2890.421994,46,60,0.36,14,0.025714286,55
2890.369141,50,64,0.32,14,0.022857143,55
2890.246047,48,62,0.34,14,0.024285714,55
2889.911186,39,63,0.79,24,0.032916667,55
2889.910831,56,85,0.81,29,0.027931034,55
2889.868648,45,61,0.54,16,0.03375,55
2889.84851,39,62,0.81,23,0.035217391,55
2889.765381,43,71,0.76,28,0.027142857,55
2889.759291,36,64,0.98,28,0.035,55
2889.650506,36,64,0.97,28,0.034642857,55
2888.772606,53,86,0.93,33,0.028181818,55
2888.703506,57,82,0.7,25,0.028,55
2888.587954,44,64,0.66,20,0.033,55
2888.436115,46,53,0.24,7,0.034285714,55
2888.430261,46,70,0.58,24,0.024166667,55
2888.132756,39,60,0.72,21,0.034285714,55
2888.090593,55,83,0.8,28,0.028571429,55
2888.053983,58,82,0.68,24,0.028333333,55
2888.053983,57,83,0.74,26,0.028461538,55
2887.891704,42,64,0.58,22,0.026363636,55
2887.826388,46,60,0.42,14,0.03,55
2887.809866,64,70,0.19,6,0.031666667,55
2887.797471,38,58,0.75,20,0.0375,55
2887.650276,43,62,0.5,19,0.026315789,55
2887.441,61,77,0.47,16,0.029375,55
2887.257793,46,65,0.46,19,0.024210526,55
2886.920139,52,82,0.9,30,0.03,55
2886.920139,51,83,0.96,32,0.03,55
2886.697491,56,88,0.83,32,0.0259375,55
2886.697491,54,91,0.95,37,0.025675676,55
2886.582308,33,53,0.81,20,0.0405,55
2886.443301,58,85,0.71,27,0.026296296,55
2886.057109,47,67,0.48,20,0.024,55
2885.870555,41,64,0.76,23,0.033043478,55
2885.753096,40,75,0.94,35,0.026857143,55
2885.64427,59,73,0.42,14,0.03,55
2885.502257,45,64,0.47,19,0.024736842,55
2885.473016,46,70,0.54,24,0.0225,55
2885.44809,39,59,0.69,20,0.0345,55
2885.175667,50,80,0.92,30,0.030666667,55
2885.062868,34,57,0.86,23,0.037391304,55
2885.05509,43,55,0.41,12,0.034166667,55
2885.05509,42,56,0.48,14,0.034285714,55
2884.998561,33,54,0.83,21,0.03952381,55
2884.978558,42,75,0.89,33,0.026969697,55
2884.857782,38,57,0.73,19,0.038421053,55
2884.454295,50,82,0.96,32,0.03,55
2884.343293,46,58,0.33,12,0.0275,55
2884.30024,56,76,0.67,20,0.0335,55
2884.070468,50,63,0.33,13,0.025384615,55
2884.012674,40,60,0.68,20,0.034,55
2884.012674,39,61,0.75,22,0.034090909,55
2883.944149,59,89,0.82,30,0.027333333,55
2883.827508,38,63,0.89,25,0.0356,55
2883.764225,58,73,0.5,15,0.033333333,55
2883.763537,47,68,0.54,21,0.025714286,55
2883.536254,59,71,0.36,12,0.03,55
2883.536254,54,77,0.69,23,0.03,55
2883.536254,53,78,0.75,25,0.03,55
2883.467516,36,58,0.74,22,0.033636364,55
2883.370915,56,82,0.69,26,0.026538462,55
2883.36813,43,51,0.31,8,0.03875,55
2883.334061,53,85,0.91,32,0.0284375,55
2883.334061,52,86,0.97,34,0.028529412,55
2883.332921,57,77,0.64,20,0.032,55
2882.936199,62,72,0.32,10,0.032,55
2882.907269,42,77,0.83,35,0.023714286,55
2882.8872,43,63,0.61,20,0.0305,55
2882.86318,44,57,0.43,13,0.033076923,55
2882.654253,47,53,0.2,6,0.033333333,55
2882.416367,35,56,0.74,21,0.035238095,55
2882.202424,51,75,0.85,24,0.035416667,55
2881.450742,39,73,0.95,34,0.027941176,55
2881.393276,64,67,0.1,3,0.033333333,55
2881.393276,61,70,0.3,9,0.033333333,55
2881.121513,67,76,0.23,9,0.025555556,55
2881.121513,62,82,0.51,20,0.0255,55
2881.121513,61,83,0.56,22,0.025454545,55
2881.121513,60,84,0.61,24,0.025416667,55
2881.121513,58,87,0.73,29,0.025172414,55
2880.782626,68,79,0.3,11,0.027272727,55
2880.782626,66,81,0.41,15,0.027333333,55
2880.676883,42,68,0.84,26,0.032307692,55
2880.548553,41,64,0.62,23,0.026956522,55
2880.260014,60,74,0.45,14,0.032142857,55
2880.054485,40,47,0.26,7,0.037142857,55
2879.791183,41,69,0.9,28,0.032142857,55
2879.312415,42,69,0.79,27,0.029259259,55
2879.298296,47,67,0.46,20,0.023,55
2879.247425,54,85,0.91,31,0.029354839,55
2879.143084,41,66,0.84,25,0.0336,55
2879.017483,48,59,0.3,11,0.027272727,55
2878.730138,5,12,0.4,7,0.057142857,55
2878.622936,43,73,0.75,30,0.025,55
2878.520185,52,70,0.67,18,0.037222222,55
2878.520185,50,72,0.82,22,0.037272727,55
2878.467483,55,89,0.9,34,0.026470588,55
2878.332156,56,83,0.71,27,0.026296296,55
2878.244789,37,53,0.57,16,0.035625,55
2878.001567,43,66,0.69,23,0.03,55
2877.897379,41,63,0.66,22,0.03,55
2877.828258,53,86,0.97,33,0.029393939,55
2877.806787,61,77,0.45,16,0.028125,55
2877.782002,40,57,0.59,17,0.034705882,55
2877.495337,45,71,0.6,26,0.023076923,55
2877.372725,60,75,0.47,15,0.031333333,55
2877.252643,36,63,0.98,27,0.036296296,55
2877.030897,60,78,0.51,18,0.028333333,55
2876.967808,39,72,0.94,33,0.028484848,55
2876.851113,49,83,0.74,34,0.021764706,55
2876.780575,38,59,0.75,21,0.035714286,55
2876.63483,57,74,0.5,17,0.029411765,55
2876.63483,56,75,0.56,19,0.029473684,55
2876.621468,5,12,0.44,7,0.062857143,55
2876.455784,55,76,0.62,21,0.02952381,55
2876.392948,42,53,0.41,11,0.037272727,55
2876.392228,49,51,0.07,2,0.035,55
2876.392228,48,52,0.14,4,0.035,55
2876.359199,41,66,0.75,25,0.03,55
2876.350425,56,74,0.54,18,0.03,55
2876.350425,55,75,0.6,20,0.03,55
2876.328407,59,75,0.51,16,0.031875,55
2876.302116,6,11,0.3,5,0.06,55
2876.030767,44,66,0.64,22,0.029090909,55
2875.942927,42,75,0.87,33,0.026363636,55
2875.940339,61,87,0.71,26,0.027307692,55
2875.833439,59,73,0.46,14,0.032857143,55
2875.818915,62,75,0.35,13,0.026923077,55
2875.511345,49,73,0.9,24,0.0375,55
2875.44033,49,59,0.27,10,0.027,55
2875.313848,52,80,0.83,28,0.029642857,55
2875.273384,39,63,0.81,24,0.03375,55
2875.183608,46,62,0.52,16,0.0325,55
2875.005199,43,74,0.73,31,0.023548387,55
2874.835122,55,84,0.82,29,0.028275862,55
2874.810503,58,84,0.7,26,0.026923077,55
2874.806158,40,59,0.64,19,0.033684211,55
2874.743448,44,70,0.73,26,0.028076923,55
2874.704236,54,78,0.8,24,0.033333333,55
2874.573148,38,67,0.93,29,0.032068966,55
2874.570532,37,61,0.83,24,0.034583333,55
2874.496717,48,58,0.31,10,0.031,55
2874.450722,63,75,0.32,12,0.026666667,55
2874.450722,60,78,0.48,18,0.026666667,55
2874.437581,42,73,0.83,31,0.026774194,55
2874.237177,44,71,0.67,27,0.024814815,55
2874.180488,47,62,0.37,15,0.024666667,55
2874.014905,43,72,0.79,29,0.027241379,55
2873.963175,36,72,0.94,36,0.026111111,55
2873.935896,41,76,0.93,35,0.026571429,55
2873.728317,35,50,0.62,15,0.041333333,55
2873.677361,38,54,0.6,16,0.0375,55
2873.490157,40,73,0.93,33,0.028181818,55
2873.14694,64,84,0.53,20,0.0265,55
2872.985272,38,61,0.8,23,0.034782609,55
2872.562987,37,52,0.54,15,0.036,55
2872.545227,46,67,0.68,21,0.032380952,55
2872.449651,57,69,0.42,12,0.035,55
2872.449651,56,70,0.49,14,0.035,55
2872.4137,57,74,0.49,17,0.028823529,55
2871.983564,54,68,0.52,14,0.037142857,55
2871.86679,48,56,0.25,8,0.03125,55
2871.807089,54,80,0.84,26,0.032307692,55
2871.680684,47,59,0.36,12,0.03,55
2871.377143,63,78,0.33,15,0.022,55
2871.299511,39,76,0.99,37,0.026756757,55
2871.12706,44,67,0.65,23,0.02826087,55
2871.09834,42,63,0.56,21,0.026666667,55
2870.97187,40,72,0.92,32,0.02875,55
2870.941509,50,73,0.86,23,0.037391304,55
2870.819045,45,63,0.59,18,0.032777778,55
2870.799567,47,55,0.27,8,0.03375,55
2870.715782,44,68,0.58,24,0.024166667,55
2870.623002,49,60,0.26,11,0.023636364,55
2870.531242,67,80,0.36,13,0.027692308,55
2870.489633,42,69,0.8,27,0.02962963,55
2870.473097,52,62,0.25,10,0.025,55
2870.446931,58,83,0.69,25,0.0276,55
2870.433491,45,67,0.63,22,0.028636364,55
2870.396786,45,69,0.6,24,0.025,55
2870.359021,41,60,0.63,19,0.033157895,55
2870.242232,37,71,0.89,34,0.026176471,55
2869.91638,46,71,0.54,25,0.0216,55
2869.857535,58,91,0.89,33,0.026969697,55
2869.76449,39,53,0.52,14,0.037142857,55
2869.497359,60,71,0.37,11,0.033636364,55
2869.437829,53,79,0.87,26,0.033461538,55
2869.353125,39,58,0.66,19,0.034736842,55
2869.259798,38,67,0.97,29,0.033448276,55
2869.130322,38,61,0.79,23,0.034347826,55
2869.130322,37,62,0.87,25,0.0348,55
2869.012074,36,55,0.73,19,0.038421053,55
2868.926598,65,82,0.48,17,0.028235294,55
2868.737646,55,77,0.74,22,0.033636364,55
2868.714148,38,60,0.75,22,0.034090909,55
2868.65332,37,61,0.85,24,0.035416667,55
2868.623934,42,56,0.49,14,0.035,55
2868.623934,41,57,0.56,16,0.035,55
2868.038043,57,88,0.79,31,0.025483871,55
2868.032745,49,62,0.32,13,0.024615385,55
2867.88956,51,57,0.16,6,0.026666667,55
2867.452059,56,84,0.78,28,0.027857143,55
2867.443981,39,58,0.63,19,0.033157895,55
2867.373975,39,63,0.82,24,0.034166667,55
2867.158063,4,13,0.56,9,0.062222222,55
2867.0572,42,73,0.85,31,0.027419355,55
2867.040605,44,65,0.63,21,0.03,55
2866.893648,48,66,0.41,18,0.022777778,55
2866.679183,53,88,0.91,35,0.026,55
2866.677772,37,53,0.61,16,0.038125,55
2866.602531,44,70,0.82,26,0.031538462,55
2866.579648,54,88,0.87,34,0.025588235,55
2866.531046,45,67,0.54,22,0.024545455,55
2866.528571,46,62,0.43,16,0.026875,55
2866.460346,51,85,0.99,34,0.029117647,55
2866.282089,60,73,0.42,13,0.032307692,55
2866.282089,58,75,0.55,17,0.032352941,55
2866.24966,44,70,0.66,26,0.025384615,55
2866.213759,37,54,0.65,17,0.038235294,55
2866.090204,38,51,0.5,13,0.038461538,55
2866.029532,37,64,0.94,27,0.034814815,55
2866.014751,45,63,0.55,18,0.030555556,55
2865.997448,44,52,0.28,8,0.035,55
2865.686194,59,78,0.51,19,0.026842105,55
2865.679062,54,84,0.86,30,0.028666667,55
2865.679062,53,85,0.92,32,0.02875,55
2865.679062,52,86,0.98,34,0.028823529,55
2865.642573,46,66,0.49,20,0.0245,55
2865.581473,34,61,0.9,27,0.033333333,55
2865.442893,50,76,0.92,26,0.035384615,55
2865.266398,40,59,0.65,19,0.034210526,55
2865.231902,45,71,0.63,26,0.024230769,55
2865.051569,39,54,0.49,15,0.032666667,55
2864.993535,51,72,0.78,21,0.037142857,55
2864.963437,38,57,0.72,19,0.037894737,55
2864.948648,42,75,0.78,33,0.023636364,55
2864.769785,40,51,0.41,11,0.037272727,55
2864.710416,57,81,0.68,24,0.028333333,55
2864.710416,56,82,0.74,26,0.028461538,55
2864.474085,42,73,0.87,31,0.028064516,55
2864.453409,60,88,0.76,28,0.027142857,55
2864.45015,33,62,0.95,29,0.032758621,55
2864.356417,63,77,0.39,14,0.027857143,55
2864.235775,61,78,0.39,17,0.022941176,55
2864.208428,58,70,0.25,12,0.020833333,55
2864.182041,41,76,0.94,35,0.026857143,55
2864.145943,42,77,0.8,35,0.022857143,55
2864.139057,55,76,0.43,21,0.02047619,55
2864.135826,55,86,0.87,31,0.028064516,55
2864.122293,44,67,0.56,23,0.024347826,55
2863.86795,38,64,0.89,26,0.034230769,55
2863.842291,52,87,0.99,35,0.028285714,55
2863.604566,39,56,0.64,17,0.037647059,55
2863.59485,65,67,0.06,2,0.03,55
2863.59485,64,68,0.12,4,0.03,55
2863.588969,56,76,0.66,20,0.033,55
2863.523828,42,73,0.96,31,0.030967742,55
2863.499408,53,81,0.83,28,0.029642857,55
2863.432345,56,89,0.65,33,0.01969697,55
2863.398773,67,86,0.36,19,0.018947368,55
2863.375901,54,78,0.81,24,0.03375,55
2863.375901,53,79,0.88,26,0.033846154,55
2863.312013,42,68,0.83,26,0.031923077,55
2863.076419,37,61,0.82,24,0.034166667,55
2863.008505,59,77,0.52,18,0.028888889,55
2862.989082,48,82,0.71,34,0.020882353,55
2862.743765,34,61,0.89,27,0.032962963,55
2862.651442,41,58,0.57,17,0.033529412,55
2862.331837,44,70,0.6,26,0.023076923,55
2862.211587,58,74,0.48,16,0.03,55
2862.211587,57,75,0.54,18,0.03,55
2862.198015,40,77,0.9,37,0.024324324,55
2862.180854,52,71,0.7,19,0.036842105,55
2862.089402,41,56,0.52,15,0.034666667,55
2862.052728,42,55,0.45,13,0.034615385,55
2862.035554,38,49,0.43,11,0.039090909,55
2862.035554,37,50,0.51,13,0.039230769,55
2862.035554,36,51,0.59,15,0.039333333,55
2861.793807,57,92,0.95,35,0.027142857,55
2861.605676,48,63,0.37,15,0.024666667,55
2861.365346,37,64,0.9,27,0.033333333,55
2861.363616,50,83,0.97,33,0.029393939,55
2861.325085,43,66,0.75,23,0.032608696,55
2861.25783,64,66,0.06,2,0.03,55
2861.25783,63,67,0.12,4,0.03,55
2861.192169,46,55,0.25,9,0.027777778,55
2861.074026,54,83,0.78,29,0.026896552,55
2860.948656,47,63,0.39,16,0.024375,55
2860.94097,51,84,0.99,33,0.03,55
2860.749677,58,76,0.57,18,0.031666667,55
2860.641,49,65,0.36,16,0.0225,55
2860.626263,55,77,0.73,22,0.033181818,55
2860.337161,61,73,0.38,12,0.031666667,55
2860.326972,52,90,0.98,38,0.025789474,55
2860.286874,48,84,0.79,36,0.021944444,55
2860.106034,38,61,0.81,23,0.035217391,55
2859.849548,45,70,0.69,25,0.0276,55
2859.619362,44,65,0.52,21,0.024761905,55
2859.52806,52,76,0.55,24,0.022916667,55
2859.527556,48,64,0.53,16,0.033125,55
2859.466099,47,64,0.41,17,0.024117647,55
2859.455229,58,73,0.51,15,0.034,55
2859.455229,57,74,0.58,17,0.034117647,55
2859.449578,50,84,0.94,34,0.027647059,55
2859.263169,43,72,0.8,29,0.027586207,55
2859.109247,66,76,0.21,10,0.021,55
2858.947855,61,87,0.7,26,0.026923077,55
2858.870392,39,52,0.44,13,0.033846154,55
2858.854309,60,88,0.79,28,0.028214286,55
2858.832095,52,77,0.53,25,0.0212,55
2858.746744,45,65,0.48,20,0.024,55
2858.653498,43,68,0.61,25,0.0244,55
2858.488885,41,66,0.8,25,0.032,55
2858.48801,37,55,0.68,18,0.037777778,55
2858.444871,50,80,0.91,30,0.030333333,55
2858.437337,44,62,0.61,18,0.033888889,55
2857.869992,38,65,0.88,27,0.032592593,55
2857.843444,43,65,0.73,22,0.033181818,55
2857.568808,46,69,0.59,23,0.025652174,55
2857.520875,36,66,0.99,30,0.033,55
2857.447032,45,69,0.58,24,0.024166667,55
2857.3497,62,73,0.32,11,0.029090909,55
2857.264523,45,72,0.59,27,0.021851852,55
2856.924399,40,61,0.74,21,0.035238095,55
2856.894135,50,77,0.95,27,0.035185185,55
2856.892214,41,76,0.84,35,0.024,55
2856.87858,59,72,0.44,13,0.033846154,55
2856.824299,45,56,0.31,11,0.028181818,55
2856.659559,54,80,0.77,26,0.029615385,55
2856.659559,52,83,0.91,31,0.029354839,55
2856.637094,40,59,0.67,19,0.035263158,55
2856.590701,62,81,0.49,19,0.025789474,55
2856.47138,45,71,0.62,26,0.023846154,55
2856.469283,56,83,0.78,27,0.028888889,55
2856.469283,55,84,0.84,29,0.028965517,55
2856.469283,55,85,0.86,30,0.028666667,55
2856.469283,54,86,0.92,32,0.02875,55
2856.390958,40,72,0.96,32,0.03,55
2856.383739,41,48,0.28,7,0.04,55
2856.28204,58,72,0.29,14,0.020714286,55
2856.21446,45,59,0.37,14,0.026428571,55
2856.028791,54,79,0.82,25,0.0328,55
2855.987867,53,81,0.78,28,0.027857143,55
2855.918985,51,83,0.89,32,0.0278125,55
2855.918985,50,84,0.95,34,0.027941176,55
2855.827293,50,60,0.23,10,0.023,55
2855.724032,52,63,0.25,11,0.022727273,55
2855.435405,43,66,0.76,23,0.033043478,55
2855.40073,39,52,0.49,13,0.037692308,55
2855.393782,48,60,0.32,12,0.026666667,55
2855.253763,57,84,0.75,27,0.027777778,55
2855.148959,36,62,0.94,26,0.036153846,55
2855.059765,46,91,0.93,45,0.020666667,55
2854.775281,55,80,0.69,25,0.0276,55
2854.768411,42,47,0.18,5,0.036,55
2854.748406,37,62,0.89,25,0.0356,55
2854.496225,38,60,0.77,22,0.035,55
2854.471661,43,66,0.77,23,0.033478261,55
2854.346774,49,62,0.33,13,0.025384615,55
2854.312907,53,88,0.99,35,0.028285714,55
2854.120952,39,58,0.67,19,0.035263158,55
2854.117647,45,65,0.52,20,0.026,55
2854.01136,59,79,0.57,20,0.0285,55
2853.982395,53,80,0.81,27,0.03,55
2853.817322,60,85,0.63,25,0.0252,55
2853.817322,59,86,0.68,27,0.025185185,55
2853.692773,44,71,0.75,27,0.027777778,55
2853.676487,63,69,0.18,6,0.03,55
2853.676487,62,70,0.24,8,0.03,55
2853.67171,42,58,0.54,16,0.03375,55
2853.620239,47,58,0.34,11,0.030909091,55
2853.38481,41,59,0.61,18,0.033888889,55
2853.377575,50,62,0.38,12,0.031666667,55
2853.30462,41,74,0.8,33,0.024242424,55
2853.2583,41,71,0.87,30,0.029,55
2852.980691,60,75,0.41,15,0.027333333,55
2852.891693,38,61,0.82,23,0.035652174,55
2852.761556,58,82,0.67,24,0.027916667,55
2852.742083,52,79,0.79,27,0.029259259,55
2852.629803,54,79,0.69,25,0.0276,55
2852.61942,39,64,0.86,25,0.0344,55
2852.603615,37,63,0.9,26,0.034615385,55
2852.455266,42,52,0.38,10,0.038,55
2852.420599,66,72,0.16,6,0.026666667,55
2852.001072,38,53,0.57,15,0.038,55
2851.888465,39,75,0.92,36,0.025555556,55
2851.865434,41,68,0.81,27,0.03,55
2851.462948,38,68,0.11,30,0.003666667,55
2851.412704,39,59,0.68,20,0.034,55
2851.325271,57,89,0.8,32,0.025,55
2851.281022,64,75,0.29,11,0.026363636,55
2851.138569,63,84,0.58,21,0.027619048,55
2851.125354,39,69,0.98,30,0.032666667,55
2850.949651,42,70,0.72,28,0.025714286,55
2850.890234,46,59,0.45,13,0.034615385,55
2850.832118,42,73,0.75,31,0.024193548,55
2850.691084,58,75,0.51,17,0.03,55
2850.691084,57,76,0.57,19,0.03,55
2850.593958,45,60,0.46,15,0.030666667,55
2850.550751,50,65,0.32,15,0.021333333,55
2850.535696,52,60,0.25,8,0.03125,55
2850.290254,60,80,0.57,20,0.0285,55
2850.26301,51,84,0.97,33,0.029393939,55
2850.232131,46,67,0.6,21,0.028571429,55
2850.114068,57,86,0.77,29,0.026551724,55
2849.88612,57,77,0.6,20,0.03,55
