% profit,ema1,ema2,threshold,diff,thresh / diff,ID
3577.070549,56,79,0.64,23,0.027826087,34
3559.920799,53,83,0.84,30,0.028,34
3528.818558,39,49,0.36,10,0.036,34
3527.296688,59,67,0.27,8,0.03375,34
3522.336002,52,85,0.91,33,0.027575758,34
3511.906911,51,86,0.97,35,0.027714286,34
3502.132092,59,68,0.3,9,0.033333333,34
3499.441121,50,75,0.87,25,0.0348,34
3498.492287,53,84,0.85,31,0.027419355,34
3495.711718,55,81,0.72,26,0.027692308,34
3492.626559,56,71,0.5,15,0.033333333,34
3489.499813,54,82,0.78,28,0.027857143,34
3485.943829,62,65,0.1,3,0.033333333,34
3484.114609,51,85,0.95,34,0.027941176,34
3483.641888,52,84,0.9,32,0.028125,34
3483.641888,51,85,0.96,34,0.028235294,34
3480.279185,38,50,0.46,12,0.038333333,34
3476.298298,39,49,0.38,10,0.038,34
3475.211615,52,73,0.73,21,0.034761905,34
3475.211615,51,74,0.8,23,0.034782609,34
3472.705402,37,51,0.54,14,0.038571429,34
3471.119038,55,79,0.68,24,0.028333333,34
3468.733684,55,80,0.7,25,0.028,34
3465.627953,51,87,0.98,36,0.027222222,34
3461.745514,59,75,0.45,16,0.028125,34
3461.489747,40,48,0.29,8,0.03625,34
3451.864223,61,71,0.29,10,0.029,34
3449.50175,53,83,0.83,30,0.027666667,34
3449.50175,52,84,0.89,32,0.0278125,34
3448.81606,53,82,0.82,29,0.028275862,34
3447.996364,60,73,0.37,13,0.028461538,34
3438.805503,59,74,0.43,15,0.028666667,34
3438.805503,53,81,0.8,28,0.028571429,34
3437.706307,35,54,0.72,19,0.037894737,34
3435.805145,52,85,0.92,33,0.027878788,34
3435.805145,51,86,0.98,35,0.028,34
3435.738993,54,80,0.74,26,0.028461538,34
3433.377271,54,81,0.76,27,0.028148148,34
3432.248719,54,82,0.77,28,0.0275,34
3431.484569,58,75,0.49,17,0.028823529,34
3427.972523,54,72,0.61,18,0.033888889,34
3427.136113,51,85,0.97,34,0.028529412,34
3420.357095,58,76,0.51,18,0.028333333,34
3410.953604,51,87,0.99,36,0.0275,34
3408.119902,55,72,0.57,17,0.033529412,34
3407.799427,57,76,0.55,19,0.028947368,34
3403.187752,58,69,0.37,11,0.033636364,34
3401.738457,55,79,0.69,24,0.02875,34
3401.738457,54,80,0.75,26,0.028846154,34
3401.738457,53,81,0.81,28,0.028928571,34
3401.738457,52,82,0.87,30,0.029,34
3401.738457,52,83,0.89,31,0.028709677,34
3401.738457,51,83,0.93,32,0.0290625,34
3401.738457,51,84,0.95,33,0.028787879,34
3397.477962,50,78,0.95,28,0.033928571,34
3392.650493,52,86,0.93,34,0.027352941,34
3390.349419,58,68,0.34,10,0.034,34
3390.190638,57,69,0.41,12,0.034166667,34
3389.140028,57,70,0.44,13,0.033846154,34
3389.09047,35,54,0.71,19,0.037368421,34
3388.260633,52,86,0.98,34,0.028823529,34
3387.314376,53,84,0.86,31,0.027741935,34
3386.504476,53,82,0.83,29,0.02862069,34
3386.443754,60,78,0.51,18,0.028333333,34
3386.414399,52,83,0.88,31,0.028387097,34
3386.414399,51,84,0.94,33,0.028484848,34
3386.063196,55,71,0.55,16,0.034375,34
3385.586355,54,72,0.62,18,0.034444444,34
3383.83243,51,83,0.94,32,0.029375,34
3383.526962,56,69,0.45,13,0.034615385,34
3383.338665,56,70,0.48,14,0.034285714,34
3383.050469,55,70,0.52,15,0.034666667,34
3381.984801,58,67,0.31,9,0.034444444,34
3381.563213,62,70,0.23,8,0.02875,34
3378.668491,55,81,0.77,26,0.029615385,34
3376.606039,56,80,0.71,24,0.029583333,34
3376.579866,52,82,0.86,30,0.028666667,34
3375.613686,58,78,0.59,20,0.0295,34
3375.613686,56,81,0.73,25,0.0292,34
3375.613686,55,82,0.79,27,0.029259259,34
3375.148938,57,68,0.38,11,0.034545455,34
3373.79807,56,76,0.59,20,0.0295,34
3373.027746,52,84,0.95,32,0.0296875,34
3372.648382,57,79,0.65,22,0.029545455,34
3370.994822,52,81,0.86,29,0.029655172,34
3370.322721,53,74,0.71,21,0.033809524,34
3370.16485,52,75,0.78,23,0.033913043,34
3370.16485,51,76,0.85,25,0.034,34
3370.006456,38,48,0.39,10,0.039,34
3370.006456,37,49,0.47,12,0.039166667,34
3368.430405,50,83,0.99,33,0.03,34
3367.529757,52,87,0.95,35,0.027142857,34
3367.491935,61,76,0.43,15,0.028666667,34
3367.09332,60,77,0.49,17,0.028823529,34
3367.09332,59,78,0.55,19,0.028947368,34
3367.09332,58,80,0.63,22,0.028636364,34
3366.201979,51,86,0.96,35,0.027428571,34
3365.435771,55,78,0.67,23,0.029130435,34
3365.435771,54,79,0.73,25,0.0292,34
3365.435771,53,80,0.79,27,0.029259259,34
3362.734187,54,83,0.8,29,0.027586207,34
3361.262445,53,83,0.89,30,0.029666667,34
3358.847659,54,73,0.64,19,0.033684211,34
3358.587331,56,78,0.62,22,0.028181818,34
3352.873239,35,54,0.73,19,0.038421053,34
3352.646691,50,84,0.99,34,0.029117647,34
3352.308071,61,72,0.31,11,0.028181818,34
3352.308071,58,75,0.48,17,0.028235294,34
3349.628078,55,78,0.66,23,0.028695652,34
3347.100095,51,82,0.92,31,0.029677419,34
3346.246501,54,82,0.84,28,0.03,34
3346.246501,53,83,0.9,30,0.03,34
3346.246501,52,84,0.96,32,0.03,34
3345.894119,55,82,0.74,27,0.027407407,34
3345.894119,53,85,0.87,32,0.0271875,34
3341.579313,52,81,0.85,29,0.029310345,34
3341.009792,56,77,0.61,21,0.029047619,34
3340.810338,54,84,0.87,30,0.029,34
3340.810338,53,85,0.93,32,0.0290625,34
3340.810338,52,86,0.99,34,0.029117647,34
3339.073876,54,83,0.86,29,0.029655172,34
3339.073876,53,84,0.92,31,0.029677419,34
3338.573612,56,81,0.72,25,0.0288,34
3338.573612,54,84,0.86,30,0.028666667,34
3338.573612,53,85,0.92,32,0.02875,34
3338.178193,52,85,0.98,33,0.02969697,34
3338.070907,42,46,0.15,4,0.0375,34
3337.921752,62,70,0.25,8,0.03125,34
3337.874728,54,83,0.85,29,0.029310345,34
3336.882785,60,74,0.43,14,0.030714286,34
3335.817207,54,82,0.83,28,0.029642857,34
3335.63991,55,82,0.78,27,0.028888889,34
3333.747806,62,71,0.28,9,0.031111111,34
3333.252746,51,84,0.92,33,0.027878788,34
3329.306624,52,87,0.99,35,0.028285714,34
3327.312764,50,85,0.98,35,0.028,34
3326.866229,60,71,0.35,11,0.031818182,34
3326.543127,55,83,0.81,28,0.028928571,34
3326.380829,52,86,0.97,34,0.028529412,34
3325.325606,61,77,0.45,16,0.028125,34
3324.894008,53,73,0.69,20,0.0345,34
3324.894008,52,74,0.76,22,0.034545455,34
3323.662153,56,82,0.74,26,0.028461538,34
3323.268577,54,85,0.88,31,0.028387097,34
3323.268577,53,86,0.94,33,0.028484848,34
3323.199653,55,83,0.8,28,0.028571429,34
3323.183743,59,77,0.53,18,0.029444444,34
3322.770985,52,85,0.97,33,0.029393939,34
3321.362378,54,79,0.72,25,0.0288,34
3320.741674,53,84,0.91,31,0.029354839,34
3320.232836,52,88,0.97,36,0.026944444,34
3319.208323,54,71,0.59,17,0.034705882,34
3317.51708,52,84,0.88,32,0.0275,34
3317.423409,53,84,0.9,31,0.029032258,34
3317.423409,52,85,0.96,33,0.029090909,34
3315.888948,56,83,0.74,27,0.027407407,34
3315.888948,55,84,0.8,29,0.027586207,34
3315.888948,54,85,0.86,31,0.027741935,34
3315.888948,53,86,0.91,33,0.027575758,34
3315.888948,52,88,0.98,36,0.027222222,34
3315.888948,52,88,0.99,36,0.0275,34
3315.397269,54,83,0.84,29,0.028965517,34
3313.652927,51,75,0.83,24,0.034583333,34
3312.9746,52,87,0.97,35,0.027714286,34
3312.666128,52,82,0.85,30,0.028333333,34
3312.666128,51,83,0.91,32,0.0284375,34
3311.279101,56,82,0.73,26,0.028076923,34
3311.279101,55,83,0.79,28,0.028214286,34
3311.279101,55,84,0.81,29,0.027931034,34
3311.279101,54,84,0.85,30,0.028333333,34
3311.279101,54,85,0.87,31,0.028064516,34
3311.279101,53,86,0.93,33,0.028181818,34
3309.534696,55,84,0.82,29,0.028275862,34
3308.368686,53,85,0.91,32,0.0284375,34
3306.833215,37,52,0.54,15,0.036,34
3305.710972,40,47,0.28,7,0.04,34
3305.491574,53,88,0.93,35,0.026571429,34
3304.659254,57,76,0.54,19,0.028421053,34
3304.659254,57,77,0.56,20,0.028,34
3304.321425,56,82,0.75,26,0.028846154,34
3303.973813,56,83,0.75,27,0.027777778,34
3303.125534,50,85,0.99,35,0.028285714,34
3300.964365,54,80,0.73,26,0.028076923,34
3300.964365,53,81,0.79,28,0.028214286,34
3299.893753,42,43,0.04,1,0.04,34
3299.893753,41,44,0.12,3,0.04,34
3299.589813,50,76,0.9,26,0.034615385,34
3298.768742,56,77,0.6,21,0.028571429,34
3297.865188,55,72,0.58,17,0.034117647,34
3293.404154,53,87,0.92,34,0.027058824,34
3292.69993,54,81,0.75,27,0.027777778,34
3292.149977,68,71,0.07,3,0.023333333,34
3292.047666,51,83,0.9,32,0.028125,34
3291.542824,57,81,0.68,24,0.028333333,34
3291.370812,57,83,0.7,26,0.026923077,34
3289.775898,50,84,0.97,34,0.028529412,34
3289.442453,60,70,0.32,10,0.032,34
3288.620867,38,50,0.47,12,0.039166667,34
3287.766038,41,47,0.22,6,0.036666667,34
3286.93415,58,72,0.45,14,0.032142857,34
3286.83011,53,82,0.81,29,0.027931034,34
3286.83011,52,83,0.87,31,0.028064516,34
3286.161708,52,87,0.98,35,0.028,34
3285.503849,39,49,0.39,10,0.039,34
3285.46042,53,80,0.78,27,0.028888889,34
3285.27291,52,76,0.81,24,0.03375,34
3284.072499,37,51,0.55,14,0.039285714,34
3283.272723,52,86,0.96,34,0.028235294,34
3283.22747,53,86,0.92,33,0.027878788,34
3281.488938,39,47,0.31,8,0.03875,34
3281.488109,56,84,0.75,28,0.026785714,34
3281.486533,41,46,0.2,5,0.04,34
3280.449062,51,78,0.86,27,0.031851852,34
3279.174087,52,82,0.84,30,0.028,34
3278.612235,51,83,0.92,32,0.02875,34
3278.164821,36,50,0.55,14,0.039285714,34
3277.433202,60,76,0.47,16,0.029375,34
3276.303297,53,81,0.78,28,0.027857143,34
3272.160743,51,85,0.94,34,0.027647059,34
3272.126496,36,53,0.61,17,0.035882353,34
3271.904409,54,86,0.86,32,0.026875,34
3271.86604,63,70,0.22,7,0.031428571,34
3271.560001,59,79,0.56,20,0.028,34
3271.560001,58,80,0.62,22,0.028181818,34
3266.93039,51,77,0.88,26,0.033846154,34
3266.176977,56,71,0.51,15,0.034,34
3265.50137,53,72,0.66,19,0.034736842,34
3264.218501,50,84,0.96,34,0.028235294,34
3263.464898,53,87,0.95,34,0.027941176,34
3261.725635,51,84,0.93,33,0.028181818,34
3261.556272,43,44,0.04,1,0.04,34
3261.556272,42,45,0.12,3,0.04,34
3259.535436,39,49,0.37,10,0.037,34
3257.693127,54,78,0.71,24,0.029583333,34
3257.534904,57,80,0.67,23,0.029130435,34
3256.904151,61,66,0.17,5,0.034,34
3255.828366,54,86,0.88,32,0.0275,34
3253.160792,59,70,0.36,11,0.032727273,34
3252.966932,57,81,0.69,24,0.02875,34
3252.018235,49,80,0.99,31,0.031935484,34
3250.590214,51,77,0.89,26,0.034230769,34
3250.590214,50,78,0.96,28,0.034285714,34
3249.585839,56,83,0.76,27,0.028148148,34
3247.394295,55,79,0.67,24,0.027916667,34
3245.258477,53,77,0.74,24,0.030833333,34
3243.612992,58,79,0.61,21,0.029047619,34
3241.913531,60,79,0.52,19,0.027368421,34
3241.913531,58,81,0.63,23,0.027391304,34
3241.913531,56,84,0.76,28,0.027142857,34
3241.913531,55,85,0.82,30,0.027333333,34
3241.493824,36,53,0.65,17,0.038235294,34
3241.397439,57,78,0.59,21,0.028095238,34
3241.397439,56,79,0.65,23,0.02826087,34
3240.097331,36,53,0.62,17,0.036470588,34
3239.632293,52,83,0.86,31,0.027741935,34
3238.243591,54,73,0.65,19,0.034210526,34
3238.243591,53,74,0.72,21,0.034285714,34
3238.243591,52,75,0.79,23,0.034347826,34
3238.243591,51,76,0.86,25,0.0344,34
3233.738915,55,85,0.81,30,0.027,34
3233.738915,53,88,0.94,35,0.026857143,34
3233.480065,55,77,0.65,22,0.029545455,34
3231.910313,64,74,0.28,10,0.028,34
3230.860104,61,72,0.34,11,0.030909091,34
3229.646957,50,86,0.99,36,0.0275,34
3226.110301,54,77,0.69,23,0.03,34
3226.064272,51,80,0.89,29,0.030689655,34
3226.054173,58,75,0.53,17,0.031176471,34
3225.951749,34,55,0.81,21,0.038571429,34
3225.156279,50,81,0.95,31,0.030645161,34
3224.625936,55,82,0.8,27,0.02962963,34
3224.058187,59,73,0.44,14,0.031428571,34
3223.426233,51,80,0.88,29,0.030344828,34
3223.152349,51,81,0.89,30,0.029666667,34
3222.731012,54,86,0.87,32,0.0271875,34
3222.731012,53,87,0.93,34,0.027352941,34
3222.250765,50,85,0.97,35,0.027714286,34
3221.254031,41,47,0.23,6,0.038333333,34
3220.330624,56,74,0.55,18,0.030555556,34
3219.499814,57,82,0.69,25,0.0276,34
3218.947475,59,80,0.58,21,0.027619048,34
3218.475479,56,80,0.72,24,0.03,34
3218.271674,50,83,0.97,33,0.029393939,34
3215.644242,55,81,0.78,26,0.03,34
3215.612478,50,81,0.94,31,0.030322581,34
3215.371496,53,87,0.94,34,0.027647059,34
3214.472414,50,79,0.93,29,0.032068966,34
3213.76626,56,75,0.57,19,0.03,34
3213.76626,55,76,0.63,21,0.03,34
3213.09148,57,79,0.66,22,0.03,34
3212.815778,50,82,0.97,32,0.0303125,34
3212.513945,36,52,0.61,16,0.038125,34
3212.342281,36,53,0.64,17,0.037647059,34
3211.876441,56,72,0.53,16,0.033125,34
3210.840481,57,80,0.68,23,0.029565217,34
3210.840481,56,81,0.74,25,0.0296,34
3210.819285,53,79,0.77,26,0.029615385,34
3210.819285,52,80,0.83,28,0.029642857,34
3210.706306,53,85,0.94,32,0.029375,34
3209.362344,58,69,0.38,11,0.034545455,34
3207.071526,54,84,0.88,30,0.029333333,34
3206.43154,59,81,0.59,22,0.026818182,34
3206.409023,53,78,0.76,25,0.0304,34
3205.962362,51,81,0.91,30,0.030333333,34
3205.606925,33,56,0.89,23,0.038695652,34
3204.357295,50,82,0.96,32,0.03,34
3204.241536,36,52,0.62,16,0.03875,34
3204.241536,35,53,0.7,18,0.038888889,34
3204.241536,34,54,0.78,20,0.039,34
3203.146754,50,82,0.98,32,0.030625,34
3202.562729,51,82,0.91,31,0.029354839,34
3201.303798,50,83,0.98,33,0.02969697,34
3201.279448,52,79,0.82,27,0.03037037,34
3200.859421,52,89,0.99,37,0.026756757,34
3199.353851,58,78,0.6,20,0.03,34
3197.597393,52,81,0.84,29,0.028965517,34
3197.122104,50,77,0.93,27,0.034444444,34
3196.184581,56,75,0.61,19,0.032105263,34
3195.003977,53,88,0.95,35,0.027142857,34
3192.339119,61,70,0.29,9,0.032222222,34
3192.185381,40,49,0.32,9,0.035555556,34
3192.093985,51,81,0.9,30,0.03,34
3191.80833,53,79,0.78,26,0.03,34
3190.935527,36,53,0.66,17,0.038823529,34
3188.335314,58,74,0.51,16,0.031875,34
3186.014139,50,84,0.98,34,0.028823529,34
3185.761567,60,67,0.24,7,0.034285714,34
3185.283437,52,80,0.84,28,0.03,34
3184.756632,59,69,0.33,10,0.033,34
3184.729571,52,90,0.98,38,0.025789474,34
3181.311936,40,48,0.31,8,0.03875,34
3181.180649,58,77,0.53,19,0.027894737,34
3179.261632,35,54,0.74,19,0.038947368,34
3178.289658,59,68,0.31,9,0.034444444,34
3178.205292,38,51,0.47,13,0.036153846,34
3176.896124,33,56,0.9,23,0.039130435,34
3176.896124,32,57,0.98,25,0.0392,34
3176.814406,59,79,0.57,20,0.0285,34
3176.768463,35,53,0.69,18,0.038333333,34
3174.548,61,68,0.23,7,0.032857143,34
3174.196102,53,92,0.94,39,0.024102564,34
3173.314898,54,87,0.88,33,0.026666667,34
3173.314898,53,89,0.95,36,0.026388889,34
3172.62253,55,76,0.68,21,0.032380952,34
3172.153331,34,55,0.8,21,0.038095238,34
3172.153331,33,56,0.88,23,0.03826087,34
3169.028992,56,73,0.56,17,0.032941176,34
3168.716747,57,75,0.57,18,0.031666667,34
3168.471173,37,51,0.53,14,0.037857143,34
3168.30179,37,52,0.56,15,0.037333333,34
3167.788271,58,70,0.4,12,0.033333333,34
3167.45847,55,77,0.64,22,0.029090909,34
3162.712791,63,67,0.13,4,0.0325,34
3162.712791,61,69,0.26,8,0.0325,34
3160.291267,53,88,0.98,35,0.028,34
3159.959908,36,52,0.63,16,0.039375,34
3159.742202,55,86,0.83,31,0.026774194,34
3159.742202,54,87,0.89,33,0.026969697,34
3157.22016,53,80,0.82,27,0.03037037,34
3156.630871,53,75,0.74,22,0.033636364,34
3154.386577,63,69,0.19,6,0.031666667,34
3154.386577,60,72,0.38,12,0.031666667,34
3153.360541,57,72,0.49,15,0.032666667,34
3152.871257,39,48,0.36,9,0.04,34
3152.657924,56,77,0.66,21,0.031428571,34
3151.513809,55,80,0.71,25,0.0284,34
3151.056377,64,70,0.17,6,0.028333333,34
3150.862525,54,77,0.75,23,0.032608696,34
3149.800755,59,74,0.47,15,0.031333333,34
3146.172018,53,78,0.82,25,0.0328,34
3145.566159,54,89,0.88,35,0.025142857,34
3145.566159,53,90,0.93,37,0.025135135,34
3144.220485,56,88,0.77,32,0.0240625,34
3143.410021,53,86,0.95,33,0.028787879,34
3141.519348,54,92,0.98,38,0.025789474,34
3141.087239,54,92,0.88,38,0.023157895,34
3140.55903,56,76,0.64,20,0.032,34
3140.344095,62,72,0.28,10,0.028,34
3140.120883,59,73,0.45,14,0.032142857,34
3139.149558,36,50,0.56,14,0.04,34
3138.96779,54,90,0.89,36,0.024722222,34
3136.268705,53,87,0.96,34,0.028235294,34
3135.586229,35,55,0.71,20,0.0355,34
3135.10835,35,53,0.71,18,0.039444444,34
3135.10835,34,54,0.79,20,0.0395,34
3133.200958,34,55,0.79,21,0.037619048,34
3132.695878,34,54,0.8,20,0.04,34
3132.078196,35,55,0.72,20,0.036,34
3130.883269,53,83,0.85,30,0.028333333,34
3130.883269,52,84,0.91,32,0.0284375,34
3130.597601,37,52,0.57,15,0.038,34
3130.529923,55,75,0.65,20,0.0325,34
3129.961325,54,85,0.89,31,0.028709677,34
3129.207888,52,89,0.97,37,0.026216216,34
3128.780478,55,73,0.6,18,0.033333333,34
3128.695102,53,76,0.76,23,0.033043478,34
3126.461284,61,71,0.32,10,0.032,34
3125.600381,63,68,0.16,5,0.032,34
3125.600381,58,73,0.48,15,0.032,34
3124.987585,62,69,0.23,7,0.032857143,34
3124.987585,57,74,0.56,17,0.032941176,34
3124.5018,46,52,0.22,6,0.036666667,34
3124.057985,65,75,0.27,10,0.027,34
3122.89057,37,50,0.5,13,0.038461538,34
3122.293999,60,71,0.36,11,0.032727273,34
3119.474123,56,78,0.63,22,0.028636364,34
3118.1146,59,71,0.4,12,0.033333333,34
3117.86681,62,68,0.2,6,0.033333333,34
3117.857036,53,89,0.92,36,0.025555556,34
3117.609431,51,86,0.99,35,0.028285714,34
3116.732001,69,74,0.11,5,0.022,34
3115.137498,58,86,0.67,28,0.023928571,34
3115.137498,57,87,0.72,30,0.024,34
3112.677913,56,74,0.6,18,0.033333333,34
3112.293067,54,91,0.88,37,0.023783784,34
3112.293067,53,93,0.94,40,0.0235,34
3112.293067,52,94,0.99,42,0.023571429,34
3112.1901,32,57,0.97,25,0.0388,34
3111.543329,62,77,0.42,15,0.028,34
3111.543329,58,82,0.67,24,0.027916667,34
3111.543329,55,86,0.86,31,0.027741935,34
3111.109483,54,87,0.92,33,0.027878788,34
3109.994357,52,79,0.89,27,0.032962963,34
3109.755185,54,94,0.93,40,0.02325,34
3108.989653,54,89,0.94,35,0.026857143,34
3108.760404,56,85,0.8,29,0.027586207,34
3108.760404,53,89,0.99,36,0.0275,34
3108.559841,54,90,0.95,36,0.026388889,34
3107.144671,63,70,0.2,7,0.028571429,34
3107.099917,60,81,0.56,21,0.026666667,34
3107.091253,67,72,0.14,5,0.028,34
3107.091253,61,79,0.5,18,0.027777778,34
3107.091253,58,83,0.69,25,0.0276,34
3106.743226,60,75,0.42,15,0.028,34
3106.717068,38,50,0.44,12,0.036666667,34
3106.397927,49,76,0.95,27,0.035185185,34
3105.468105,57,77,0.57,20,0.0285,34
3104.792738,39,50,0.41,11,0.037272727,34
3104.398722,54,93,0.92,39,0.023589744,34
3104.203494,56,80,0.67,24,0.027916667,34
3104.203494,55,81,0.73,26,0.028076923,34
3103.879318,55,87,0.88,32,0.0275,34
3103.409472,54,74,0.67,20,0.0335,34
3103.324768,51,78,0.9,27,0.033333333,34
3102.835902,63,78,0.4,15,0.026666667,34
3102.542885,59,72,0.42,13,0.032307692,34
3102.542885,57,74,0.55,17,0.032352941,34
3101.195135,57,79,0.61,22,0.027727273,34
3100.676629,38,51,0.49,13,0.037692308,34
3100.47248,52,83,0.92,31,0.029677419,34
3100.469731,37,49,0.48,12,0.04,34
3100.109248,65,70,0.14,5,0.028,34
3099.633878,32,57,0.96,25,0.0384,34
3099.433591,59,71,0.39,12,0.0325,34
3099.433591,57,73,0.52,16,0.0325,34
3098.804131,52,91,0.99,39,0.025384615,34
3098.407667,51,85,0.99,34,0.029117647,34
3097.934915,54,88,0.92,34,0.027058824,34
3097.497199,35,53,0.72,18,0.04,34
3096.654809,60,81,0.57,21,0.027142857,34
3096.654809,58,83,0.68,25,0.0272,34
3096.54816,52,72,0.71,20,0.0355,34
3096.292282,56,87,0.83,31,0.026774194,34
3096.292282,54,90,0.96,36,0.026666667,34
3095.790887,51,83,0.96,32,0.03,34
3095.589859,39,47,0.32,8,0.04,34
3095.589859,38,48,0.4,10,0.04,34
3094.660566,65,74,0.25,9,0.027777778,34
3094.660566,59,81,0.61,22,0.027727273,34
3092.732569,52,77,0.83,25,0.0332,34
3091.89227,60,80,0.55,20,0.0275,34
3091.832042,51,83,0.97,32,0.0303125,34
3091.633324,58,84,0.71,26,0.027307692,34
3091.633324,56,86,0.82,30,0.027333333,34
3091.633324,54,89,0.95,35,0.027142857,34
3091.553011,58,76,0.54,18,0.03,34
3091.387574,56,87,0.84,31,0.027096774,34
3091.387574,54,90,0.97,36,0.026944444,34
3091.265944,60,72,0.35,12,0.029166667,34
3091.119263,53,85,0.88,32,0.0275,34
3089.369098,53,82,0.85,29,0.029310345,34
3089.247611,53,78,0.81,25,0.0324,34
3089.053734,62,73,0.31,11,0.028181818,34
3089.053734,59,76,0.48,17,0.028235294,34
3088.915514,62,78,0.43,16,0.026875,34
3088.191861,57,84,0.73,27,0.027037037,34
3087.979421,36,51,0.59,15,0.039333333,34
3087.879952,66,72,0.17,6,0.028333333,34
3087.879952,63,75,0.34,12,0.028333333,34
3087.705052,54,78,0.77,24,0.032083333,34
3087.467437,68,72,0.11,4,0.0275,34
3087.467437,66,74,0.22,8,0.0275,34
3087.467437,64,76,0.33,12,0.0275,34
3087.467437,62,78,0.44,16,0.0275,34
3087.467437,59,82,0.63,23,0.027391304,34
3087.467437,57,84,0.74,27,0.027407407,34
3087.467437,56,86,0.81,30,0.027,34
3087.467437,55,87,0.87,32,0.0271875,34
3087.467437,54,88,0.93,34,0.027352941,34
3087.456146,57,75,0.58,18,0.032222222,34
3087.449303,58,81,0.65,23,0.02826087,34
3087.449303,54,86,0.9,32,0.028125,34
3087.439049,61,78,0.48,17,0.028235294,34
3087.439049,57,83,0.73,26,0.028076923,34
3087.274605,52,81,0.88,29,0.030344828,34
3086.805825,56,75,0.62,19,0.032631579,34
3085.351539,55,88,0.82,33,0.024848485,34
3084.492128,60,70,0.33,10,0.033,34
3084.40513,61,81,0.53,20,0.0265,34
3084.40513,59,83,0.64,24,0.026666667,34
3084.40513,58,85,0.71,27,0.026296296,34
3084.40513,57,86,0.77,29,0.026551724,34
3084.40513,55,88,0.88,33,0.026666667,34
3084.40513,55,89,0.9,34,0.026470588,34
3084.006245,64,77,0.35,13,0.026923077,34
3084.006245,62,79,0.46,17,0.027058824,34
3084.006245,60,82,0.59,22,0.026818182,34
3084.006245,58,84,0.7,26,0.026923077,34
3083.867813,59,75,0.48,16,0.03,34
3083.812974,55,82,0.75,27,0.027777778,34
3083.772158,55,87,0.86,32,0.026875,34
3083.183536,64,73,0.26,9,0.028888889,34
3082.723616,35,54,0.68,19,0.035789474,34
3082.507842,36,51,0.58,15,0.038666667,34
3082.328404,38,49,0.42,11,0.038181818,34
3081.276224,51,74,0.81,23,0.035217391,34
3081.276224,50,75,0.88,25,0.0352,34
3081.021343,50,82,0.95,32,0.0296875,34
3080.975072,49,79,0.98,30,0.032666667,34
3080.935773,53,91,0.94,38,0.024736842,34
3080.386855,38,51,0.5,13,0.038461538,34
3078.531825,59,82,0.62,23,0.026956522,34
3077.719659,55,91,0.83,36,0.023055556,34
3077.382643,62,71,0.26,9,0.028888889,34
3076.658783,58,73,0.49,15,0.032666667,34
3076.514272,55,76,0.69,21,0.032857143,34
3076.486841,53,89,0.98,36,0.027222222,34
3074.855226,61,80,0.52,19,0.027368421,34
3074.855226,59,83,0.65,24,0.027083333,34
3074.855226,57,85,0.76,28,0.027142857,34
3074.855226,57,86,0.78,29,0.026896552,34
3074.855226,55,88,0.89,33,0.026969697,34
3074.22445,33,54,0.82,21,0.039047619,34
3073.261952,57,90,0.74,33,0.022424242,34
3073.169855,53,87,0.97,34,0.028529412,34
3073.030331,50,83,0.96,33,0.029090909,34
3072.721813,40,47,0.27,7,0.038571429,34
3072.61898,39,48,0.35,9,0.038888889,34
3072.61898,38,49,0.43,11,0.039090909,34
3072.037842,55,77,0.7,22,0.031818182,34
3071.892586,54,81,0.77,27,0.028518519,34
3070.510505,58,71,0.43,13,0.033076923,34
3070.29603,55,90,0.83,35,0.023714286,34
3070.186932,63,86,0.48,23,0.020869565,34
3069.696969,37,52,0.58,15,0.038666667,34
3069.461658,52,82,0.88,30,0.029333333,34
3069.035837,56,87,0.82,31,0.026451613,34
3068.119877,37,50,0.51,13,0.039230769,34
3067.803261,55,78,0.7,23,0.030434783,34
3067.803261,54,79,0.76,25,0.0304,34
3067.025656,37,51,0.51,14,0.036428571,34
3066.3194,65,76,0.25,11,0.022727273,34
3066.261195,53,71,0.64,18,0.035555556,34
3063.953278,57,82,0.71,25,0.0284,34
3063.520997,35,52,0.67,17,0.039411765,34
3063.420756,65,83,0.38,18,0.021111111,34
3063.286494,62,75,0.38,13,0.029230769,34
3063.286494,58,80,0.64,22,0.029090909,34
3063.286494,57,81,0.7,24,0.029166667,34
3062.904807,54,79,0.74,25,0.0296,34
3062.878934,53,90,0.99,37,0.026756757,34
3061.596721,61,79,0.49,18,0.027222222,34
3061.596721,56,85,0.79,29,0.027241379,34
3061.372002,59,77,0.5,18,0.027777778,34
3061.351396,42,44,0.08,2,0.04,34
3061.351396,41,45,0.16,4,0.04,34
3061.351396,40,46,0.24,6,0.04,34
3061.329668,51,84,0.98,33,0.02969697,34
3061.258304,34,54,0.77,20,0.0385,34
3061.058518,55,68,0.47,13,0.036153846,34
3060.94099,58,72,0.46,14,0.032857143,34
3059.497671,56,81,0.69,25,0.0276,34
3059.044071,34,53,0.74,19,0.038947368,34
3058.957694,54,82,0.79,28,0.028214286,34
3058.725049,53,86,0.89,33,0.026969697,34
3057.672991,57,85,0.75,28,0.026785714,34
3057.609413,61,80,0.51,19,0.026842105,34
3057.398965,56,82,0.71,26,0.027307692,34
3057.213885,63,77,0.38,14,0.027142857,34
3056.394153,53,82,0.88,29,0.030344828,34
3056.376368,59,64,0.18,5,0.036,34
3055.552213,36,52,0.59,16,0.036875,34
3055.417245,54,76,0.72,22,0.032727273,34
3055.072985,54,81,0.78,27,0.028888889,34
3054.661383,40,48,0.3,8,0.0375,34
3054.591889,57,73,0.53,16,0.033125,34
3054.485474,65,81,0.36,16,0.0225,34
3054.460454,57,75,0.55,18,0.030555556,34
3054.460454,56,76,0.61,20,0.0305,34
3054.261704,56,88,0.84,32,0.02625,34
3053.82811,44,55,0.4,11,0.036363636,34
3053.765954,36,54,0.64,18,0.035555556,34
3053.217036,55,83,0.76,28,0.027142857,34
3052.573582,55,86,0.85,31,0.027419355,34
3052.486526,53,82,0.87,29,0.03,34
3052.107241,51,84,0.99,33,0.03,34
3051.516229,65,66,0.03,1,0.03,34
3051.249788,53,80,0.8,27,0.02962963,34
3050.849342,56,74,0.59,18,0.032777778,34
3050.84827,60,80,0.54,20,0.027,34
3050.2935,34,55,0.82,21,0.039047619,34
3049.581504,57,80,0.63,23,0.027391304,34
3049.487717,55,83,0.77,28,0.0275,34
3049.021695,51,82,0.94,31,0.030322581,34
3048.358871,54,88,0.94,34,0.027647059,34
3047.76958,54,84,0.82,30,0.027333333,34
3047.651179,33,54,0.83,21,0.03952381,34
3047.614192,64,84,0.42,20,0.021,34
3047.522915,33,56,0.87,23,0.037826087,34
3047.139696,59,74,0.44,15,0.029333333,34
3047.139696,58,75,0.5,17,0.029411765,34
3047.031028,51,82,0.9,31,0.029032258,34
3046.610838,53,83,0.87,30,0.029,34
3046.610838,52,84,0.93,32,0.0290625,34
3046.560972,55,77,0.67,22,0.030454545,34
3045.814143,61,67,0.2,6,0.033333333,34
3045.543444,63,71,0.23,8,0.02875,34
3045.009035,57,82,0.68,25,0.0272,34
3044.759077,50,79,0.98,29,0.033793103,34
3044.560054,55,89,0.91,34,0.026764706,34
3043.885592,55,87,0.85,32,0.0265625,34
3043.885592,54,88,0.91,34,0.026764706,34
3043.796377,55,84,0.83,29,0.02862069,34
3043.377595,53,87,0.91,34,0.026764706,34
3042.506082,58,72,0.47,14,0.033571429,34
3042.458588,64,67,0.09,3,0.03,34
3042.458588,63,68,0.15,5,0.03,34
3042.458588,54,78,0.72,24,0.03,34
3042.228866,55,89,0.83,34,0.024411765,34
3041.914835,60,74,0.4,14,0.028571429,34
3041.824325,57,77,0.6,20,0.03,34
3041.66188,52,84,0.92,32,0.02875,34
3041.66188,51,85,0.98,34,0.028823529,34
3041.40528,52,93,0.99,41,0.024146341,34
3040.78367,58,80,0.6,22,0.027272727,34
3040.293144,34,56,0.79,22,0.035909091,34
3039.527309,58,83,0.67,25,0.0268,34
3039.527309,58,84,0.69,26,0.026538462,34
3039.527309,57,85,0.74,28,0.026428571,34
3039.527309,56,86,0.8,30,0.026666667,34
3039.527309,55,88,0.87,33,0.026363636,34
3039.527309,54,89,0.92,35,0.026285714,34
3039.527309,54,89,0.93,35,0.026571429,34
3039.527309,53,90,0.97,37,0.026216216,34
3039.527309,53,90,0.98,37,0.026486486,34
3039.527309,53,91,0.99,38,0.026052632,34
3039.194283,54,78,0.73,24,0.030416667,34
3038.772887,54,91,0.87,37,0.023513514,34
3038.209619,50,75,0.89,25,0.0356,34
3038.094633,57,76,0.56,19,0.029473684,34
3038.094633,56,77,0.62,21,0.02952381,34
3038.094633,55,78,0.68,23,0.029565217,34
3038.094633,54,80,0.76,26,0.029230769,34
3038.094633,53,81,0.82,28,0.029285714,34
3038.057295,58,74,0.47,16,0.029375,34
3038.057295,57,75,0.53,18,0.029444444,34
3037.854833,52,91,0.98,39,0.025128205,34
3037.413801,65,81,0.34,16,0.02125,34
3036.539708,41,48,0.25,7,0.035714286,34
3035.657644,60,77,0.5,17,0.029411765,34
3035.657644,59,78,0.56,19,0.029473684,34
3035.620725,55,78,0.69,23,0.03,34
3035.620725,54,79,0.75,25,0.03,34
3035.331893,56,80,0.66,24,0.0275,34
3035.293998,62,70,0.24,8,0.03,34
3035.293998,61,71,0.3,10,0.03,34
3035.260741,38,50,0.45,12,0.0375,34
3033.912213,52,83,0.93,31,0.03,34
3033.10654,58,85,0.72,27,0.026666667,34
3032.410061,54,85,0.84,31,0.027096774,34
3032.244671,57,78,0.62,21,0.02952381,34
3032.105201,55,80,0.75,25,0.03,34
3032.088112,61,76,0.44,15,0.029333333,34
3032.088112,56,82,0.76,26,0.029230769,34
3032.088112,55,83,0.82,28,0.029285714,34
3032.044067,56,82,0.77,26,0.029615385,34
3031.995695,58,81,0.64,23,0.027826087,34
3031.995695,57,82,0.7,25,0.028,34
3031.995695,54,86,0.89,32,0.0278125,34
3031.574064,68,78,0.21,10,0.021,34
3031.51336,63,75,0.33,12,0.0275,34
3030.830353,53,92,0.93,39,0.023846154,34
3030.830353,52,93,0.98,41,0.023902439,34
3030.610822,51,84,0.96,33,0.029090909,34
3030.274238,52,84,0.94,32,0.029375,34
3030.108083,57,84,0.72,27,0.026666667,34
3030.099628,59,80,0.59,21,0.028095238,34
3030.099628,56,84,0.78,28,0.027857143,34
3030.099628,55,85,0.84,30,0.028,34
3030.099628,53,88,0.97,35,0.027714286,34
3030.085038,58,78,0.56,20,0.028,34
3029.35018,64,80,0.35,16,0.021875,34
3029.248227,54,81,0.81,27,0.03,34
3028.841701,56,79,0.69,23,0.03,34
3028.760002,35,52,0.66,17,0.038823529,34
3028.632224,58,77,0.57,19,0.03,34
3028.632224,57,78,0.63,21,0.03,34
3028.586203,54,90,0.87,36,0.024166667,34
3028.553753,51,78,0.91,27,0.033703704,34
3028.40494,55,69,0.5,14,0.035714286,34
3028.229256,61,75,0.39,14,0.027857143,34
3028.160973,55,90,0.91,35,0.026,34
3027.624606,61,73,0.34,12,0.028333333,34
3027.384854,64,83,0.42,19,0.022105263,34
3027.331777,35,51,0.64,16,0.04,34
3027.311005,52,78,0.86,26,0.033076923,34
3027.168739,51,79,0.93,28,0.033214286,34
3027.167752,55,89,0.89,34,0.026176471,34
3027.104788,54,90,0.94,36,0.026111111,34
3026.777304,60,75,0.45,15,0.03,34
3026.777304,59,76,0.51,17,0.03,34
3026.151321,60,77,0.47,17,0.027647059,34
3025.6056,55,89,0.82,34,0.024117647,34
3025.271064,32,57,0.95,25,0.038,34
3025.105427,54,81,0.82,27,0.03037037,34
3024.711365,57,81,0.71,24,0.029583333,34
3024.252066,34,53,0.75,19,0.039473684,34
3024.046073,55,90,0.84,35,0.024,34
3024.026953,59,73,0.41,14,0.029285714,34
3023.290631,53,81,0.84,28,0.03,34
3023.290631,52,82,0.9,30,0.03,34
3022.324721,7,9,0.11,2,0.055,34
3022.23569,37,52,0.55,15,0.036666667,34
3021.901889,60,73,0.38,13,0.029230769,34
3021.852822,35,51,0.65,16,0.040625,34
3021.835489,57,80,0.64,23,0.027826087,34
3021.519066,64,80,0.46,16,0.02875,34
3021.271243,53,81,0.83,28,0.029642857,34
3021.224516,56,70,0.44,14,0.031428571,34
3021.072235,55,80,0.73,25,0.0292,34
3021.072235,54,81,0.79,27,0.029259259,34
3020.385447,52,77,0.79,25,0.0316,34
3020.216647,60,68,0.27,8,0.03375,34
3020.182753,69,75,0.13,6,0.021666667,34
3020.109732,60,78,0.49,18,0.027222222,34
3020.035157,52,83,0.95,31,0.030645161,34
3019.993046,57,81,0.66,24,0.0275,34
3019.974016,32,94,0.14,62,0.002258065,34
3019.789849,55,73,0.61,18,0.033888889,34
3019.438627,56,78,0.64,22,0.029090909,34
3018.977211,55,74,0.63,19,0.033157895,34
3018.835324,57,71,0.47,14,0.033571429,34
3018.835324,54,75,0.7,21,0.033333333,34
3018.835324,53,76,0.77,23,0.033478261,34
3018.580604,60,78,0.53,18,0.029444444,34
3018.29366,55,74,0.65,19,0.034210526,34
3018.037393,62,75,0.36,13,0.027692308,34
3017.808798,56,76,0.6,20,0.03,34
3017.808798,55,77,0.66,22,0.03,34
3017.648977,54,91,0.98,37,0.026486486,34
3017.512741,52,83,0.94,31,0.030322581,34
3017.466251,66,68,0.06,2,0.03,34
3017.466251,65,69,0.12,4,0.03,34
3017.466251,64,70,0.18,6,0.03,34
3016.970155,53,77,0.79,24,0.032916667,34
3016.95946,34,56,0.84,22,0.038181818,34
3016.345721,33,55,0.87,22,0.039545455,34
3016.331255,53,92,0.92,39,0.023589744,34
3015.656151,54,86,0.91,32,0.0284375,34
3015.568035,63,74,0.32,11,0.029090909,34
3014.660718,54,83,0.81,29,0.027931034,34
3014.505416,55,71,0.49,16,0.030625,34
3013.789622,56,79,0.68,23,0.029565217,34
3013.789622,55,80,0.74,25,0.0296,34
3013.645006,60,79,0.53,19,0.027894737,34
3013.538534,59,79,0.55,20,0.0275,34
3013.063709,36,53,0.63,17,0.037058824,34
3012.953544,52,82,0.89,30,0.029666667,34
3012.953544,51,83,0.95,32,0.0296875,34
3012.712399,57,72,0.5,15,0.033333333,34
3012.712399,56,72,0.54,16,0.03375,34
3012.712399,52,77,0.84,25,0.0336,34
3012.65875,41,48,0.26,7,0.037142857,34
3012.634475,58,79,0.58,21,0.027619048,34
3012.566653,34,56,0.78,22,0.035454545,34
3012.533017,53,80,0.81,27,0.03,34
3012.533017,52,81,0.87,29,0.03,34
3012.208695,60,72,0.36,12,0.03,34
3012.208695,59,73,0.42,14,0.03,34
3012.208695,58,74,0.48,16,0.03,34
3012.208695,57,75,0.54,18,0.03,34
3012.190052,58,79,0.62,21,0.02952381,34
3011.741644,42,47,0.19,5,0.038,34
3011.741644,39,50,0.42,11,0.038181818,34
3011.588399,67,77,0.22,10,0.022,34
3011.499271,49,75,0.93,26,0.035769231,34
3011.37753,55,79,0.7,24,0.029166667,34
3011.297834,56,89,0.79,33,0.023939394,34
3010.946914,57,83,0.72,26,0.027692308,34
3010.946914,54,87,0.91,33,0.027575758,34
3010.884277,63,76,0.36,13,0.027692308,34
3010.844109,55,85,0.83,30,0.027666667,34
3010.684318,59,85,0.68,26,0.026153846,34
3010.684318,56,89,0.86,33,0.026060606,34
3010.444801,57,88,0.81,31,0.026129032,34
3010.444801,55,91,0.93,36,0.025833333,34
3010.436169,61,72,0.32,11,0.029090909,34
3009.849722,33,92,0.12,59,0.002033898,34
3008.529994,62,77,0.43,15,0.028666667,34
3008.529994,58,81,0.66,23,0.028695652,34
3008.359965,54,81,0.8,27,0.02962963,34
3008.359965,53,82,0.86,29,0.029655172,34
3008.290642,57,83,0.74,26,0.028461538,34
3008.290642,56,84,0.8,28,0.028571429,34
3007.340346,54,87,0.9,33,0.027272727,34
3006.195185,63,73,0.28,10,0.028,34
3006.193404,54,84,0.89,30,0.029666667,34
3006.193404,53,85,0.95,32,0.0296875,34
3006.107046,52,82,0.91,30,0.030333333,34
3006.053967,52,83,0.9,31,0.029032258,34
3005.930594,33,57,0.92,24,0.038333333,34
3005.409321,56,84,0.79,28,0.028214286,34
3005.086593,66,73,0.19,7,0.027142857,34
3005.086593,64,75,0.3,11,0.027272727,34
3004.969822,32,56,0.92,24,0.038333333,34
3004.844904,65,72,0.2,7,0.028571429,34
3004.665069,60,74,0.41,14,0.029285714,34
3004.665069,59,75,0.47,16,0.029375,34
3004.665069,57,78,0.61,21,0.029047619,34
3004.665069,56,79,0.67,23,0.029130435,34
3004.611522,54,91,0.97,37,0.026216216,34
3004.523436,67,76,0.2,9,0.022222222,34
3004.078634,63,85,0.47,22,0.021363636,34
3003.985806,50,80,0.94,30,0.031333333,34
3003.981703,55,86,0.88,31,0.028387097,34
3003.926163,52,85,0.93,33,0.028181818,34
3003.21945,53,95,0.98,42,0.023333333,34
3003.128531,32,55,0.92,23,0.04,34
3002.535212,64,73,0.25,9,0.027777778,34
3002.514481,40,49,0.34,9,0.037777778,34
3002.180293,62,74,0.35,12,0.029166667,34
3001.929991,60,74,0.42,14,0.03,34
3001.8447,33,57,0.9,24,0.0375,34
3001.74403,58,86,0.74,28,0.026428571,34
3001.505201,56,89,0.87,33,0.026363636,34
3001.505201,55,90,0.92,35,0.026285714,34
3001.505201,54,92,0.99,38,0.026052632,34
3001.153818,55,83,0.83,28,0.029642857,34
3001.104376,57,84,0.75,27,0.027777778,34
3000.776309,53,79,0.79,26,0.030384615,34
3000.628345,61,77,0.44,16,0.0275,34
3000.512752,59,67,0.25,8,0.03125,34
3000.24931,55,93,0.87,38,0.022894737,34
2999.907591,63,81,0.41,18,0.022777778,34
2999.857972,64,74,0.29,10,0.029,34
2999.857972,63,75,0.35,12,0.029166667,34
2999.619288,61,78,0.49,17,0.028823529,34
2999.619288,55,85,0.86,30,0.028666667,34
2999.619288,54,86,0.92,32,0.02875,34
2999.55221,49,76,0.96,27,0.035555556,34
2999.455961,56,83,0.73,27,0.027037037,34
2999.308861,61,83,0.5,22,0.022727273,34
2998.736936,59,69,0.34,10,0.034,34
2998.426072,52,86,0.94,34,0.027647059,34
2998.219852,53,96,0.98,43,0.022790698,34
2997.801721,59,86,0.61,27,0.022592593,34
2997.319077,53,74,0.64,21,0.03047619,34
2996.755036,61,88,0.57,27,0.021111111,34
2996.371929,62,76,0.4,14,0.028571429,34
2996.371929,56,83,0.77,27,0.028518519,34
2996.279095,33,57,0.85,24,0.035416667,34
2995.63187,53,86,0.96,33,0.029090909,34
2995.32237,59,81,0.63,22,0.028636364,34
2995.276771,54,87,0.94,33,0.028484848,34
2994.502141,68,75,0.16,7,0.022857143,34
2994.285513,62,85,0.5,23,0.02173913,34
2994.285513,60,87,0.59,27,0.021851852,34
2994.029655,56,68,0.43,12,0.035833333,34
2993.196758,57,80,0.66,23,0.028695652,34
2992.82369,52,76,0.82,24,0.034166667,34
2991.884758,67,75,0.18,8,0.0225,34
2991.862844,61,86,0.55,25,0.022,34
2991.69983,61,79,0.51,18,0.028333333,34
2991.69983,60,80,0.57,20,0.0285,34
2991.102046,35,54,0.69,19,0.036315789,34
2990.375074,58,77,0.56,19,0.029473684,34
2990.046742,32,56,0.93,24,0.03875,34
2989.54743,53,86,0.9,33,0.027272727,34
2988.228898,54,82,0.81,28,0.028928571,34
2987.943038,67,80,0.28,13,0.021538462,34
2987.57048,59,76,0.47,17,0.027647059,34
2987.510535,60,75,0.43,15,0.028666667,34
2987.510535,56,79,0.66,23,0.028695652,34
2987.510535,55,80,0.72,25,0.0288,34
2987.282079,52,86,0.92,34,0.027058824,34
2987.019266,42,47,0.18,5,0.036,34
2986.815068,55,85,0.85,30,0.028333333,34
2986.706377,55,92,0.86,37,0.023243243,34
2986.499877,56,84,0.77,28,0.0275,34
2985.812267,51,82,0.93,31,0.03,34
2985.362396,60,76,0.45,16,0.028125,34
2985.229988,38,51,0.46,13,0.035384615,34
2985.166204,60,69,0.3,9,0.033333333,34
2984.986246,60,75,0.44,15,0.029333333,34
2984.986246,59,76,0.5,17,0.029411765,34
2984.862488,60,89,0.62,29,0.02137931,34
2984.808367,41,48,0.27,7,0.038571429,34
2984.581515,57,71,0.48,14,0.034285714,34
2984.581515,56,72,0.55,16,0.034375,34
2984.460867,58,82,0.65,24,0.027083333,34
2984.460867,57,83,0.71,26,0.027307692,34
2984.460867,55,86,0.84,31,0.027096774,34
2984.460867,53,89,0.97,36,0.026944444,34
2984.391361,54,83,0.79,29,0.027241379,34
2984.298164,35,89,0.1,54,0.001851852,34
2983.949018,64,72,0.23,8,0.02875,34
2983.933417,60,79,0.56,19,0.029473684,34
2983.883257,54,88,0.96,34,0.028235294,34
2983.64051,52,85,0.95,33,0.028787879,34
2983.248049,54,82,0.8,28,0.028571429,34
2982.53954,33,92,0.14,59,0.002372881,34
2982.044154,55,71,0.5,16,0.03125,34
2981.805289,58,77,0.55,19,0.028947368,34
2981.419649,61,78,0.47,17,0.027647059,34
2981.064462,58,88,0.7,30,0.023333333,34
2981.064462,56,91,0.81,35,0.023142857,34
2980.65751,60,88,0.6,28,0.021428571,34
2980.456111,42,45,0.11,3,0.036666667,34
2979.927501,62,76,0.41,14,0.029285714,34
2979.638569,54,89,0.87,35,0.024857143,34
2979.638569,53,90,0.92,37,0.024864865,34
2979.638569,52,92,0.99,40,0.02475,34
2979.578625,53,84,0.87,31,0.028064516,34
2979.563683,53,91,0.93,38,0.024473684,34
2979.282803,62,72,0.29,10,0.029,34
2979.282803,57,78,0.6,21,0.028571429,34
2979.267812,58,77,0.54,19,0.028421053,34
2979.256678,63,73,0.26,10,0.026,34
2979.064365,63,71,0.24,8,0.03,34
2979.064365,62,72,0.3,10,0.03,34
2979.064365,61,73,0.36,12,0.03,34
2978.81805,62,80,0.48,18,0.026666667,34
2978.744663,55,84,0.79,29,0.027241379,34
2978.744663,54,85,0.85,31,0.027419355,34
2978.309259,56,73,0.58,17,0.034117647,34
2977.85813,33,55,0.88,22,0.04,34
2977.752788,56,81,0.7,25,0.028,34
2977.629096,53,88,0.96,35,0.027428571,34
2977.535054,33,54,0.84,21,0.04,34
2977.402469,59,80,0.6,21,0.028571429,34
2977.402469,58,82,0.68,24,0.028333333,34
2977.273496,58,82,0.69,24,0.02875,34
2977.222644,52,78,0.87,26,0.033461538,34
2977.165514,53,88,0.99,35,0.028285714,34
2977.145386,63,73,0.29,10,0.029,34
2977.017518,60,78,0.52,18,0.028888889,34
2977.017518,59,79,0.58,20,0.029,34
2977.017518,56,83,0.78,27,0.028888889,34
2977.017518,55,84,0.84,29,0.028965517,34
2977.017518,54,85,0.9,31,0.029032258,34
2976.869553,59,76,0.49,17,0.028823529,34
2976.869553,55,81,0.74,26,0.028461538,34
2976.775653,64,80,0.36,16,0.0225,34
2976.673966,35,99,0.19,64,0.00296875,34
2976.421411,60,79,0.55,19,0.028947368,34
2976.421411,59,80,0.61,21,0.029047619,34
2976.361588,58,70,0.41,12,0.034166667,34
2976.068166,54,94,0.92,40,0.023,34
2976.068166,53,95,0.97,42,0.023095238,34
2976.068166,53,96,0.99,43,0.023023256,34
2976.062934,65,82,0.37,17,0.021764706,34
2976.062934,61,87,0.56,26,0.021538462,34
2976.062934,59,89,0.65,30,0.021666667,34
2975.936362,56,82,0.72,26,0.027692308,34
2975.906715,37,52,0.53,15,0.035333333,34
2975.766824,55,91,0.94,36,0.026111111,34
2975.732455,30,71,0.52,41,0.012682927,34
2975.710471,33,54,0.85,21,0.04047619,34
2975.597462,32,55,0.91,23,0.039565217,34
2975.294568,54,90,0.88,36,0.024444444,34
2975.135256,52,86,0.95,34,0.027941176,34
2974.93053,61,77,0.47,16,0.029375,34
2974.705155,62,86,0.51,24,0.02125,34
2974.575589,34,56,0.83,22,0.037727273,34
2974.386615,53,83,0.86,30,0.028666667,34
2974.233551,33,58,0.87,25,0.0348,34
2973.981118,62,73,0.32,11,0.029090909,34
2973.981118,61,74,0.38,13,0.029230769,34
2973.93157,32,93,0.16,61,0.002622951,34
2973.657705,53,76,0.78,23,0.033913043,34
2973.657705,52,77,0.85,25,0.034,34
2973.657705,51,78,0.92,27,0.034074074,34
2973.657705,50,79,0.99,29,0.034137931,34
2973.59276,61,73,0.35,12,0.029166667,34
2973.312053,55,83,0.78,28,0.027857143,34
2973.312053,54,84,0.83,30,0.027666667,34
2973.312053,53,85,0.89,32,0.0278125,34
2973.088836,54,80,0.77,26,0.029615385,34
2972.994236,62,86,0.52,24,0.021666667,34
2972.899724,56,85,0.82,29,0.028275862,34
2972.56347,58,82,0.66,24,0.0275,34
2972.397011,53,96,0.92,43,0.021395349,34
2972.362364,51,79,0.94,28,0.033571429,34
2971.918137,52,79,0.88,27,0.032592593,34
2971.865568,63,84,0.43,21,0.02047619,34
2971.184466,51,80,0.95,29,0.032758621,34
2970.660196,56,88,0.78,32,0.024375,34
2970.531123,47,52,0.18,5,0.036,34
2969.892933,60,88,0.62,28,0.022142857,34
2969.821798,53,77,0.8,24,0.033333333,34
2969.709353,69,73,0.09,4,0.0225,34
2969.641881,54,74,0.68,20,0.034,34
2969.584797,67,74,0.19,7,0.027142857,34
2969.584797,65,76,0.3,11,0.027272727,34
2969.584797,63,78,0.41,15,0.027333333,34
2969.584797,61,81,0.54,20,0.027,34
2969.545825,59,77,0.52,18,0.028888889,34
2969.545825,58,78,0.58,20,0.029,34
2969.131161,57,79,0.64,22,0.029090909,34
2969.060332,56,80,0.69,24,0.02875,34
2969.060332,55,81,0.75,26,0.028846154,34
2968.877022,62,76,0.39,14,0.027857143,34
2968.643465,57,83,0.75,26,0.028846154,34
2968.643465,56,84,0.81,28,0.028928571,34
2968.643465,55,85,0.87,30,0.029,34
2968.464052,64,75,0.31,11,0.028181818,34
2968.155094,63,69,0.18,6,0.03,34
2968.022364,36,51,0.6,15,0.04,34
2968.022364,35,52,0.68,17,0.04,34
2967.977987,56,77,0.63,21,0.03,34
2967.720984,51,73,0.79,22,0.035909091,34
2967.586453,34,55,0.83,21,0.03952381,34
2967.430119,53,84,0.89,31,0.028709677,34
2967.032381,58,81,0.67,23,0.029130435,34
2967.032381,57,82,0.73,25,0.0292,34
2967.032381,56,83,0.79,27,0.029259259,34
2966.925261,54,83,0.82,29,0.028275862,34
2965.838667,55,87,0.9,32,0.028125,34
2965.748347,61,74,0.37,13,0.028461538,34
2965.611485,54,83,0.83,29,0.02862069,34
2965.564449,33,92,0.13,59,0.00220339,34
2965.466888,53,75,0.75,22,0.034090909,34
2965.336828,51,84,0.97,33,0.029393939,34
2965.313785,33,55,0.84,22,0.038181818,34
2965.31268,52,87,0.96,35,0.027428571,34
2965.30789,33,57,0.86,24,0.035833333,34
2965.202659,53,81,0.85,28,0.030357143,34
2965.180624,53,83,0.88,30,0.029333333,34
2965.106925,55,82,0.76,27,0.028148148,34
2965.071292,69,79,0.21,10,0.021,34
2965.071292,68,80,0.25,12,0.020833333,34
2965.071292,65,84,0.39,19,0.020526316,34
2964.982568,54,91,0.89,37,0.024054054,34
2964.813329,62,86,0.48,24,0.02,34
2964.624323,63,77,0.39,14,0.027857143,34
2964.506094,33,55,0.86,22,0.039090909,34
2964.15767,56,85,0.78,29,0.026896552,34
2964.15767,54,88,0.9,34,0.026470588,34
2964.15767,53,89,0.96,36,0.026666667,34
2964.150027,57,79,0.62,22,0.028181818,34
2964.072658,32,58,0.93,26,0.035769231,34
2963.598575,51,83,0.99,32,0.0309375,34
2963.468715,60,85,0.56,25,0.0224,34
2963.407421,54,87,0.93,33,0.028181818,34
2963.264059,59,81,0.6,22,0.027272727,34
2963.036887,53,73,0.63,20,0.0315,34
2962.815163,56,81,0.71,25,0.0284,34
2962.815163,55,82,0.77,27,0.028518519,34
2962.434532,55,75,0.66,20,0.033,34
2962.391468,34,53,0.76,19,0.04,34
2962.384695,56,80,0.7,24,0.029166667,34
2962.384695,55,81,0.76,26,0.029230769,34
2962.384695,54,82,0.82,28,0.029285714,34
2961.562379,33,91,0.12,58,0.002068966,34
2961.5421,66,79,0.28,13,0.021538462,34
2961.240399,62,77,0.41,15,0.027333333,34
2960.902793,36,98,0.14,62,0.002258065,34
2960.498365,54,76,0.74,22,0.033636364,34
2959.834456,38,49,0.44,11,0.04,34
2959.832317,37,50,0.52,13,0.04,34
2959.776776,34,55,0.76,21,0.036190476,34
2959.719654,55,79,0.71,24,0.029583333,34
2958.892656,32,92,0.16,60,0.002666667,34
2958.765959,58,79,0.59,21,0.028095238,34
2958.725046,61,76,0.42,15,0.028,34
2958.136885,53,85,0.9,32,0.028125,34
2957.588206,33,56,0.84,23,0.036521739,34
2957.57885,56,73,0.57,17,0.033529412,34
2957.577855,53,93,0.95,40,0.02375,34
2957.393277,66,73,0.2,7,0.028571429,34
2957.16062,55,74,0.64,19,0.033684211,34
2957.159927,53,84,0.88,31,0.028387097,34
2956.225257,54,76,0.73,22,0.033181818,34
2956.203127,32,94,0.13,62,0.002096774,34
2955.961485,51,79,0.82,28,0.029285714,34
2955.914017,56,91,0.79,35,0.022571429,34
2955.486893,54,84,0.84,30,0.028,34
2953.489906,32,56,0.94,24,0.039166667,34
2953.43225,62,74,0.34,12,0.028333333,34
2953.43225,58,78,0.57,20,0.0285,34
2953.157901,33,57,0.91,24,0.037916667,34
2952.675347,33,85,0.17,52,0.003269231,34
2952.498179,60,81,0.58,21,0.027619048,34
2952.264273,57,84,0.77,27,0.028518519,34
2952.264273,56,85,0.83,29,0.02862069,34
2952.264273,55,86,0.89,31,0.028709677,34
2952.130483,63,83,0.43,20,0.0215,34
2951.769518,57,81,0.67,24,0.027916667,34
2951.19235,51,76,0.88,25,0.0352,34
2951.122409,60,77,0.48,17,0.028235294,34
2951.078824,57,88,0.73,31,0.023548387,34
2950.988626,44,68,0.79,24,0.032916667,34
2950.477689,62,75,0.37,13,0.028461538,34
2949.994181,52,96,0.96,44,0.021818182,34
2949.737127,59,78,0.53,19,0.027894737,34
2949.681713,51,76,0.78,25,0.0312,34
2949.674105,60,83,0.61,23,0.026521739,34
2949.674105,59,84,0.66,25,0.0264,34
2949.467395,60,76,0.46,16,0.02875,34
2949.272807,58,73,0.46,15,0.030666667,34
2949.139572,60,76,0.42,16,0.02625,34
2949.026606,57,80,0.65,23,0.02826087,34
2948.985823,58,80,0.61,22,0.027727273,34
2948.89197,59,80,0.57,21,0.027142857,34
2948.808376,54,91,0.96,37,0.025945946,34
2948.724672,63,84,0.46,21,0.021904762,34
2948.670512,57,77,0.58,20,0.029,34
2948.373472,52,85,0.94,33,0.028484848,34
2948.034318,61,86,0.56,25,0.0224,34
2947.698441,39,50,0.4,11,0.036363636,34
2947.056177,57,84,0.76,27,0.028148148,34
2947.056177,56,86,0.84,30,0.028,34
2947.056177,54,88,0.95,34,0.027941176,34
2947.056177,54,89,0.97,35,0.027714286,34
2946.462711,57,79,0.63,22,0.028636364,34
2946.364444,7,8,0.06,1,0.06,34
2946.110899,65,73,0.22,8,0.0275,34
2946.074413,50,74,0.86,24,0.035833333,34
2945.913133,59,66,0.23,7,0.032857143,34
2945.90043,30,93,0.17,63,0.002698413,34
2945.687516,52,83,0.91,31,0.029354839,34
2945.316988,55,94,0.82,39,0.021025641,34
2945.130945,58,79,0.6,21,0.028571429,34
2945.057379,65,67,0.06,2,0.03,34
2945.057379,64,68,0.12,4,0.03,34
2944.629722,54,91,0.9,37,0.024324324,34
2944.433793,55,84,0.85,29,0.029310345,34
2944.433793,54,85,0.91,31,0.029354839,34
2944.1499,61,75,0.4,14,0.028571429,34
2944.144637,56,91,0.8,35,0.022857143,34
2944.144637,55,92,0.85,37,0.022972973,34
2944.144637,54,94,0.91,40,0.02275,34
2943.857054,69,76,0.15,7,0.021428571,34
2943.617239,34,54,0.76,20,0.038,34
2943.39221,54,76,0.68,22,0.030909091,34
2943.047385,38,50,0.43,12,0.035833333,34
2942.980782,58,68,0.31,10,0.031,34
2942.752412,59,77,0.47,18,0.026111111,34
2942.612065,47,54,0.24,7,0.034285714,34
2942.353306,59,78,0.54,19,0.028421053,34
2941.983257,54,95,0.87,41,0.021219512,34
2941.668524,57,74,0.51,17,0.03,34
2941.572302,59,78,0.49,19,0.025789474,34
2941.563045,69,75,0.17,6,0.028333333,34
2941.402938,50,78,0.97,28,0.034642857,34
2940.933566,54,80,0.78,26,0.03,34
2940.67502,56,88,0.85,32,0.0265625,34
2940.551092,32,93,0.14,61,0.002295082,34
2940.528254,63,79,0.43,16,0.026875,34
2940.528254,59,84,0.67,25,0.0268,34
2940.201977,63,85,0.44,22,0.02,34
2939.948982,58,67,0.32,9,0.035555556,34
2939.804858,34,57,0.8,23,0.034782609,34
2939.745835,70,73,0.07,3,0.023333333,34
2939.745835,67,76,0.21,9,0.023333333,34
2939.745835,64,79,0.35,15,0.023333333,34
2939.494408,59,79,0.59,20,0.0295,34
2939.494408,58,80,0.65,22,0.029545455,34
2939.115453,60,78,0.5,18,0.027777778,34
2939.067662,58,81,0.6,23,0.026086957,34
2938.778471,52,87,0.94,35,0.026857143,34
2938.749917,34,56,0.8,22,0.036363636,34
2938.568036,51,81,0.92,30,0.030666667,34
2938.471027,63,74,0.31,11,0.028181818,34
2938.301561,63,72,0.26,9,0.028888889,34
2938.238614,62,82,0.46,20,0.023,34
2938.213445,52,85,0.9,33,0.027272727,34
2937.020054,55,73,0.56,18,0.031111111,34
2936.677282,57,73,0.49,16,0.030625,34
2936.194562,58,86,0.64,28,0.022857143,34
2936.041641,51,89,0.96,38,0.025263158,34
2935.74017,56,80,0.68,24,0.028333333,34
2935.049995,55,86,0.87,31,0.028064516,34
2934.746012,33,55,0.85,22,0.038636364,34
2934.638178,74,76,0.04,2,0.02,34
2934.638178,73,77,0.08,4,0.02,34
2934.638178,72,78,0.12,6,0.02,34
2934.638178,71,79,0.16,8,0.02,34
2934.638178,70,80,0.2,10,0.02,34
2934.638178,69,81,0.24,12,0.02,34
2934.638178,68,82,0.28,14,0.02,34
2934.638178,67,83,0.32,16,0.02,34
2934.515952,60,88,0.57,28,0.020357143,34
2934.181143,33,57,0.93,24,0.03875,34
2934.12628,59,71,0.37,12,0.030833333,34
2934.054717,32,58,0.94,26,0.036153846,34
2933.940324,59,77,0.51,18,0.028333333,34
2933.660936,52,88,0.96,36,0.026666667,34
2933.589399,35,88,0.11,53,0.002075472,34
2933.575172,54,70,0.57,16,0.035625,34
2933.300896,62,85,0.47,23,0.020434783,34
2933.2965,63,76,0.37,13,0.028461538,34
2932.358898,55,93,0.86,38,0.022631579,34
2932.172865,58,89,0.65,31,0.020967742,34
2931.265928,61,84,0.51,23,0.022173913,34
2930.890578,60,84,0.54,24,0.0225,34
2930.472046,61,75,0.41,14,0.029285714,34
2930.022024,54,95,0.94,41,0.022926829,34
2929.984755,32,93,0.15,61,0.002459016,34
2929.843453,62,76,0.34,14,0.024285714,34
2929.843453,61,77,0.39,16,0.024375,34
2929.843453,60,78,0.44,18,0.024444444,34
2929.843453,59,79,0.49,20,0.0245,34
2929.450221,59,85,0.59,26,0.022692308,34
2929.220395,65,77,0.32,12,0.026666667,34
2928.885339,34,52,0.73,18,0.040555556,34
2928.822901,61,78,0.46,17,0.027058824,34
2928.577516,55,75,0.67,20,0.0335,34
2928.419639,65,79,0.31,14,0.022142857,34
2928.296319,32,56,0.95,24,0.039583333,34
2928.086523,52,74,0.72,22,0.032727273,34
2927.918821,53,94,0.95,41,0.023170732,34
2927.695845,50,81,0.96,31,0.030967742,34
2927.281197,56,89,0.78,33,0.023636364,34
2925.821526,63,65,0.06,2,0.03,34
2925.821526,62,66,0.12,4,0.03,34
2925.821526,61,67,0.18,6,0.03,34
2925.531501,58,91,0.72,33,0.021818182,34
2925.531501,57,93,0.78,36,0.021666667,34
2925.355462,56,78,0.66,22,0.03,34
2925.355462,55,79,0.72,24,0.03,34
2925.351607,59,77,0.48,18,0.026666667,34
2925.293879,49,78,0.91,29,0.03137931,34
2925.042656,62,82,0.45,20,0.0225,34
2924.767624,64,71,0.2,7,0.028571429,34
2924.613071,54,84,0.81,30,0.027,34
2924.61139,65,77,0.27,12,0.0225,34
2924.567667,30,94,0.17,64,0.00265625,34
2924.357189,56,81,0.65,25,0.026,34
2924.216237,58,73,0.45,15,0.03,34
2924.040402,34,56,0.82,22,0.037272727,34
2923.245281,53,94,0.97,41,0.023658537,34
2922.543707,50,77,0.95,27,0.035185185,34
2922.452387,55,85,0.78,30,0.026,34
2922.383453,53,82,0.84,29,0.028965517,34
2922.180585,52,82,0.93,30,0.031,34
2922.022091,51,78,0.84,27,0.031111111,34
2921.614137,59,87,0.62,28,0.022142857,34
2921.246575,57,82,0.72,25,0.0288,34
2921.149254,33,58,0.92,25,0.0368,34
2920.961317,23,91,0.71,68,0.010441176,34
2920.223165,59,66,0.24,7,0.034285714,34
2920.151411,63,82,0.4,19,0.021052632,34
2919.663621,57,92,0.78,35,0.022285714,34
2919.100733,63,66,0.1,3,0.033333333,34
2918.850112,58,83,0.7,25,0.028,34
2918.850112,56,86,0.83,30,0.027666667,34
2918.850112,55,87,0.89,32,0.0278125,34
2918.850112,55,88,0.91,33,0.027575758,34
2918.850112,54,89,0.96,35,0.027428571,34
2918.738659,57,74,0.52,17,0.030588235,34
2918.282786,59,88,0.65,29,0.022413793,34
2917.819217,33,93,0.13,60,0.002166667,34
2917.639141,55,82,0.7,27,0.025925926,34
2917.328657,59,86,0.63,27,0.023333333,34
2917.29969,61,74,0.35,13,0.026923077,34
2917.293363,63,70,0.21,7,0.03,34
2917.293363,62,71,0.27,9,0.03,34
2917.293363,61,72,0.33,11,0.03,34
2916.851423,58,79,0.54,21,0.025714286,34
2916.426382,35,88,0.1,53,0.001886792,34
2915.836596,51,79,0.87,28,0.031071429,34
2915.823871,30,71,0.53,41,0.012926829,34
2915.819964,62,67,0.17,5,0.034,34
2915.692437,56,90,0.77,34,0.022647059,34
2915.524463,62,69,0.21,7,0.03,34
2915.524463,61,70,0.27,9,0.03,34
2915.524463,60,71,0.33,11,0.03,34
2915.524463,59,72,0.39,13,0.03,34
2915.523309,55,83,0.72,28,0.025714286,34
2915.268476,72,75,0.06,3,0.02,34
2915.268476,71,76,0.1,5,0.02,34
2915.062776,57,81,0.61,24,0.025416667,34
2914.767221,59,89,0.67,30,0.022333333,34
2914.767221,58,91,0.73,33,0.022121212,34
2914.751205,58,76,0.53,18,0.029444444,34
2914.751205,57,77,0.59,20,0.0295,34
2914.751205,56,78,0.65,22,0.029545455,34
2914.471267,32,55,0.93,23,0.040434783,34
2914.400327,53,86,0.97,33,0.029393939,34
2914.129876,61,82,0.56,21,0.026666667,34
2913.954709,61,85,0.5,24,0.020833333,34
2913.897794,57,87,0.8,30,0.026666667,34
2913.735449,56,82,0.67,26,0.025769231,34
2913.576277,59,70,0.37,11,0.033636364,34
2913.474018,56,81,0.68,25,0.0272,34
2913.396441,35,99,0.21,64,0.00328125,34
2913.083347,57,92,0.77,35,0.022,34
2913.078471,6,10,0.21,4,0.0525,34
2913.011011,35,99,0.15,64,0.00234375,34
2912.905781,44,57,0.45,13,0.034615385,34
2912.680814,59,69,0.3,10,0.03,34
2912.608266,61,84,0.52,23,0.022608696,34
2911.897134,54,92,0.91,38,0.023947368,34
2911.405906,57,68,0.39,11,0.035454545,34
2911.405906,51,75,0.85,24,0.035416667,34
2911.405906,50,76,0.92,26,0.035384615,34
2911.051785,37,50,0.49,13,0.037692308,34
2911.033416,55,94,0.87,39,0.022307692,34
2910.946486,61,77,0.46,16,0.02875,34
2910.349331,36,55,0.7,19,0.036842105,34
2910.285444,64,84,0.4,20,0.02,34
2910.111387,61,82,0.48,21,0.022857143,34
2910.06658,61,74,0.39,13,0.03,34
2910.027779,66,67,0.03,1,0.03,34
2910.027779,65,68,0.09,3,0.03,34
2910.027779,64,69,0.15,5,0.03,34
2909.989784,68,70,0.05,2,0.025,34
2909.256471,56,94,0.84,38,0.022105263,34
2909.085404,65,71,0.17,6,0.028333333,34
2909.004278,56,82,0.66,26,0.025384615,34
2908.824884,53,86,0.84,33,0.025454545,34
2908.679688,54,96,0.95,42,0.022619048,34
2908.590585,60,68,0.24,8,0.03,34
2908.347748,49,77,0.99,28,0.035357143,34
2908.260265,52,88,0.9,36,0.025,34
2908.048416,54,77,0.7,23,0.030434783,34
2908.019363,54,75,0.71,21,0.033809524,34
2907.997733,58,88,0.68,30,0.022666667,34
2907.808536,66,82,0.33,16,0.020625,34
2907.139476,52,74,0.69,22,0.031363636,34
2906.58244,54,92,0.9,38,0.023684211,34
2905.958379,52,87,0.89,35,0.025428571,34
2905.790593,53,73,0.65,20,0.0325,34
2905.297126,69,77,0.17,8,0.02125,34
2905.201661,58,80,0.54,22,0.024545455,34
2903.988754,59,89,0.66,30,0.022,34
2903.985646,59,80,0.62,21,0.02952381,34
2903.985646,58,81,0.68,23,0.029565217,34
2903.969453,47,55,0.27,8,0.03375,34
2903.94058,61,85,0.54,24,0.0225,34
2903.63626,61,87,0.57,26,0.021923077,34
2903.576092,57,77,0.62,20,0.031,34
2903.576092,56,78,0.68,22,0.030909091,34
2903.576092,53,82,0.89,29,0.030689655,34
2903.371435,63,76,0.31,13,0.023846154,34
2902.976663,67,74,0.16,7,0.022857143,34
2902.922332,60,79,0.54,19,0.028421053,34
2902.903125,67,71,0.11,4,0.0275,34
2902.87399,57,82,0.74,25,0.0296,34
2902.87399,56,83,0.8,27,0.02962963,34
2902.65135,58,81,0.56,23,0.024347826,34
2902.498323,36,98,0.17,62,0.002741935,34
2902.474306,64,75,0.32,11,0.029090909,34
2902.258755,58,70,0.35,12,0.029166667,34
2902.183933,67,80,0.26,13,0.02,34
2902.183933,66,81,0.3,15,0.02,34
2901.670202,58,86,0.73,28,0.026071429,34
2901.670202,57,87,0.79,30,0.026333333,34
2901.140486,55,90,0.93,35,0.026571429,34
2901.084407,54,71,0.61,17,0.035882353,34
2900.774883,55,91,0.84,36,0.023333333,34
2900.76815,59,69,0.31,10,0.031,34
2900.507796,58,90,0.71,32,0.0221875,34
2900.335575,46,65,0.63,19,0.033157895,34
2900.14508,67,68,0.03,1,0.03,34
2900.14508,66,69,0.09,3,0.03,34
2900.14508,65,70,0.15,5,0.03,34
2900.14508,64,71,0.21,7,0.03,34
2900.14508,63,72,0.27,9,0.03,34
2899.502897,53,76,0.71,23,0.030869565,34
2898.944207,64,75,0.26,11,0.023636364,34
2898.742303,53,83,0.81,30,0.027,34
2898.741417,52,85,0.99,33,0.03,34
2898.684781,57,68,0.36,11,0.032727273,34
2898.576398,63,81,0.52,18,0.028888889,34
2898.213472,59,76,0.46,17,0.027058824,34
2898.213472,57,79,0.59,22,0.026818182,34
2898.201031,55,81,0.7,26,0.026923077,34
2897.977691,71,96,0.43,25,0.0172,34
2897.947,54,85,0.78,31,0.02516129,34
2897.803963,58,87,0.66,29,0.022758621,34
2897.762184,56,83,0.71,27,0.026296296,34
2897.737637,54,84,0.77,30,0.025666667,34
2897.585435,62,73,0.33,11,0.03,34
2897.233727,51,76,0.77,25,0.0308,34
2896.926769,60,87,0.56,27,0.020740741,34
2896.923027,61,63,0.07,2,0.035,34
2896.923027,60,64,0.14,4,0.035,34
2896.687546,29,95,0.18,66,0.002727273,34
2896.109982,55,84,0.77,29,0.026551724,34
2896.109982,54,85,0.82,31,0.026451613,34
2896.109982,53,86,0.88,33,0.026666667,34
2895.977433,53,75,0.71,22,0.032272727,34
2895.893945,56,81,0.66,25,0.0264,34
2895.890541,58,71,0.44,13,0.033846154,34
2895.861256,63,83,0.45,20,0.0225,34
2895.8437,55,85,0.88,30,0.029333333,34
2895.8437,54,86,0.94,32,0.029375,34
2895.324456,60,87,0.6,27,0.022222222,34
2895.145418,33,56,0.91,23,0.039565217,34
2894.960412,53,76,0.69,23,0.03,34
2894.848876,57,83,0.67,26,0.025769231,34
2894.678307,37,53,0.57,16,0.035625,34
2894.643719,35,54,0.75,19,0.039473684,34
2894.454113,50,77,0.84,27,0.031111111,34
2894.34174,54,86,0.84,32,0.02625,34
2894.34174,53,87,0.9,34,0.026470588,34
2894.165284,62,79,0.48,17,0.028235294,34
2894.165284,59,82,0.65,23,0.02826087,34
2894.165284,58,83,0.71,25,0.0284,34
2894.165284,58,84,0.73,26,0.028076923,34
2894.074218,66,82,0.34,16,0.02125,34
2893.677065,52,77,0.75,25,0.03,34
2893.590151,54,75,0.63,21,0.03,34
2893.550229,65,74,0.22,9,0.024444444,34
2892.811099,58,72,0.43,14,0.030714286,34
2892.689056,65,74,0.26,9,0.028888889,34
2892.244648,66,71,0.14,5,0.028,34
2891.969218,46,55,0.31,9,0.034444444,34
2891.969218,45,56,0.38,11,0.034545455,34
2891.804421,60,66,0.21,6,0.035,34
2891.804421,59,67,0.28,8,0.035,34
2891.804421,58,68,0.35,10,0.035,34
2891.525315,58,77,0.52,19,0.027368421,34
2891.168017,35,55,0.76,20,0.038,34
2891.100138,62,85,0.51,23,0.022173913,34
2891.052399,52,79,0.83,27,0.030740741,34
2891.045323,52,75,0.71,23,0.030869565,34
2890.896158,32,56,0.96,24,0.04,34
2890.527759,56,85,0.74,29,0.025517241,34
2890.304855,69,78,0.18,9,0.02,34
2890.304855,68,79,0.22,11,0.02,34
2890.091967,62,74,0.31,12,0.025833333,34
2890.04038,58,92,0.73,34,0.021470588,34
2889.943579,68,76,0.17,8,0.02125,34
2889.848019,55,74,0.57,19,0.03,34
2889.496164,56,75,0.58,19,0.030526316,34
2889.443551,55,82,0.72,27,0.026666667,34
2889.18663,64,76,0.34,12,0.028333333,34
2889.072027,54,72,0.58,18,0.032222222,34
2888.41532,52,92,0.98,40,0.0245,34
2888.275398,32,92,0.17,60,0.002833333,34
2888.185628,54,72,0.64,18,0.035555556,34
2888.185628,53,73,0.71,20,0.0355,34
2887.955543,52,75,0.81,23,0.035217391,34
2887.824127,65,79,0.4,14,0.028571429,34
2887.682635,54,90,0.98,36,0.027222222,34
2887.569194,59,65,0.2,6,0.033333333,34
2887.35747,64,80,0.34,16,0.02125,34
2887.353283,68,79,0.23,11,0.020909091,34
2887.091702,65,76,0.31,11,0.028181818,34
2887.079444,60,73,0.39,13,0.03,34
2886.831396,37,51,0.56,14,0.04,34
2885.850561,53,87,0.98,34,0.028823529,34
2885.812311,63,77,0.4,14,0.028571429,34
2885.779059,59,75,0.46,16,0.02875,34
2885.677407,58,87,0.68,29,0.023448276,34
2885.351925,62,78,0.45,16,0.028125,34
2885.351925,60,80,0.56,20,0.028,34
2885.351925,59,81,0.62,22,0.028181818,34
2885.351925,56,85,0.81,29,0.027931034,34
2884.948373,54,86,0.93,32,0.0290625,34
2884.948373,54,87,0.95,33,0.028787879,34
2884.895006,55,84,0.73,29,0.025172414,34
2884.774963,54,83,0.77,29,0.026551724,34
2884.774963,53,84,0.83,31,0.026774194,34
2883.857434,32,57,0.99,25,0.0396,34
2883.604836,34,91,0.11,57,0.001929825,34
2883.386555,58,76,0.52,18,0.028888889,34
2883.38123,53,87,0.99,34,0.029117647,34
2882.898515,59,88,0.64,29,0.022068966,34
2882.60961,50,77,0.94,27,0.034814815,34
2882.575998,67,81,0.3,14,0.021428571,34
2882.54116,65,79,0.3,14,0.021428571,34
2882.265897,55,70,0.49,15,0.032666667,34
2882.030338,54,92,0.89,38,0.023421053,34
2882.022783,52,78,0.81,26,0.031153846,34
2881.975848,68,75,0.15,7,0.021428571,34
2881.602292,54,83,0.78,29,0.026896552,34
2881.541179,64,71,0.19,7,0.027142857,34
2881.472621,57,87,0.82,30,0.027333333,34
2881.472621,56,88,0.88,32,0.0275,34
2881.320527,38,52,0.5,14,0.035714286,34
2881.217004,56,73,0.51,17,0.03,34
2881.159789,59,78,0.51,19,0.026842105,34
2881.023872,58,90,0.66,32,0.020625,34
2880.94567,57,79,0.6,22,0.027272727,34
2880.848203,57,91,0.75,34,0.022058824,34
2880.732994,54,70,0.53,16,0.033125,34
2880.216315,58,70,0.37,12,0.030833333,34
2879.853084,54,87,0.96,33,0.029090909,34
2879.775364,52,73,0.69,21,0.032857143,34
2879.725266,59,69,0.32,10,0.032,34
2879.709635,33,91,0.11,58,0.001896552,34
2879.678785,57,76,0.57,19,0.03,34
2879.540546,6,10,0.22,4,0.055,34
2879.35177,53,84,0.84,31,0.027096774,34
2879.310938,33,93,0.12,60,0.002,34
2879.257667,51,87,0.96,36,0.026666667,34
2879.219797,57,81,0.64,24,0.026666667,34
2879.017822,58,86,0.75,28,0.026785714,34
2878.866162,66,83,0.35,17,0.020588235,34
2878.776004,37,51,0.52,14,0.037142857,34
2878.544566,35,99,0.17,64,0.00265625,34
2878.499338,59,84,0.7,25,0.028,34
2878.419556,70,77,0.14,7,0.02,34
2878.271132,76,90,0.25,14,0.017857143,34
2878.122275,55,91,0.85,36,0.023611111,34
2878.122275,53,94,0.96,41,0.023414634,34
2877.721235,60,75,0.41,15,0.027333333,34
2877.174434,59,66,0.25,7,0.035714286,34
2876.98398,55,83,0.75,28,0.026785714,34
2876.826779,66,74,0.23,8,0.02875,34
2876.813153,70,78,0.17,8,0.02125,34
2876.813153,62,87,0.53,25,0.0212,34
2876.648013,51,75,0.78,24,0.0325,34
2876.648013,50,76,0.85,26,0.032692308,34
2876.516281,61,80,0.44,19,0.023157895,34
2876.285604,58,89,0.69,31,0.022258065,34
2876.243949,52,85,0.86,33,0.026060606,34
2876.243949,51,87,0.93,36,0.025833333,34
2876.200682,66,77,0.25,11,0.022727273,34
2875.988139,55,81,0.71,26,0.027307692,34
2875.821893,60,81,0.59,21,0.028095238,34
2875.802501,38,52,0.48,14,0.034285714,34
2875.737666,44,56,0.43,12,0.035833333,34
2875.593824,36,52,0.64,16,0.04,34
2874.816381,65,83,0.39,18,0.021666667,34
2874.670336,57,72,0.51,15,0.034,34
2874.489679,54,82,0.76,28,0.027142857,34
2874.434486,57,88,0.71,31,0.022903226,34
2874.049214,73,94,0.36,21,0.017142857,34
2874.048946,75,92,0.29,17,0.017058824,34
2873.927468,33,57,0.95,24,0.039583333,34
2873.829831,33,57,0.94,24,0.039166667,34
2873.818465,57,86,0.72,29,0.024827586,34
2873.761888,77,89,0.21,12,0.0175,34
2873.736332,62,80,0.5,18,0.027777778,34
2873.723644,71,96,0.44,25,0.0176,34
2873.539447,59,82,0.64,23,0.027826087,34
2873.329752,52,88,0.91,36,0.025277778,34
2873.310489,57,85,0.77,28,0.0275,34
2872.558246,55,71,0.57,16,0.035625,34
2872.508324,64,85,0.44,21,0.020952381,34
2872.450205,57,90,0.7,33,0.021212121,34
2872.369691,56,90,0.79,34,0.023235294,34
2872.369691,54,93,0.9,39,0.023076923,34
2872.244525,53,83,0.82,30,0.027333333,34
2872.089804,63,74,0.28,11,0.025454545,34
2872.008058,54,85,0.79,31,0.025483871,34
2871.546161,60,89,0.63,29,0.021724138,34
2871.54555,64,72,0.21,8,0.02625,34
2871.326593,56,81,0.64,25,0.0256,34
2871.280643,57,80,0.62,23,0.026956522,34
2871.279409,49,77,0.97,28,0.034642857,34
2871.101268,64,84,0.43,20,0.0215,34
2871.048592,61,65,0.14,4,0.035,34
2870.773244,59,77,0.49,18,0.027222222,34
2870.734002,55,88,0.9,33,0.027272727,34
2870.610935,56,70,0.43,14,0.030714286,34
2870.28117,33,91,0.15,58,0.002586207,34
2870.280913,60,85,0.58,25,0.0232,34
2869.879793,61,78,0.5,17,0.029411765,34
2869.794159,64,77,0.37,13,0.028461538,34
2869.778169,62,77,0.36,15,0.024,34
2869.435956,36,98,0.16,62,0.002580645,34
2869.34856,66,81,0.33,15,0.022,34
2869.34856,63,85,0.48,22,0.021818182,34
2869.015912,54,88,0.97,34,0.028529412,34
2868.959398,54,71,0.56,17,0.032941176,34
2868.813383,56,84,0.82,28,0.029285714,34
2868.800301,53,88,0.92,35,0.026285714,34
2868.78743,54,87,0.87,33,0.026363636,34
2868.672615,55,76,0.64,21,0.03047619,34
2868.598322,40,50,0.48,10,0.048,34
2868.445419,51,74,0.76,23,0.033043478,34
2868.258318,56,69,0.46,13,0.035384615,34
2868.102797,62,86,0.53,24,0.022083333,34
2867.828651,59,90,0.67,31,0.021612903,34
2867.759416,56,93,0.82,37,0.022162162,34
2867.068859,52,72,0.7,20,0.035,34
2866.740696,70,97,0.48,27,0.017777778,34
2866.739361,63,78,0.34,15,0.022666667,34
2866.715974,59,74,0.45,15,0.03,34
2866.715974,58,75,0.51,17,0.03,34
2866.338404,56,90,0.8,34,0.023529412,34
2866.338404,54,93,0.91,39,0.023333333,34
2866.240268,57,67,0.36,10,0.036,34
2866.213183,68,79,0.24,11,0.021818182,34
2866.010693,49,51,0.07,2,0.035,34
2866.010693,48,52,0.14,4,0.035,34
2866.010693,47,53,0.21,6,0.035,34
2865.971797,36,97,0.18,61,0.00295082,34
2865.65917,64,75,0.27,11,0.024545455,34
2865.424973,60,65,0.17,5,0.034,34
2865.182827,57,71,0.41,14,0.029285714,34
2865.090199,52,86,0.9,34,0.026470588,34
2864.962658,61,78,0.41,17,0.024117647,34
2864.962658,60,79,0.46,19,0.024210526,34
2864.962658,59,80,0.51,21,0.024285714,34
2864.861422,52,75,0.8,23,0.034782609,34
2864.861422,51,76,0.87,25,0.0348,34
2864.758171,72,93,0.37,21,0.017619048,34
2864.710923,57,85,0.71,28,0.025357143,34
2864.363324,59,82,0.66,23,0.028695652,34
2864.318579,60,76,0.48,16,0.03,34
2864.236666,30,71,0.54,41,0.013170732,34
2864.198448,55,81,0.79,26,0.030384615,34
2864.198448,54,83,0.87,29,0.03,34
2864.198448,53,84,0.93,31,0.03,34
2864.165889,34,89,0.12,55,0.002181818,34
2864.118676,60,75,0.46,15,0.030666667,34
2864.083831,57,91,0.76,34,0.022352941,34
2863.780955,53,72,0.63,19,0.033157895,34
2863.673687,33,68,0.39,35,0.011142857,34
2863.466177,62,78,0.46,16,0.02875,34
2863.426443,61,73,0.37,12,0.030833333,34
2863.426443,57,78,0.64,21,0.03047619,34
2863.426443,56,79,0.7,23,0.030434783,34
2863.426443,55,80,0.76,25,0.0304,34
2863.426443,54,81,0.83,27,0.030740741,34
2863.426443,53,83,0.91,30,0.030333333,34
2863.426443,52,84,0.97,32,0.0303125,34
2863.03126,52,80,0.85,28,0.030357143,34
2862.926748,65,75,0.29,10,0.029,34
2862.926748,64,76,0.35,12,0.029166667,34
2862.926748,63,76,0.38,13,0.029230769,34
2862.926748,62,77,0.44,15,0.029333333,34
2862.926748,60,80,0.58,20,0.029,34
2862.926748,59,81,0.64,22,0.029090909,34
2862.765823,70,97,0.47,27,0.017407407,34
2862.757943,57,78,0.58,21,0.027619048,34
2862.409526,60,77,0.44,17,0.025882353,34
2862.022059,33,58,0.94,25,0.0376,34
2861.722874,7,11,0.18,4,0.045,34
2861.669471,58,77,0.58,19,0.030526316,34
2861.669471,54,82,0.85,28,0.030357143,34
2861.411025,58,80,0.56,22,0.025454545,34
2861.379294,55,94,0.88,39,0.022564103,34
2861.379294,54,96,0.94,42,0.022380952,34
2861.243883,57,67,0.35,10,0.035,34
2861.243883,56,68,0.42,12,0.035,34
2861.243883,55,69,0.49,14,0.035,34
2861.243883,54,70,0.56,16,0.035,34
2861.243883,53,71,0.63,18,0.035,34
2861.22909,41,60,0.67,19,0.035263158,34
2861.169791,51,86,0.94,35,0.026857143,34
2860.908199,35,55,0.75,20,0.0375,34
2860.569197,61,84,0.49,23,0.021304348,34
2860.373391,52,89,0.98,37,0.026486486,34
2860.198276,56,80,0.64,24,0.026666667,34
2860.140351,61,81,0.56,20,0.028,34
2860.128575,52,74,0.78,22,0.035454545,34
2859.992691,57,69,0.37,12,0.030833333,34
2859.79155,54,95,0.93,41,0.022682927,34
2859.755043,50,80,0.89,30,0.029666667,34
2859.559876,43,57,0.5,14,0.035714286,34
2859.553848,61,79,0.52,18,0.028888889,34
2859.517052,35,99,0.18,64,0.0028125,34
2859.406687,53,87,0.89,34,0.026176471,34
2859.320122,59,90,0.68,31,0.021935484,34
2859.314408,57,85,0.79,28,0.028214286,34
2859.314408,56,86,0.85,30,0.028333333,34
2859.201553,55,82,0.69,27,0.025555556,34
2859.150383,64,73,0.23,9,0.025555556,34
2859.003561,52,85,0.89,33,0.026969697,34
2858.783989,76,90,0.24,14,0.017142857,34
2858.781146,56,90,0.78,34,0.022941176,34
2858.761385,63,81,0.47,18,0.026111111,34
2858.761385,60,84,0.63,24,0.02625,34
2858.761385,59,86,0.7,27,0.025925926,34
2858.761385,58,87,0.75,29,0.025862069,34
2858.704759,58,90,0.7,32,0.021875,34
2858.701685,35,54,0.93,19,0.048947368,34
2858.528069,58,88,0.69,30,0.023,34
2858.528069,57,89,0.74,32,0.023125,34
2858.509547,53,93,0.96,40,0.024,34
2858.390495,58,78,0.52,20,0.026,34
2858.390495,57,80,0.59,23,0.025652174,34
2858.181433,51,75,0.84,24,0.035,34
2857.69174,64,77,0.3,13,0.023076923,34
2857.49274,61,82,0.49,21,0.023333333,34
2857.399524,56,68,0.4,12,0.033333333,34
2857.360148,62,80,0.51,18,0.028333333,34
2857.360148,59,83,0.68,24,0.028333333,34
2856.977613,36,51,0.55,15,0.036666667,34
2856.431792,65,81,0.33,16,0.020625,34
2856.373081,65,73,0.23,8,0.02875,34
2855.926966,62,79,0.49,17,0.028823529,34
2855.664059,32,91,0.17,59,0.002881356,34
2855.420713,50,76,0.91,26,0.035,34
2854.429204,53,96,0.91,43,0.021162791,34
2854.410544,65,75,0.23,10,0.023,34
2854.370465,49,77,0.92,28,0.032857143,34
2854.168236,55,90,0.95,35,0.027142857,34
2853.983466,57,89,0.73,32,0.0228125,34
2853.983466,55,92,0.84,37,0.022702703,34
2853.7502,55,72,0.6,17,0.035294118,34
2853.7502,54,73,0.67,19,0.035263158,34
2853.370289,66,76,0.22,10,0.022,34
2853.140871,57,67,0.33,10,0.033,34
2852.967044,57,83,0.76,26,0.029230769,34
2852.967044,55,86,0.9,31,0.029032258,34
2852.795094,55,69,0.47,14,0.033571429,34
2852.79478,55,73,0.58,18,0.032222222,34
2852.626469,57,71,0.45,14,0.032142857,34
2852.562383,59,83,0.67,24,0.027916667,34
2852.562034,63,78,0.43,15,0.028666667,34
2852.562034,61,81,0.57,20,0.0285,34
2852.534655,62,83,0.46,21,0.021904762,34
2852.020795,34,55,0.77,21,0.036666667,34
2851.907494,59,76,0.52,17,0.030588235,34
2851.907494,59,77,0.54,18,0.03,34
2851.861958,51,75,0.79,24,0.032916667,34
2851.69753,53,74,0.73,21,0.034761905,34
2851.680202,56,80,0.73,24,0.030416667,34
2851.619895,63,81,0.4,18,0.022222222,34
2851.500725,63,71,0.25,8,0.03125,34
2851.360639,36,54,0.63,18,0.035,34
2851.314008,55,90,0.94,35,0.026857143,34
2851.305088,51,90,0.98,39,0.025128205,34
2851.252655,51,82,0.95,31,0.030645161,34
2850.941494,59,64,0.17,5,0.034,34
2850.930015,55,88,0.92,33,0.027878788,34
2850.701304,81,99,0.07,18,0.003888889,34
2850.687489,58,67,0.28,9,0.031111111,34
2850.57215,52,88,0.95,36,0.026388889,34
2850.364126,56,80,0.65,24,0.027083333,34
2850.325496,33,58,0.93,25,0.0372,34
2850.273255,37,53,0.77,16,0.048125,34
2849.859062,54,71,0.6,17,0.035294118,34
2849.587363,35,53,0.68,18,0.037777778,34
