% profit,ema1,ema2,threshold,diff,thresh / diff,ID
4052.500695,64,73,0.26,9,0.028888889,46
4011.17069,55,83,0.82,28,0.029285714,46
4003.987137,59,78,0.56,19,0.029473684,46
4003.987137,58,79,0.62,21,0.02952381,46
3950.69448,65,72,0.2,7,0.028571429,46
3944.521603,62,74,0.35,12,0.029166667,46
3926.139338,61,75,0.41,14,0.029285714,46
3903.236119,63,73,0.29,10,0.029,46
3889.849232,59,77,0.53,18,0.029444444,46
3870.516475,60,76,0.47,16,0.029375,46
3866.407841,58,78,0.59,20,0.0295,46
3859.477236,57,79,0.65,22,0.029545455,46
3853.865433,65,73,0.23,8,0.02875,46
3853.865433,61,77,0.46,16,0.02875,46
3852.889629,63,75,0.35,12,0.029166667,46
3852.662258,64,74,0.29,10,0.029,46
3840.820505,58,81,0.66,23,0.028695652,46
3840.820505,57,82,0.72,25,0.0288,46
3837.830505,59,79,0.58,20,0.029,46
3837.830505,58,80,0.64,22,0.029090909,46
3837.830505,57,81,0.7,24,0.029166667,46
3836.813905,56,83,0.78,27,0.028888889,46
3825.005642,60,78,0.52,18,0.028888889,46
3823.772611,61,76,0.44,15,0.029333333,46
3823.542853,62,76,0.4,14,0.028571429,46
3816.916503,60,77,0.5,17,0.029411765,46
3816.102432,63,74,0.32,11,0.029090909,46
3813.102255,62,76,0.41,14,0.029285714,46
3813.102255,61,77,0.47,16,0.029375,46
3802.021831,56,82,0.76,26,0.029230769,46
3801.950201,62,75,0.38,13,0.029230769,46
3779.975176,66,67,0.03,1,0.03,46
3779.975176,65,68,0.09,3,0.03,46
3779.975176,64,69,0.15,5,0.03,46
3779.975176,63,70,0.21,7,0.03,46
3779.975176,62,71,0.27,9,0.03,46
3779.975176,61,72,0.33,11,0.03,46
3779.975176,60,73,0.39,13,0.03,46
3777.183401,66,72,0.17,6,0.028333333,46
3755.791075,60,70,0.31,10,0.031,46
3754.745296,64,75,0.31,11,0.028181818,46
3714.694214,57,73,0.5,16,0.03125,46
3681.932435,55,75,0.63,20,0.0315,46
3675.115597,57,73,0.52,16,0.0325,46
3673.069417,59,72,0.4,13,0.030769231,46
3671.752569,61,68,0.23,7,0.032857143,46
3670.710547,59,80,0.6,21,0.028571429,46
3667.640852,66,73,0.2,7,0.028571429,46
3666.488179,61,78,0.49,17,0.028823529,46
3654.546867,59,69,0.33,10,0.033,46
3654.546867,56,72,0.53,16,0.033125,46
3652.355015,62,77,0.43,15,0.028666667,46
3649.974092,62,73,0.34,11,0.030909091,46
3649.814717,51,73,0.76,22,0.034545455,46
3649.805859,61,69,0.25,8,0.03125,46
3648.897748,60,79,0.54,19,0.028421053,46
3647.175816,50,78,0.93,28,0.033214286,46
3645.609279,60,79,0.55,19,0.028947368,46
3643.535388,57,71,0.46,14,0.032857143,46
3643.535388,54,74,0.66,20,0.033,46
3641.105927,73,82,0.16,9,0.017777778,46
3639.003293,58,70,0.4,12,0.033333333,46
3637.579908,68,87,0.34,19,0.017894737,46
3636.529165,63,76,0.37,13,0.028461538,46
3633.491663,57,73,0.51,16,0.031875,46
3631.551431,56,73,0.56,17,0.032941176,46
3630.719903,54,73,0.64,19,0.033684211,46
3628.604317,67,72,0.14,5,0.028,46
3628.33435,60,69,0.29,9,0.032222222,46
3627.095462,58,69,0.37,11,0.033636364,46
3627.095462,55,73,0.6,18,0.033333333,46
3622.741944,55,75,0.65,20,0.0325,46
3620.086049,52,76,0.8,24,0.033333333,46
3619.667332,59,70,0.36,11,0.032727273,46
3618.220203,58,71,0.43,13,0.033076923,46
3615.071078,53,75,0.73,22,0.033181818,46
3613.432873,50,78,0.94,28,0.033571429,46
3613.366195,54,75,0.69,21,0.032857143,46
3611.939253,51,78,0.88,27,0.032592593,46
3611.939253,50,79,0.95,29,0.032758621,46
3608.758149,53,77,0.78,24,0.0325,46
3608.588837,57,80,0.68,23,0.029565217,46
3607.390155,59,71,0.39,12,0.0325,46
3606.019115,54,77,0.74,23,0.032173913,46
3605.968862,61,67,0.2,6,0.033333333,46
3605.669883,58,72,0.44,14,0.031428571,46
3602.28274,57,72,0.49,15,0.032666667,46
3596.709417,56,74,0.59,18,0.032777778,46
3594.214486,52,77,0.81,25,0.0324,46
3593.742702,60,70,0.32,10,0.032,46
3593.742702,58,72,0.45,14,0.032142857,46
3590.452164,56,74,0.58,18,0.032222222,46
3589.294171,56,75,0.59,19,0.031052632,46
3588.693226,53,74,0.71,21,0.033809524,46
3587.651885,56,75,0.6,19,0.031578947,46
3585.354304,58,71,0.42,13,0.032307692,46
3585.354304,56,73,0.55,17,0.032352941,46
3585.354304,55,74,0.62,19,0.032631579,46
3585.354304,54,75,0.68,21,0.032380952,46
3585.354304,53,76,0.75,23,0.032608696,46
3585.354304,52,77,0.82,25,0.0328,46
3585.137889,65,91,0.46,26,0.017692308,46
3583.663058,53,77,0.77,24,0.032083333,46
3583.663058,52,78,0.84,26,0.032307692,46
3583.663058,51,79,0.91,28,0.0325,46
3583.663058,50,80,0.97,30,0.032333333,46
3583.663058,50,81,0.99,31,0.031935484,46
3583.498049,54,77,0.72,23,0.031304348,46
3582.787044,54,74,0.67,20,0.0335,46
3581.096977,52,77,0.83,25,0.0332,46
3581.009261,60,69,0.3,9,0.033333333,46
3579.283351,50,79,0.96,29,0.033103448,46
3577.27875,60,71,0.34,11,0.030909091,46
3574.660492,56,75,0.61,19,0.032105263,46
3572.388776,63,67,0.13,4,0.0325,46
3572.388776,61,69,0.26,8,0.0325,46
3571.849507,70,85,0.27,15,0.018,46
3571.352267,55,68,0.45,13,0.034615385,46
3570.003565,51,77,0.87,26,0.033461538,46
3569.581368,57,72,0.5,15,0.033333333,46
3569.581368,53,76,0.77,23,0.033478261,46
3567.036014,57,71,0.47,14,0.033571429,46
3566.073313,51,79,0.9,28,0.032142857,46
3564.639777,53,85,0.95,32,0.0296875,46
3563.447493,53,76,0.76,23,0.033043478,46
3561.826247,51,74,0.78,23,0.033913043,46
3561.826247,50,75,0.85,25,0.034,46
3561.826247,49,76,0.92,27,0.034074074,46
3561.148211,55,76,0.68,21,0.032380952,46
3560.561515,50,77,0.92,27,0.034074074,46
3558.433059,52,79,0.87,27,0.032222222,46
3558.025055,51,78,0.9,27,0.033333333,46
3558.025055,50,79,0.97,29,0.033448276,46
3556.448677,59,72,0.41,13,0.031538462,46
3555.113644,53,77,0.79,24,0.032916667,46
3554.148747,62,68,0.19,6,0.031666667,46
3553.276029,54,75,0.7,21,0.033333333,46
3552.932284,51,78,0.89,27,0.032962963,46
3551.714059,54,76,0.73,22,0.033181818,46
3551.117564,55,75,0.64,20,0.032,46
3551.117564,54,76,0.71,22,0.032272727,46
3551.117564,52,79,0.86,27,0.031851852,46
3551.117564,51,80,0.93,29,0.032068966,46
3550.893481,59,71,0.38,12,0.031666667,46
3548.99898,57,70,0.44,13,0.033846154,46
3548.99898,53,75,0.74,22,0.033636364,46
3547.786797,55,75,0.66,20,0.033,46
3547.324418,52,76,0.81,24,0.03375,46
3547.108018,52,79,0.88,27,0.032592593,46
3545.850266,62,67,0.16,5,0.032,46
3545.850266,57,72,0.48,15,0.032,46
3545.850266,56,74,0.57,18,0.031666667,46
3545.850266,55,74,0.61,19,0.032105263,46
3545.850266,54,76,0.7,22,0.031818182,46
3545.821341,63,66,0.1,3,0.033333333,46
3545.42169,59,70,0.35,11,0.031818182,46
3545.42169,53,76,0.74,23,0.032173913,46
3545.140824,54,77,0.73,23,0.03173913,46
3543.982313,55,74,0.63,19,0.033157895,46
3542.775676,52,75,0.78,23,0.033913043,46
3542.775676,51,76,0.85,25,0.034,46
3541.420695,61,66,0.17,5,0.034,46
3533.481775,35,56,0.73,21,0.034761905,46
3532.366061,62,74,0.37,12,0.030833333,46
3531.487791,52,78,0.86,26,0.033076923,46
3529.714376,58,66,0.27,8,0.03375,46
3527.756827,56,71,0.51,15,0.034,46
3525.524313,62,74,0.36,12,0.03,46
3525.524313,61,75,0.42,14,0.03,46
3525.524313,60,76,0.48,16,0.03,46
3524.670286,63,71,0.25,8,0.03125,46
3523.712556,50,80,0.98,30,0.032666667,46
3523.024458,55,82,0.81,27,0.03,46
3520.658298,52,78,0.85,26,0.032692308,46
3518.833507,56,81,0.74,25,0.0296,46
3518.076829,58,77,0.57,19,0.03,46
3515.202798,53,78,0.79,25,0.0316,46
3513.011461,75,80,0.09,5,0.018,46
3512.406463,50,80,0.99,30,0.033,46
3511.077036,54,76,0.72,22,0.032727273,46
3510.295782,55,76,0.67,21,0.031904762,46
3510.295782,53,78,0.8,25,0.032,46
3510.295782,52,80,0.88,28,0.031428571,46
3510.295782,52,80,0.89,28,0.031785714,46
3510.295782,51,81,0.95,30,0.031666667,46
3510.241829,53,84,0.93,31,0.03,46
3510.208885,52,78,0.83,26,0.031923077,46
3510.096189,60,68,0.27,8,0.03375,46
3510.096189,56,72,0.54,16,0.03375,46
3509.958633,59,75,0.51,16,0.031875,46
3508.312057,63,72,0.28,9,0.031111111,46
3508.064281,57,78,0.66,21,0.031428571,46
3506.258585,54,77,0.75,23,0.032608696,46
3506.067843,57,74,0.53,17,0.031176471,46
3506.067843,55,76,0.66,21,0.031428571,46
3504.616333,51,79,0.92,28,0.032857143,46
3503.492711,53,79,0.81,26,0.031153846,46
3502.352105,61,70,0.29,9,0.032222222,46
3502.352105,59,72,0.42,13,0.032307692,46
3502.352105,57,74,0.55,17,0.032352941,46
3502.208071,57,78,0.63,21,0.03,46
3502.080228,58,73,0.48,15,0.032,46
3502.018837,49,76,0.93,27,0.034444444,46
3501.780716,59,76,0.51,17,0.03,46
3500.67587,51,80,0.95,29,0.032758621,46
3500.461223,61,75,0.43,14,0.030714286,46
3496.377821,55,77,0.68,22,0.030909091,46
3495.485938,61,70,0.28,9,0.031111111,46
3495.40304,66,79,0.26,13,0.02,46
3491.786988,63,68,0.16,5,0.032,46
3491.615506,53,78,0.81,25,0.0324,46
3490.407994,38,51,0.46,13,0.035384615,46
3489.244739,51,80,0.94,29,0.032413793,46
3489.044149,51,81,0.96,30,0.032,46
3488.466118,54,69,0.52,15,0.034666667,46
3488.380306,54,81,0.86,27,0.031851852,46
3487.908003,58,65,0.24,7,0.034285714,46
3485.859806,55,82,0.8,27,0.02962963,46
3485.859806,54,83,0.86,29,0.029655172,46
3485.007278,56,79,0.69,23,0.03,46
3484.529558,53,71,0.61,18,0.033888889,46
3484.529558,52,72,0.68,20,0.034,46
3483.655726,53,78,0.82,25,0.0328,46
3482.239831,53,82,0.88,29,0.030344828,46
3481.854361,63,73,0.31,10,0.031,46
3481.814844,60,75,0.45,15,0.03,46
3480.089301,53,71,0.62,18,0.034444444,46
3480.089301,52,72,0.69,20,0.0345,46
3479.747125,57,74,0.54,17,0.031764706,46
3479.457814,45,59,0.43,14,0.030714286,46
3478.811468,54,70,0.55,16,0.034375,46
3478.28569,54,83,0.87,29,0.03,46
3477.643855,56,76,0.64,20,0.032,46
3477.352712,59,76,0.53,17,0.031176471,46
3477.057126,62,71,0.29,9,0.032222222,46
3475.554961,58,73,0.47,15,0.031333333,46
3475.351098,70,75,0.1,5,0.02,46
3475.351098,69,76,0.14,7,0.02,46
3475.351098,68,77,0.18,9,0.02,46
3475.351098,67,78,0.22,11,0.02,46
3475.188706,61,73,0.38,12,0.031666667,46
3474.351256,58,72,0.46,14,0.032857143,46
3474.145915,59,73,0.43,14,0.030714286,46
3474.145915,58,74,0.49,16,0.030625,46
3474.063242,51,79,0.93,28,0.033214286,46
3473.700526,55,73,0.61,18,0.033888889,46
3473.700526,52,77,0.84,25,0.0336,46
3473.61274,61,71,0.32,10,0.032,46
3473.61274,58,75,0.54,17,0.031764706,46
3473.555693,54,80,0.84,26,0.032307692,46
3473.172638,60,70,0.33,10,0.033,46
3473.172638,57,73,0.53,16,0.033125,46
3473.109628,55,81,0.78,26,0.03,46
3471.278849,59,77,0.56,18,0.031111111,46
3469.712488,57,77,0.64,20,0.032,46
3469.258249,54,82,0.84,28,0.03,46
3467.601436,55,77,0.71,22,0.032272727,46
3467.601436,52,81,0.93,29,0.032068966,46
3467.334361,52,79,0.89,27,0.032962963,46
3467.334361,51,80,0.96,29,0.033103448,46
3465.767747,67,68,0.03,1,0.03,46
3465.767747,66,69,0.09,3,0.03,46
3465.585509,57,79,0.67,22,0.030454545,46
3465.585509,56,80,0.73,24,0.030416667,46
3463.681617,58,77,0.59,19,0.031052632,46
3463.131912,57,76,0.6,19,0.031578947,46
3461.893839,61,74,0.41,13,0.031538462,46
3461.722396,55,69,0.48,14,0.034285714,46
3460.784271,52,84,0.97,32,0.0303125,46
3458.45656,74,80,0.11,6,0.018333333,46
3457.985495,65,75,0.28,10,0.028,46
3457.920966,64,71,0.22,7,0.031428571,46
3457.91118,62,71,0.28,9,0.031111111,46
3456.910762,60,73,0.41,13,0.031538462,46
3456.591054,56,78,0.69,22,0.031363636,46
3454.565575,54,82,0.87,28,0.031071429,46
3454.107729,54,83,0.88,29,0.030344828,46
3453.075635,53,81,0.91,28,0.0325,46
3452.025117,51,77,0.88,26,0.033846154,46
3451.968928,61,74,0.39,13,0.03,46
3451.053185,39,49,0.36,10,0.036,46
3450.843423,60,74,0.43,14,0.030714286,46
3449.965366,58,74,0.5,16,0.03125,46
3449.553152,67,89,0.39,22,0.017727273,46
3448.559013,55,77,0.7,22,0.031818182,46
3448.559013,53,80,0.85,27,0.031481481,46
3448.530301,63,69,0.19,6,0.031666667,46
3447.544624,55,80,0.75,25,0.03,46
3447.168593,53,83,0.93,30,0.031,46
3446.544773,64,93,0.51,29,0.017586207,46
3446.506714,54,78,0.78,24,0.0325,46
3446.506714,52,80,0.91,28,0.0325,46
3446.180443,55,80,0.79,25,0.0316,46
3446.097604,60,71,0.35,11,0.031818182,46
3446.097604,57,75,0.57,18,0.031666667,46
3446.097604,56,76,0.63,20,0.0315,46
3446.097604,54,78,0.76,24,0.031666667,46
3446.097604,53,79,0.83,26,0.031923077,46
3446.097604,52,81,0.91,29,0.03137931,46
3444.249085,62,70,0.25,8,0.03125,46
3443.259949,63,70,0.22,7,0.031428571,46
3443.203383,54,80,0.8,26,0.030769231,46
3442.638631,51,83,0.99,32,0.0309375,46
3442.102033,55,79,0.74,24,0.030833333,46
3441.814527,62,78,0.45,16,0.028125,46
3441.409541,52,83,0.99,31,0.031935484,46
3441.289758,63,77,0.39,14,0.027857143,46
3441.04415,59,73,0.45,14,0.032142857,46
3440.99455,60,73,0.42,13,0.032307692,46
3440.99455,58,75,0.55,17,0.032352941,46
3439.44334,66,68,0.06,2,0.03,46
3439.44334,65,69,0.12,4,0.03,46
3439.44334,64,70,0.18,6,0.03,46
3438.986822,53,79,0.82,26,0.031538462,46
3438.986822,51,82,0.97,31,0.031290323,46
3437.695959,44,60,0.49,16,0.030625,46
3437.603247,51,82,0.99,31,0.031935484,46
3437.194807,51,73,0.8,22,0.036363636,46
3436.934147,52,82,0.93,30,0.031,46
3436.755571,59,75,0.5,16,0.03125,46
3436.242691,65,72,0.21,7,0.03,46
3436.242691,64,73,0.27,9,0.03,46
3436.242691,63,74,0.33,11,0.03,46
3436.242691,62,75,0.39,13,0.03,46
3436.242691,61,76,0.45,15,0.03,46
3436.242691,60,77,0.51,17,0.03,46
3435.871014,51,78,0.91,27,0.033703704,46
3435.200376,64,92,0.5,28,0.017857143,46
3433.767615,53,79,0.84,26,0.032307692,46
3433.074132,54,82,0.85,28,0.030357143,46
3431.961854,52,82,0.97,30,0.032333333,46
3430.175765,50,74,0.83,24,0.034583333,46
3429.265906,53,83,0.91,30,0.030333333,46
3429.000403,58,73,0.5,15,0.033333333,46
3428.512132,57,81,0.71,24,0.029583333,46
3428.512132,56,82,0.77,26,0.029615385,46
3426.602836,58,77,0.58,19,0.030526316,46
3426.064054,60,74,0.44,14,0.031428571,46
3425.413486,58,76,0.58,18,0.032222222,46
3424.636021,54,79,0.8,25,0.032,46
3424.504343,59,77,0.54,18,0.03,46
3424.504343,58,78,0.6,20,0.03,46
3423.574689,56,80,0.72,24,0.03,46
3423.390258,59,75,0.49,16,0.030625,46
3422.972253,65,70,0.15,5,0.03,46
3422.972253,64,71,0.21,7,0.03,46
3422.972253,63,72,0.27,9,0.03,46
3422.972253,62,73,0.33,11,0.03,46
3421.74878,62,69,0.22,7,0.031428571,46
3421.613518,56,78,0.71,22,0.032272727,46
3421.467996,58,78,0.62,20,0.031,46
3420.946307,58,76,0.55,18,0.030555556,46
3420.946307,57,77,0.61,20,0.0305,46
3420.248807,56,78,0.68,22,0.030909091,46
3420.248807,54,80,0.81,26,0.031153846,46
3420.248807,52,83,0.95,31,0.030645161,46
3420.014876,56,79,0.7,23,0.030434783,46
3419.251304,64,70,0.19,6,0.031666667,46
3419.081799,59,74,0.49,15,0.032666667,46
3418.700809,56,78,0.67,22,0.030454545,46
3418.492904,52,79,0.9,27,0.033333333,46
3418.39532,56,73,0.57,17,0.033529412,46
3418.39532,53,77,0.8,24,0.033333333,46
3418.39532,52,78,0.87,26,0.033461538,46
3418.038051,58,74,0.51,16,0.031875,46
3418.029855,59,73,0.46,14,0.032857143,46
3418.029855,55,78,0.75,23,0.032608696,46
3417.849701,54,78,0.75,24,0.03125,46
3417.662645,54,81,0.82,27,0.03037037,46
3416.879912,55,83,0.83,28,0.029642857,46
3415.261344,55,77,0.69,22,0.031363636,46
3415.261344,53,80,0.84,27,0.031111111,46
3415.260988,55,74,0.64,19,0.033684211,46
3415.112804,53,81,0.87,28,0.031071429,46
3415.007765,64,68,0.13,4,0.0325,46
3415.007765,62,70,0.26,8,0.0325,46
3414.664723,53,80,0.89,27,0.032962963,46
3414.247729,53,82,0.91,29,0.03137931,46
3413.801002,61,73,0.37,12,0.030833333,46
3413.78667,54,81,0.83,27,0.030740741,46
3413.78667,53,82,0.89,29,0.030689655,46
3413.369805,57,78,0.64,21,0.03047619,46
3413.369805,55,81,0.79,26,0.030384615,46
3413.219873,51,81,0.97,30,0.032333333,46
3412.872948,56,75,0.62,19,0.032631579,46
3411.707148,63,94,0.55,31,0.017741935,46
3410.945359,58,75,0.53,17,0.031176471,46
3410.752136,51,81,0.98,30,0.032666667,46
3408.774274,57,76,0.58,19,0.030526316,46
3408.774274,56,77,0.64,21,0.03047619,46
3408.619784,52,83,0.98,31,0.031612903,46
3408.486441,55,79,0.77,24,0.032083333,46
3407.754613,59,74,0.47,15,0.031333333,46
3407.754613,57,77,0.62,20,0.031,46
3405.178246,56,67,0.38,11,0.034545455,46
3404.99327,47,56,0.28,9,0.031111111,46
3404.781948,64,69,0.16,5,0.032,46
3404.422114,54,81,0.85,27,0.031481481,46
3404.320346,68,87,0.35,19,0.018421053,46
3403.884302,60,76,0.49,16,0.030625,46
3403.884302,59,77,0.55,18,0.030555556,46
3403.391164,59,73,0.44,14,0.031428571,46
3403.391164,57,76,0.59,19,0.031052632,46
3403.391164,55,78,0.72,23,0.031304348,46
3403.391164,54,79,0.78,25,0.0312,46
3403.131139,54,79,0.82,25,0.0328,46
3402.795407,59,79,0.59,20,0.0295,46
3402.795407,58,80,0.65,22,0.029545455,46
3402.596917,55,76,0.69,21,0.032857143,46
3402.45682,63,71,0.24,8,0.03,46
3402.45682,62,72,0.3,10,0.03,46
3402.45682,61,73,0.36,12,0.03,46
3402.45682,60,74,0.42,14,0.03,46
3402.45682,59,75,0.48,16,0.03,46
3402.45682,58,76,0.54,18,0.03,46
3402.429276,54,79,0.77,25,0.0308,46
3401.459903,59,70,0.37,11,0.033636364,46
3401.459903,55,75,0.67,20,0.0335,46
3401.315411,58,76,0.56,18,0.031111111,46
3401.315411,55,79,0.75,24,0.03125,46
3401.070766,58,77,0.6,19,0.031578947,46
3400.900026,61,74,0.4,13,0.030769231,46
3400.900026,60,75,0.46,15,0.030666667,46
3400.900026,59,76,0.52,17,0.030588235,46
3400.900026,57,78,0.65,21,0.030952381,46
3400.900026,56,79,0.71,23,0.030869565,46
3399.779701,56,77,0.68,21,0.032380952,46
3398.830025,58,73,0.49,15,0.032666667,46
3398.70861,52,83,0.97,31,0.031290323,46
3398.578271,55,79,0.76,24,0.031666667,46
3398.409431,57,76,0.62,19,0.032631579,46
3398.311072,55,81,0.81,26,0.031153846,46
3398.059406,53,81,0.9,28,0.032142857,46
3397.450656,54,70,0.54,16,0.03375,46
3397.346776,57,77,0.6,20,0.03,46
3397.048419,53,84,0.94,31,0.030322581,46
3395.790826,55,80,0.78,25,0.0312,46
3395.262321,61,72,0.35,11,0.031818182,46
3395.106462,56,66,0.35,10,0.035,46
3395.106462,55,67,0.42,12,0.035,46
3395.106462,54,68,0.49,14,0.035,46
3395.106462,53,69,0.56,16,0.035,46
3393.918081,55,78,0.73,23,0.03173913,46
3393.379936,60,72,0.38,12,0.031666667,46
3393.24639,57,79,0.68,22,0.030909091,46
3392.599942,54,80,0.82,26,0.031538462,46
3392.511888,53,82,0.92,29,0.031724138,46
3392.385686,57,79,0.66,22,0.03,46
3391.594064,64,67,0.1,3,0.033333333,46
3391.594064,61,70,0.3,9,0.033333333,46
3391.557182,52,82,0.98,30,0.032666667,46
3391.317649,52,84,0.99,32,0.0309375,46
3390.777988,60,72,0.37,12,0.030833333,46
3390.399735,55,79,0.78,24,0.0325,46
3390.327538,55,69,0.47,14,0.033571429,46
3390.291752,59,65,0.2,6,0.033333333,46
3390.239014,42,63,0.64,21,0.03047619,46
3389.952772,62,73,0.35,11,0.031818182,46
3389.584681,49,75,0.95,26,0.036538462,46
3389.493736,56,77,0.66,21,0.031428571,46
3389.493736,54,79,0.79,25,0.0316,46
3389.323968,58,75,0.52,17,0.030588235,46
3389.323968,55,79,0.73,24,0.030416667,46
3389.08318,65,80,0.3,15,0.02,46
3389.08318,64,81,0.34,17,0.02,46
3389.042607,56,79,0.72,23,0.031304348,46
3388.946031,55,80,0.76,25,0.0304,46
3388.504415,56,77,0.67,21,0.031904762,46
3388.471443,53,78,0.83,25,0.0332,46
3388.385938,51,82,0.98,31,0.031612903,46
3388.177267,55,80,0.77,25,0.0308,46
3388.08328,57,75,0.56,18,0.031111111,46
3387.554946,61,72,0.34,11,0.030909091,46
3387.017005,61,71,0.33,10,0.033,46
3386.261797,52,82,0.95,30,0.031666667,46
3385.545201,62,72,0.31,10,0.031,46
3385.184529,56,76,0.66,20,0.033,46
3383.459638,52,81,0.9,29,0.031034483,46
3383.414727,57,75,0.58,18,0.032222222,46
3383.273014,57,80,0.7,23,0.030434783,46
3382.966784,53,72,0.64,19,0.033684211,46
3382.966784,52,73,0.71,21,0.033809524,46
3382.966784,51,75,0.8,24,0.033333333,46
3382.966784,50,76,0.87,26,0.033461538,46
3382.640176,55,77,0.73,22,0.033181818,46
3382.466644,60,73,0.4,13,0.030769231,46
3382.466644,56,77,0.65,21,0.030952381,46
3381.970161,53,83,0.92,30,0.030666667,46
3380.102609,60,75,0.47,15,0.031333333,46
3379.933308,53,79,0.86,26,0.033076923,46
3379.933308,52,80,0.93,28,0.033214286,46
3379.066331,58,76,0.57,18,0.031666667,46
3378.21702,52,84,0.98,32,0.030625,46
3378.207424,54,84,0.89,30,0.029666667,46
3378.014242,60,71,0.36,11,0.032727273,46
3377.891673,57,76,0.61,19,0.032105263,46
3377.891673,55,78,0.74,23,0.032173913,46
3377.891673,54,80,0.83,26,0.031923077,46
3376.650317,53,81,0.89,28,0.031785714,46
3375.914475,53,79,0.85,26,0.032692308,46
3375.713723,60,78,0.53,18,0.029444444,46
3375.592469,54,82,0.86,28,0.030714286,46
3374.548034,52,81,0.92,29,0.031724138,46
3374.095384,60,72,0.39,12,0.0325,46
3373.416266,53,80,0.86,27,0.031851852,46
3372.823363,65,82,0.33,17,0.019411765,46
3372.823363,64,83,0.37,19,0.019473684,46
3372.817469,53,80,0.87,27,0.032222222,46
3372.031607,55,66,0.39,11,0.035454545,46
3371.427442,56,76,0.62,20,0.031,46
3370.761423,59,78,0.57,19,0.03,46
3370.359144,58,74,0.52,16,0.0325,46
3369.347938,54,78,0.77,24,0.032083333,46
3369.347938,52,80,0.9,28,0.032142857,46
3369.224791,52,74,0.73,22,0.033181818,46
3369.026719,62,69,0.23,7,0.032857143,46
3368.55033,69,86,0.31,17,0.018235294,46
3368.297586,54,67,0.46,13,0.035384615,46
3368.297586,52,70,0.63,18,0.035,46
3368.128068,58,79,0.63,21,0.03,46
3368.128068,57,80,0.69,23,0.03,46
3367.270448,58,72,0.47,14,0.033571429,46
3365.437838,72,83,0.2,11,0.018181818,46
3365.29593,56,76,0.65,20,0.0325,46
3364.526641,66,91,0.44,25,0.0176,46
3363.665679,59,72,0.43,13,0.033076923,46
3363.665679,54,78,0.79,24,0.032916667,46
3363.086451,54,71,0.57,17,0.033529412,46
3361.271772,61,72,0.36,11,0.032727273,46
3360.914465,39,50,0.39,11,0.035454545,46
3360.210014,66,90,0.43,24,0.017916667,46
3359.243152,67,89,0.4,22,0.018181818,46
3358.815168,61,96,0.64,35,0.018285714,46
3358.495105,59,74,0.48,15,0.032,46
3358.495105,56,78,0.7,22,0.031818182,46
3358.393334,52,67,0.54,15,0.036,46
3357.690245,57,75,0.59,18,0.032777778,46
3357.690245,53,80,0.88,27,0.032592593,46
3357.690245,52,81,0.95,29,0.032758621,46
3356.954571,65,91,0.47,26,0.018076923,46
3356.954571,63,93,0.54,30,0.018,46
3355.388062,59,71,0.4,12,0.033333333,46
3355.388062,56,74,0.6,18,0.033333333,46
3355.163206,50,74,0.88,24,0.036666667,46
3354.841816,64,92,0.51,28,0.018214286,46
3353.132397,57,66,0.31,9,0.034444444,46
3351.283316,62,95,0.59,33,0.017878788,46
3351.199322,55,81,0.8,26,0.030769231,46
3350.36692,66,82,0.31,16,0.019375,46
3349.010311,55,78,0.76,23,0.033043478,46
3348.997194,56,75,0.63,19,0.033157895,46
3348.492236,56,68,0.41,12,0.034166667,46
3348.152453,58,74,0.53,16,0.033125,46
3346.07552,61,71,0.31,10,0.031,46
3346.07552,59,74,0.46,15,0.030666667,46
3346.07552,55,78,0.71,23,0.030869565,46
3345.107024,62,72,0.32,10,0.032,46
3345.058783,53,81,0.86,28,0.030714286,46
3344.866542,72,73,0.02,1,0.02,46
3344.866542,71,74,0.06,3,0.02,46
3344.332562,54,81,0.84,27,0.031111111,46
3344.195552,66,90,0.44,24,0.018333333,46
3344.097231,58,75,0.56,17,0.032941176,46
3344.052599,62,95,0.6,33,0.018181818,46
3343.830149,57,62,0.18,5,0.036,46
3342.828847,52,82,0.96,30,0.032,46
3341.081893,67,69,0.06,2,0.03,46
3341.081893,66,70,0.12,4,0.03,46
3341.081893,65,71,0.18,6,0.03,46
3341.081893,64,72,0.24,8,0.03,46
3341.081893,63,73,0.3,10,0.03,46
3340.126457,52,68,0.57,16,0.035625,46
3338.377984,57,77,0.63,20,0.0315,46
3337.908833,59,76,0.54,17,0.031764706,46
3337.805799,52,81,0.94,29,0.032413793,46
3337.64761,56,77,0.69,21,0.032857143,46
3337.364293,70,84,0.26,14,0.018571429,46
3336.760139,54,80,0.85,26,0.032692308,46
3334.11203,57,74,0.56,17,0.032941176,46
3334.11203,52,80,0.92,28,0.032857143,46
3334.086655,62,84,0.44,22,0.02,46
3334.053266,55,77,0.72,22,0.032727273,46
3332.757713,54,79,0.81,25,0.0324,46
3332.703281,52,82,0.94,30,0.031333333,46
3332.518384,65,69,0.13,4,0.0325,46
3331.408237,53,81,0.88,28,0.031428571,46
3331.408237,53,82,0.9,29,0.031034483,46
3331.408237,52,83,0.96,31,0.030967742,46
3331.327913,55,76,0.7,21,0.033333333,46
3330.817547,62,68,0.2,6,0.033333333,46
3328.768347,40,47,0.26,7,0.037142857,46
3328.599979,51,71,0.7,20,0.035,46
3328.35559,63,94,0.56,31,0.018064516,46
3327.376217,49,74,0.87,25,0.0348,46
3327.324245,55,70,0.5,15,0.033333333,46
3326.504423,58,78,0.61,20,0.0305,46
3326.504423,56,81,0.75,25,0.03,46
3322.358653,38,49,0.41,11,0.037272727,46
3320.907821,57,67,0.34,10,0.034,46
3320.809924,56,63,0.25,7,0.035714286,46
3319.568703,51,81,0.99,30,0.033,46
3317.863333,53,67,0.5,14,0.035714286,46
3317.270436,59,64,0.17,5,0.034,46
3315.465345,50,75,0.86,25,0.0344,46
3314.934391,64,82,0.36,18,0.02,46
3314.934391,63,83,0.4,20,0.02,46
3313.866945,69,87,0.32,18,0.017777778,46
3313.040436,41,48,0.25,7,0.035714286,46
3312.715673,63,69,0.2,6,0.033333333,46
3312.715673,60,72,0.4,12,0.033333333,46
3312.522072,34,57,0.8,23,0.034782609,46
3310.37472,60,74,0.45,14,0.032142857,46
3310.246891,57,78,0.67,21,0.031904762,46
3309.896999,61,73,0.39,12,0.0325,46
3309.293726,56,79,0.73,23,0.03173913,46
3307.177481,68,69,0.03,1,0.03,46
3307.177481,67,70,0.09,3,0.03,46
3307.177481,66,71,0.15,5,0.03,46
3306.688239,37,53,0.56,16,0.035,46
3306.499242,46,58,0.37,12,0.030833333,46
3305.826785,51,73,0.75,22,0.034090909,46
3301.544174,54,77,0.76,23,0.033043478,46
3301.302723,42,64,0.66,22,0.03,46
3301.23799,63,71,0.26,8,0.0325,46
3301.169813,53,68,0.53,15,0.035333333,46
3299.922598,56,80,0.74,24,0.030833333,46
3293.250735,68,88,0.36,20,0.018,46
3290.746079,63,93,0.55,30,0.018333333,46
3289.782279,51,86,0.94,35,0.026857143,46
3286.866125,56,81,0.76,25,0.0304,46
3286.151044,48,74,0.92,26,0.035384615,46
3285.74498,64,93,0.52,29,0.017931034,46
3285.218241,35,55,0.71,20,0.0355,46
3284.326017,65,92,0.48,27,0.017777778,46
3281.460487,63,95,0.57,32,0.0178125,46
3280.52832,43,63,0.6,20,0.03,46
3279.440978,67,88,0.38,21,0.018095238,46
3276.682349,63,84,0.41,21,0.01952381,46
3276.576775,66,89,0.42,23,0.01826087,46
3275.08798,49,77,0.95,28,0.033928571,46
3274.680511,51,70,0.67,19,0.035263158,46
3273.602529,47,54,0.22,7,0.031428571,46
3273.400017,62,94,0.58,32,0.018125,46
3272.846892,33,57,0.86,24,0.035833333,46
3272.421976,55,63,0.29,8,0.03625,46
3271.987939,35,55,0.7,20,0.035,46
3270.756009,33,59,0.9,26,0.034615385,46
3270.660044,66,81,0.29,15,0.019333333,46
3270.462599,61,97,0.65,36,0.018055556,46
3269.53137,40,49,0.32,9,0.035555556,46
3269.361854,62,94,0.59,32,0.0184375,46
3267.012512,65,90,0.46,25,0.0184,46
3265.536271,67,80,0.25,13,0.019230769,46
3265.409475,52,69,0.6,17,0.035294118,46
3264.208267,50,72,0.77,22,0.035,46
3263.658905,59,67,0.26,8,0.0325,46
3262.692277,58,64,0.21,6,0.035,46
3262.692277,57,65,0.28,8,0.035,46
3259.903121,37,52,0.53,15,0.035333333,46
3259.833248,53,84,0.83,31,0.026774194,46
3259.68503,36,54,0.65,18,0.036111111,46
3257.947729,35,53,0.67,18,0.037222222,46
3256.858219,57,82,0.73,25,0.0292,46
3256.709794,62,96,0.61,34,0.017941176,46
3253.763965,35,56,0.74,21,0.035238095,46
3252.863995,36,54,0.63,18,0.035,46
3246.692362,55,71,0.53,16,0.033125,46
3246.217766,55,82,0.82,27,0.03037037,46
3245.812913,37,52,0.54,15,0.036,46
3244.394784,65,82,0.34,17,0.02,46
3243.377224,60,73,0.43,13,0.033076923,46
3242.927343,51,82,0.93,31,0.03,46
3242.894787,36,54,0.64,18,0.035555556,46
3242.86526,69,77,0.16,8,0.02,46
3242.86526,68,78,0.2,10,0.02,46
3242.328759,53,70,0.59,17,0.034705882,46
3242.328759,52,71,0.66,19,0.034736842,46
3242.328759,51,72,0.73,21,0.034761905,46
3239.994316,61,86,0.5,25,0.02,46
3238.295155,35,54,0.68,19,0.035789474,46
3231.333297,72,74,0.04,2,0.02,46
3231.333297,71,75,0.08,4,0.02,46
3231.333297,70,76,0.12,6,0.02,46
3229.475631,50,75,0.9,25,0.036,46
3228.102151,62,83,0.46,21,0.021904762,46
3227.90316,54,70,0.58,16,0.03625,46
3225.603794,44,60,0.5,16,0.03125,46
3224.941265,61,85,0.48,24,0.02,46
3224.791829,67,79,0.24,12,0.02,46
3224.314046,62,87,0.49,25,0.0196,46
3223.882393,34,57,0.81,23,0.035217391,46
3222.683544,65,83,0.35,18,0.019444444,46
3220.383073,65,92,0.49,27,0.018148148,46
3219.696256,68,76,0.18,8,0.0225,46
3219.280307,57,67,0.36,10,0.036,46
3219.280307,53,71,0.65,18,0.036111111,46
3218.469914,65,80,0.33,15,0.022,46
3214.544063,39,48,0.35,9,0.038888889,46
3214.228196,50,55,0.14,5,0.028,46
3212.179914,36,52,0.59,16,0.036875,46
3211.520926,49,76,0.97,27,0.035925926,46
3210.683016,52,73,0.75,21,0.035714286,46
3209.8756,40,49,0.33,9,0.036666667,46
3209.307319,54,71,0.6,17,0.035294118,46
3208.791783,64,91,0.5,27,0.018518519,46
3208.426525,48,55,0.22,7,0.031428571,46
3208.111865,57,68,0.37,11,0.033636364,46
3208.111865,54,72,0.6,18,0.033333333,46
3207.9612,56,84,0.8,28,0.028571429,46
3204.546558,58,66,0.29,8,0.03625,46
3201.097339,53,87,0.98,34,0.028823529,46
3200.49986,63,82,0.42,19,0.022105263,46
3199.95442,59,75,0.52,16,0.0325,46
3199.612387,50,73,0.8,23,0.034782609,46
3198.447473,51,75,0.84,24,0.035,46
3198.071264,53,72,0.68,19,0.035789474,46
3197.298181,66,81,0.3,15,0.02,46
3196.485147,45,56,0.35,11,0.031818182,46
3195.488165,60,98,0.69,38,0.018157895,46
3194.938121,39,49,0.37,10,0.037,46
3194.485137,54,71,0.58,17,0.034117647,46
3194.485137,53,72,0.65,19,0.034210526,46
3194.043419,55,71,0.54,16,0.03375,46
3193.872938,59,80,0.61,21,0.029047619,46
3193.872938,58,81,0.67,23,0.029130435,46
3193.309244,55,70,0.51,15,0.034,46
3192.925389,48,73,0.89,25,0.0356,46
3192.225521,48,56,0.25,8,0.03125,46
3191.227412,57,77,0.65,20,0.0325,46
3190.044363,54,71,0.61,17,0.035882353,46
3189.027156,67,81,0.27,14,0.019285714,46
3188.499602,66,89,0.43,23,0.018695652,46
3188.353679,58,68,0.33,10,0.033,46
3187.193513,44,58,0.44,14,0.031428571,46
3186.329343,63,70,0.23,7,0.032857143,46
3184.720238,56,69,0.43,13,0.033076923,46
3183.81595,55,85,0.86,30,0.028666667,46
3183.677136,47,57,0.31,10,0.031,46
3183.074874,55,69,0.51,14,0.036428571,46
3181.413854,32,60,0.98,28,0.035,46
3181.341485,34,55,0.76,21,0.036190476,46
3180.786851,49,77,0.98,28,0.035,46
3179.155491,41,47,0.22,6,0.036666667,46
3179.002879,55,84,0.85,29,0.029310345,46
3178.870602,54,72,0.61,18,0.033888889,46
3178.457802,33,58,0.88,25,0.0352,46
3177.315326,57,83,0.74,26,0.028461538,46
3177.194146,50,83,0.99,33,0.03,46
3176.761189,48,53,0.16,5,0.032,46
3176.056306,66,78,0.27,12,0.0225,46
3175.42918,52,83,0.87,31,0.028064516,46
3175.42918,51,84,0.93,33,0.028181818,46
3175.42918,50,85,0.99,35,0.028285714,46
3174.630228,66,79,0.27,13,0.020769231,46
3174.549884,65,90,0.47,25,0.0188,46
3174.321839,51,74,0.83,23,0.036086957,46
3173.950033,56,70,0.46,14,0.032857143,46
3173.568612,49,77,0.99,28,0.035357143,46
3173.342076,73,81,0.15,8,0.01875,46
3173.26931,46,55,0.29,9,0.032222222,46
3173.010224,55,80,0.69,25,0.0276,46
3172.250808,43,59,0.51,16,0.031875,46
3172.195505,61,64,0.1,3,0.033333333,46
3172.195505,58,67,0.3,9,0.033333333,46
3171.293649,56,69,0.46,13,0.035384615,46
3170.843166,51,55,0.11,4,0.0275,46
3170.327311,52,72,0.73,20,0.0365,46
3170.315507,54,97,0.92,43,0.021395349,46
3169.230182,52,73,0.72,21,0.034285714,46
3169.220476,53,71,0.66,18,0.036666667,46
3169.220476,50,75,0.91,25,0.0364,46
3168.91668,53,82,0.81,29,0.027931034,46
3168.782774,55,68,0.48,13,0.036923077,46
3168.661827,41,64,0.72,23,0.031304348,46
3168.33115,63,82,0.41,19,0.021578947,46
3168.01404,38,50,0.44,12,0.036666667,46
3167.970842,52,74,0.74,22,0.033636364,46
3167.48064,55,70,0.53,15,0.035333333,46
3167.248526,65,80,0.32,15,0.021333333,46
3167.002681,49,76,0.98,27,0.036296296,46
3166.786639,63,93,0.56,30,0.018666667,46
3166.622968,49,57,0.22,8,0.0275,46
3165.795456,47,59,0.34,12,0.028333333,46
3165.713245,54,81,0.75,27,0.027777778,46
3163.979315,50,76,0.91,26,0.035,46
3163.927564,56,83,0.79,27,0.029259259,46
3163.161884,50,76,0.92,26,0.035384615,46
3162.166023,58,67,0.32,9,0.035555556,46
3162.122271,50,74,0.82,24,0.034166667,46
3161.875268,59,66,0.25,7,0.035714286,46
3160.830794,58,82,0.68,24,0.028333333,46
3160.830794,55,86,0.87,31,0.028064516,46
3160.830794,54,87,0.93,33,0.028181818,46
3160.830794,53,88,0.99,35,0.028285714,46
3159.409422,56,70,0.47,14,0.033571429,46
3159.335967,42,65,0.68,23,0.029565217,46
3159.290396,43,62,0.58,19,0.030526316,46
3158.682966,51,75,0.81,24,0.03375,46
3158.682966,50,76,0.88,26,0.033846154,46
3158.455226,37,54,0.59,17,0.034705882,46
3158.113504,70,74,0.09,4,0.0225,46
3157.388992,65,91,0.48,26,0.018461538,46
3157.388992,64,92,0.52,28,0.018571429,46
3157.18882,43,61,0.56,18,0.031111111,46
3157.185458,37,52,0.55,15,0.036666667,46
3156.99702,58,71,0.45,13,0.034615385,46
3156.99702,57,72,0.52,15,0.034666667,46
3156.99702,56,73,0.59,17,0.034705882,46
3156.888738,54,83,0.78,29,0.026896552,46
3156.433233,44,61,0.52,17,0.030588235,46
3154.998906,41,64,0.71,23,0.030869565,46
3154.882244,51,74,0.82,23,0.035652174,46
3154.806987,51,75,0.82,24,0.034166667,46
3154.524111,43,62,0.59,19,0.031052632,46
3154.459926,51,85,0.94,34,0.027647059,46
3153.735346,53,73,0.68,20,0.034,46
3153.363615,49,75,0.9,26,0.034615385,46
3153.363615,48,76,0.97,28,0.034642857,46
3152.272141,55,70,0.54,15,0.036,46
3151.089422,64,81,0.37,17,0.021764706,46
3150.95547,65,84,0.36,19,0.018947368,46
3150.433696,65,84,0.37,19,0.019473684,46
3150.138793,34,56,0.78,22,0.035454545,46
3150.096413,46,57,0.35,11,0.031818182,46
3149.796054,55,74,0.66,19,0.034736842,46
3149.786228,42,63,0.65,21,0.030952381,46
3149.708174,53,79,0.78,26,0.03,46
3149.433523,55,85,0.87,30,0.029,46
3149.433523,54,86,0.93,32,0.0290625,46
3148.564001,35,53,0.7,18,0.038888889,46
3148.375566,41,65,0.74,24,0.030833333,46
3148.364925,39,51,0.42,12,0.035,46
3147.530518,60,87,0.54,27,0.02,46
3146.937525,68,80,0.23,12,0.019166667,46
3146.425269,54,87,0.92,33,0.027878788,46
3145.868056,56,84,0.81,28,0.028928571,46
3145.772651,60,97,0.68,37,0.018378378,46
3144.799813,64,85,0.4,21,0.019047619,46
3144.238859,52,73,0.76,21,0.036190476,46
3144.167351,51,74,0.84,23,0.036521739,46
3144.052679,53,84,0.84,31,0.027096774,46
3144.052679,52,84,0.88,32,0.0275,46
3143.723985,53,72,0.69,19,0.036315789,46
3143.29876,54,87,0.94,33,0.028484848,46
3143.238367,48,52,0.13,4,0.0325,46
3143.238367,46,54,0.26,8,0.0325,46
3143.12253,56,69,0.44,13,0.033846154,46
3143.049979,42,48,0.21,6,0.035,46
3143.049979,41,49,0.28,8,0.035,46
3142.687406,60,65,0.17,5,0.034,46
3142.604138,56,80,0.65,24,0.027083333,46
3142.604138,54,82,0.76,28,0.027142857,46
3142.604138,53,83,0.82,30,0.027333333,46
3142.104435,40,66,0.8,26,0.030769231,46
3141.861822,49,77,0.96,28,0.034285714,46
3141.63422,61,84,0.52,23,0.022608696,46
3139.843896,67,88,0.39,21,0.018571429,46
3139.813405,53,89,0.99,36,0.0275,46
3138.202436,63,87,0.45,24,0.01875,46
3138.144798,56,68,0.44,12,0.036666667,46
3137.889123,50,76,0.89,26,0.034230769,46
3137.14237,66,83,0.33,17,0.019411765,46
3136.782963,52,86,0.91,34,0.026764706,46
3135.428514,73,74,0.02,1,0.02,46
3135.428514,72,75,0.06,3,0.02,46
3135.428514,71,76,0.1,5,0.02,46
3135.428514,70,77,0.14,7,0.02,46
3135.159371,69,78,0.18,9,0.02,46
3135.159371,68,79,0.22,11,0.02,46
3135.159371,67,80,0.26,13,0.02,46
3133.839947,66,79,0.28,13,0.021538462,46
3133.830287,63,86,0.44,23,0.019130435,46
3133.247302,61,98,0.66,37,0.017837838,46
3133.004411,59,92,0.69,33,0.020909091,46
3132.986008,64,80,0.36,16,0.0225,46
3132.753109,51,74,0.79,23,0.034347826,46
3132.589047,51,87,0.96,36,0.026666667,46
3132.297059,43,60,0.53,17,0.031176471,46
3129.826993,51,86,0.95,35,0.027142857,46
3129.724393,57,68,0.39,11,0.035454545,46
3129.493794,51,83,0.92,32,0.02875,46
3128.384805,52,85,0.89,33,0.026969697,46
3128.382112,44,57,0.42,13,0.032307692,46
3128.020103,56,73,0.35,17,0.020588235,46
3126.108858,60,69,0.31,9,0.034444444,46
3126.108858,59,70,0.38,11,0.034545455,46
3124.952441,72,82,0.19,10,0.019,46
3124.458511,70,85,0.28,15,0.018666667,46
3124.281404,56,69,0.47,13,0.036153846,46
3123.501884,46,59,0.4,13,0.030769231,46
3123.132672,44,46,0.07,2,0.035,46
3123.132672,43,47,0.14,4,0.035,46
3122.411385,59,65,0.22,6,0.036666667,46
3121.673305,36,53,0.61,17,0.035882353,46
3120.932589,54,71,0.62,17,0.036470588,46
3119.605931,38,52,0.48,14,0.034285714,46
3119.529882,66,80,0.28,14,0.02,46
3119.529882,65,81,0.32,16,0.02,46
3119.292176,40,50,0.35,10,0.035,46
3118.976183,63,65,0.07,2,0.035,46
3118.976183,62,66,0.14,4,0.035,46
3118.773749,67,87,0.38,20,0.019,46
3118.389467,48,57,0.28,9,0.031111111,46
3118.233998,48,58,0.27,10,0.027,46
3117.588639,36,52,0.6,16,0.0375,46
3117.387765,35,55,0.73,20,0.0365,46
3117.180862,53,73,0.67,20,0.0335,46
3116.741396,52,74,0.75,22,0.034090909,46
3115.983716,37,53,0.57,16,0.035625,46
3115.794809,62,94,0.6,32,0.01875,46
3115.338742,57,94,0.78,37,0.021081081,46
3115.322096,67,82,0.29,15,0.019333333,46
3114.587058,64,83,0.38,19,0.02,46
3114.587058,63,84,0.42,21,0.02,46
3114.337869,51,88,0.98,37,0.026486486,46
3113.942272,62,85,0.46,23,0.02,46
3113.238407,57,69,0.4,12,0.033333333,46
3113.232635,44,59,0.47,15,0.031333333,46
3112.876945,68,86,0.34,18,0.018888889,46
3111.657404,39,50,0.4,11,0.036363636,46
3111.591873,35,55,0.72,20,0.036,46
3111.411808,61,65,0.13,4,0.0325,46
3111.032767,50,56,0.16,6,0.026666667,46
3110.942568,45,59,0.44,14,0.031428571,46
3110.066048,38,52,0.49,14,0.035,46
3109.462133,64,91,0.51,27,0.018888889,46
3108.912147,22,92,0.67,70,0.009571429,46
3108.883482,53,98,0.98,45,0.021777778,46
3108.455893,44,64,0.52,20,0.026,46
3106.42479,46,57,0.34,11,0.030909091,46
3106.292668,45,60,0.46,15,0.030666667,46
3105.635576,37,51,0.51,14,0.036428571,46
3105.38657,52,81,0.86,29,0.029655172,46
3105.043374,50,75,0.89,25,0.0356,46
3103.084312,33,56,0.85,23,0.036956522,46
3103.078281,40,48,0.29,8,0.03625,46
3102.531079,51,82,0.92,31,0.029677419,46
3102.474973,43,63,0.61,20,0.0305,46
3101.473002,43,61,0.55,18,0.030555556,46
3101.449851,48,54,0.19,6,0.031666667,46
3101.309572,34,57,0.82,23,0.035652174,46
3100.614968,55,72,0.58,17,0.034117647,46
3100.508358,44,62,0.54,18,0.03,46
3099.495621,45,61,0.48,16,0.03,46
3099.307107,43,64,0.62,21,0.02952381,46
3098.863305,59,66,0.24,7,0.034285714,46
3098.468058,66,88,0.42,22,0.019090909,46
3096.495215,49,56,0.19,7,0.027142857,46
3095.437113,38,51,0.47,13,0.036153846,46
3094.713132,67,77,0.21,10,0.021,46
3094.11843,62,95,0.61,33,0.018484848,46
3094.11843,61,96,0.65,35,0.018571429,46
3093.629081,71,84,0.24,13,0.018461538,46
3093.083943,56,76,0.6,20,0.03,46
3093.083943,55,77,0.66,22,0.03,46
3092.868684,34,55,0.77,21,0.036666667,46
3092.675039,39,48,0.34,9,0.037777778,46
3092.241212,63,94,0.57,31,0.018387097,46
3092.075569,61,67,0.19,6,0.031666667,46
3091.826015,51,87,0.97,36,0.026944444,46
3091.42125,60,86,0.56,26,0.021538462,46
3091.313953,45,58,0.4,13,0.030769231,46
3089.574975,41,47,0.23,6,0.038333333,46
3089.455751,40,46,0.23,6,0.038333333,46
3088.939607,47,58,0.34,11,0.030909091,46
3088.322776,63,92,0.55,29,0.018965517,46
3085.92169,62,87,0.48,25,0.0192,46
3085.176109,61,68,0.22,7,0.031428571,46
3085.176109,58,71,0.41,13,0.031538462,46
3084.818725,34,54,0.78,20,0.039,46
3084.666799,61,67,0.21,6,0.035,46
3084.666799,60,68,0.28,8,0.035,46
3084.666799,59,69,0.35,10,0.035,46
3084.666799,58,70,0.42,12,0.035,46
3084.639908,46,60,0.37,14,0.026428571,46
3084.222143,59,82,0.53,23,0.023043478,46
3083.993744,46,60,0.42,14,0.03,46
3083.933704,59,71,0.41,12,0.034166667,46
3083.862484,51,54,0.08,3,0.026666667,46
3083.208213,51,85,0.95,34,0.027941176,46
3082.716272,50,84,0.99,34,0.029117647,46
3082.381596,67,77,0.22,10,0.022,46
3081.745276,52,85,0.9,33,0.027272727,46
3081.182303,53,77,0.82,24,0.034166667,46
3081.182303,52,78,0.89,26,0.034230769,46
3081.110429,40,67,0.71,27,0.026296296,46
3079.790335,62,83,0.47,21,0.022380952,46
3078.842788,68,77,0.19,9,0.021111111,46
3078.679555,32,60,0.99,28,0.035357143,46
3078.64408,58,78,0.54,20,0.027,46
3078.003962,38,71,0.85,33,0.025757576,46
3077.3596,65,79,0.31,14,0.022142857,46
3077.026915,56,90,0.76,34,0.022352941,46
3076.603532,64,84,0.4,20,0.02,46
3076.474904,54,86,0.84,32,0.02625,46
3076.114903,63,86,0.45,23,0.019565217,46
3076.013284,63,86,0.48,23,0.020869565,46
3075.208034,54,86,0.92,32,0.02875,46
3075.152817,55,75,0.69,20,0.0345,46
3074.561528,61,68,0.24,7,0.034285714,46
3074.227652,61,65,0.14,4,0.035,46
3074.1338,51,79,0.96,28,0.034285714,46
3073.942265,36,74,0.98,38,0.025789474,46
3073.571889,59,98,0.72,39,0.018461538,46
3073.079688,37,50,0.49,13,0.037692308,46
3072.750421,47,55,0.25,8,0.03125,46
3071.428625,52,75,0.79,23,0.034347826,46
3071.084912,65,89,0.46,24,0.019166667,46
3070.781302,51,86,0.96,35,0.027428571,46
3070.53375,41,65,0.73,24,0.030416667,46
3069.897268,62,73,0.3,11,0.027272727,46
3069.825698,53,88,0.98,35,0.028,46
3069.79369,64,80,0.33,16,0.020625,46
3068.629519,33,59,0.91,26,0.035,46
3068.586417,39,69,0.78,30,0.026,46
3068.347543,54,73,0.65,19,0.034210526,46
3068.274473,32,58,0.95,26,0.036538462,46
3068.066025,69,79,0.21,10,0.021,46
3067.316228,53,74,0.69,21,0.032857143,46
3066.962695,47,60,0.34,13,0.026153846,46
3066.232977,33,58,0.95,25,0.038,46
3065.847634,41,64,0.7,23,0.030434783,46
3065.482122,64,85,0.41,21,0.01952381,46
3065.40614,57,89,0.71,32,0.0221875,46
3065.40614,55,92,0.82,37,0.022162162,46
3064.459221,50,77,0.95,27,0.035185185,46
3064.218919,40,48,0.3,8,0.0375,46
3063.470293,69,85,0.3,16,0.01875,46
3063.420368,52,81,0.87,29,0.03,46
3063.41295,52,91,0.89,39,0.022820513,46
3063.238215,60,86,0.73,26,0.028076923,46
3063.238215,58,89,0.86,31,0.027741935,46
3063.238215,57,90,0.92,33,0.027878788,46
3061.712076,52,75,0.76,23,0.033043478,46
3061.712076,51,76,0.83,25,0.0332,46
3061.151996,57,75,0.54,18,0.03,46
3061.106377,61,85,0.52,24,0.021666667,46
3061.069679,60,85,0.56,25,0.0224,46
3060.044158,66,79,0.37,13,0.028461538,46
3059.868942,45,57,0.38,12,0.031666667,46
3059.647023,71,83,0.23,12,0.019166667,46
3059.209649,52,76,0.82,24,0.034166667,46
3059.209649,51,77,0.89,26,0.034230769,46
3058.120023,53,74,0.74,21,0.035238095,46
3057.803156,57,70,0.31,13,0.023846154,46
3056.604071,59,68,0.3,9,0.033333333,46
3056.541184,44,61,0.53,17,0.031176471,46
3056.079114,39,69,0.8,30,0.026666667,46
3055.76404,50,83,0.98,33,0.02969697,46
3055.686127,37,51,0.52,14,0.037142857,46
3055.337395,59,68,0.31,9,0.034444444,46
3055.03123,54,77,0.78,23,0.033913043,46
3054.783483,41,66,0.76,25,0.0304,46
3054.273363,59,87,0.79,28,0.028214286,46
3054.095653,54,75,0.73,21,0.034761905,46
3053.956159,53,87,0.99,34,0.029117647,46
3052.923401,54,74,0.68,20,0.034,46
3052.923401,53,75,0.75,22,0.034090909,46
3052.447163,55,73,0.58,18,0.032222222,46
3052.193852,28,76,0.5,48,0.010416667,46
3052.180924,40,67,0.83,27,0.030740741,46
3051.696825,62,63,0.03,1,0.03,46
3051.696825,61,64,0.09,3,0.03,46
3051.199319,53,76,0.54,23,0.023478261,46
3050.84436,55,73,0.63,18,0.035,46
3050.84436,52,77,0.87,25,0.0348,46
3050.84436,51,78,0.94,27,0.034814815,46
3050.828067,53,73,0.7,20,0.035,46
3050.610754,69,79,0.19,10,0.019,46
3050.490923,59,98,0.73,39,0.018717949,46
3050.396111,47,59,0.32,12,0.026666667,46
3049.789052,61,85,0.5,24,0.020833333,46
3049.637672,66,77,0.25,11,0.022727273,46
3049.507271,61,84,0.51,23,0.022173913,46
3049.506314,68,87,0.36,19,0.018947368,46
3049.2427,58,68,0.35,10,0.035,46
3049.230189,62,84,0.61,22,0.027727273,46
3049.038781,61,88,0.56,27,0.020740741,46
3048.758429,51,76,0.87,25,0.0348,46
3048.714819,53,74,0.72,21,0.034285714,46
3048.642539,52,74,0.77,22,0.035,46
3048.086164,65,83,0.38,18,0.021111111,46
3048.037458,57,70,0.46,13,0.035384615,46
3048.037458,54,74,0.7,20,0.035,46
3047.640936,55,71,0.55,16,0.034375,46
3047.395888,62,84,0.45,22,0.020454545,46
3047.389832,53,80,0.79,27,0.029259259,46
3047.268479,65,80,0.31,15,0.020666667,46
3047.143626,62,64,0.07,2,0.035,46
3047.143626,60,66,0.21,6,0.035,46
3047.143626,59,67,0.28,8,0.035,46
3046.926204,50,78,0.97,28,0.034642857,46
3046.405784,57,70,0.42,13,0.032307692,46
3046.324473,68,81,0.25,13,0.019230769,46
3045.699371,54,73,0.66,19,0.034736842,46
3045.699371,53,74,0.73,21,0.034761905,46
3045.173496,49,78,0.99,29,0.034137931,46
3044.934635,34,58,0.82,24,0.034166667,46
3044.895218,43,61,0.57,18,0.031666667,46
3044.820137,52,74,0.78,22,0.035454545,46
3044.820137,51,75,0.85,24,0.035416667,46
3044.809762,63,95,0.58,32,0.018125,46
3044.77577,46,60,0.4,14,0.028571429,46
3044.739251,55,72,0.59,17,0.034705882,46
3044.382495,54,73,0.67,19,0.035263158,46
3044.053962,45,61,0.46,16,0.02875,46
3043.231066,65,74,0.26,9,0.028888889,46
3042.881855,57,71,0.33,14,0.023571429,46
3042.828284,56,71,0.49,15,0.032666667,46
3042.405992,52,79,0.91,27,0.033703704,46
3042.239777,55,71,0.47,16,0.029375,46
3042.178185,38,53,0.52,15,0.034666667,46
3042.128147,59,73,0.42,14,0.03,46
3041.089379,52,75,0.81,23,0.035217391,46
3040.980538,42,64,0.59,22,0.026818182,46
3040.905911,59,69,0.32,10,0.032,46
3040.687625,67,74,0.16,7,0.022857143,46
3040.507052,60,85,0.51,25,0.0204,46
3039.810753,63,76,0.38,13,0.029230769,46
3039.783558,64,85,0.44,21,0.020952381,46
3039.643811,55,89,0.88,34,0.025882353,46
3039.643811,54,91,0.95,37,0.025675676,46
3039.412861,47,58,0.32,11,0.029090909,46
3039.321591,57,88,0.88,31,0.028387097,46
3039.131457,58,69,0.39,11,0.035454545,46
3038.836391,30,73,0.45,43,0.010465116,46
3038.646283,54,73,0.62,19,0.032631579,46
3038.627012,33,55,0.86,22,0.039090909,46
3038.48063,57,71,0.48,14,0.034285714,46
3038.35161,53,87,0.9,34,0.026470588,46
3038.211067,60,67,0.24,7,0.034285714,46
3037.927247,66,74,0.19,8,0.02375,46
3037.735702,42,64,0.68,22,0.030909091,46
3037.673193,54,76,0.76,22,0.034545455,46
3037.673193,53,77,0.83,24,0.034583333,46
3037.425667,61,84,0.47,23,0.020434783,46
3037.360224,63,81,0.5,18,0.027777778,46
3037.360224,60,85,0.69,25,0.0276,46
3037.24616,65,85,0.38,20,0.019,46
3037.14708,69,80,0.21,11,0.019090909,46
3037.044116,55,72,0.57,17,0.033529412,46
3036.847599,50,78,0.95,28,0.033928571,46
3036.438911,59,68,0.32,9,0.035555556,46
3036.136692,60,62,0.07,2,0.035,46
3036.045354,58,70,0.28,12,0.023333333,46
3035.815137,62,79,0.39,17,0.022941176,46
3035.570133,58,88,0.67,30,0.022333333,46
3035.011732,64,81,0.38,17,0.022352941,46
3034.756406,55,71,0.57,16,0.035625,46
3034.754123,62,82,0.56,20,0.028,46
3034.724703,36,51,0.58,15,0.038666667,46
3034.6988,77,81,0.07,4,0.0175,46
3034.370847,37,73,0.92,36,0.025555556,46
3032.956729,67,78,0.23,11,0.020909091,46
3032.912966,52,76,0.78,24,0.0325,46
3032.752236,67,78,0.29,11,0.026363636,46
3032.672952,42,46,0.15,4,0.0375,46
3032.520394,64,81,0.48,17,0.028235294,46
3032.50289,58,69,0.36,11,0.032727273,46
3032.478029,60,97,0.69,37,0.018648649,46
3031.779123,42,64,0.67,22,0.030454545,46
3031.752638,69,75,0.13,6,0.021666667,46
3031.3482,56,73,0.54,17,0.031764706,46
3031.3482,54,75,0.67,21,0.031904762,46
3031.28978,67,75,0.18,8,0.0225,46
3031.194852,56,91,0.92,35,0.026285714,46
3031.120984,54,72,0.62,18,0.034444444,46
3031.120984,53,73,0.69,20,0.0345,46
3030.880315,43,65,0.58,22,0.026363636,46
3030.870755,43,65,0.57,22,0.025909091,46
3030.739665,51,77,0.85,26,0.032692308,46
3030.338066,51,80,0.99,29,0.034137931,46
3030.263413,61,97,0.66,36,0.018333333,46
3030.236062,60,98,0.7,38,0.018421053,46
3030.044877,57,71,0.49,14,0.035,46
3029.869302,57,71,0.45,14,0.032142857,46
3029.628605,61,69,0.27,8,0.03375,46
3029.607244,62,85,0.59,23,0.025652174,46
3029.390567,38,50,0.46,12,0.038333333,46
3029.254732,59,99,0.74,40,0.0185,46
3028.779633,39,47,0.31,8,0.03875,46
3028.261803,57,69,0.42,12,0.035,46
3028.261803,56,70,0.49,14,0.035,46
3028.261803,55,71,0.56,16,0.035,46
3028.261803,54,72,0.63,18,0.035,46
3028.122839,59,87,0.61,28,0.021785714,46
3027.852559,50,78,0.96,28,0.034285714,46
3027.780758,50,77,0.94,27,0.034814815,46
3027.574001,44,62,0.48,18,0.026666667,46
3027.537166,52,88,0.95,36,0.026388889,46
3027.52204,60,65,0.15,5,0.03,46
3027.52204,59,66,0.21,7,0.03,46
3027.52204,58,67,0.27,9,0.03,46
3027.47625,54,72,0.64,18,0.035555556,46
3027.47625,53,73,0.71,20,0.0355,46
3027.120263,61,67,0.14,6,0.023333333,46
3027.089907,58,99,0.78,41,0.01902439,46
3026.816325,36,52,0.62,16,0.03875,46
3026.613493,62,87,0.51,25,0.0204,46
3026.573754,51,80,0.98,29,0.033793103,46
3026.372113,63,82,0.39,19,0.020526316,46
3026.372113,62,83,0.43,21,0.02047619,46
3026.257209,45,61,0.49,16,0.030625,46
3026.257209,44,62,0.55,18,0.030555556,46
3026.256739,64,86,0.42,22,0.019090909,46
3026.256739,63,87,0.46,24,0.019166667,46
3026.243538,61,85,0.67,24,0.027916667,46
3026.206987,52,75,0.8,23,0.034782609,46
3025.771901,54,88,0.93,34,0.027352941,46
3025.745021,59,87,0.57,28,0.020357143,46
3025.704301,59,68,0.29,9,0.032222222,46
3025.545626,44,63,0.5,19,0.026315789,46
3025.412904,56,85,0.82,29,0.028275862,46
3025.412904,55,86,0.88,31,0.028387097,46
3025.272262,55,76,0.71,21,0.033809524,46
3024.97538,52,78,0.9,26,0.034615385,46
3024.97419,68,81,0.27,13,0.020769231,46
3024.18337,56,72,0.56,16,0.035,46
3024.18337,53,76,0.8,23,0.034782609,46
3024.138231,61,82,0.47,21,0.022380952,46
3024.131585,33,56,0.89,23,0.038695652,46
3024.10115,35,54,0.7,19,0.036842105,46
3023.982259,38,71,0.87,33,0.026363636,46
3023.603752,55,87,0.87,32,0.0271875,46
3023.576771,62,93,0.59,31,0.019032258,46
3023.193502,55,93,0.99,38,0.026052632,46
3023.166725,58,68,0.36,10,0.036,46
3023.04397,56,95,0.83,39,0.021282051,46
3023.041893,57,87,0.66,30,0.022,46
3022.993015,58,86,0.61,28,0.021785714,46
3022.829083,35,57,0.76,22,0.034545455,46
3022.634444,52,82,0.87,30,0.029,46
3022.634444,51,83,0.93,32,0.0290625,46
3022.426573,45,62,0.45,17,0.026470588,46
3022.256033,61,83,0.45,22,0.020454545,46
3022.119982,56,74,0.61,18,0.033888889,46
3022.079172,64,81,0.36,17,0.021176471,46
3021.907529,57,81,0.69,24,0.02875,46
3021.795932,52,89,0.97,37,0.026216216,46
3021.470732,58,84,0.73,26,0.028076923,46
3021.325871,45,61,0.42,16,0.02625,46
3021.07239,62,66,0.13,4,0.0325,46
3021.07239,60,68,0.26,8,0.0325,46
3020.997068,64,81,0.45,17,0.026470588,46
3020.997068,61,85,0.63,24,0.02625,46
3020.997068,59,87,0.74,28,0.026428571,46
3020.997068,58,89,0.81,31,0.026129032,46
3020.617825,67,78,0.24,11,0.021818182,46
3020.451245,62,84,0.48,22,0.021818182,46
3020.37818,36,53,0.62,17,0.036470588,46
3020.285126,53,80,0.9,27,0.033333333,46
3020.129144,57,93,0.76,36,0.021111111,46
3019.754629,65,85,0.41,20,0.0205,46
3019.744909,51,76,0.88,25,0.0352,46
3019.731332,60,82,0.5,22,0.022727273,46
3019.719353,50,76,0.94,26,0.036153846,46
3019.598345,58,70,0.39,12,0.0325,46
3019.548038,50,79,0.98,29,0.033793103,46
3019.28283,53,79,0.87,26,0.033461538,46
3019.123367,51,79,0.97,28,0.034642857,46
3019.121951,56,70,0.5,14,0.035714286,46
3018.888733,63,82,0.51,19,0.026842105,46
3018.888733,61,84,0.62,23,0.026956522,46
3018.888733,61,85,0.64,24,0.026666667,46
3018.888733,59,87,0.75,28,0.026785714,46
3018.888733,57,89,0.86,32,0.026875,46
3018.340432,43,64,0.55,21,0.026190476,46
3018.16875,32,59,0.96,27,0.035555556,46
3018.165269,63,83,0.43,20,0.0215,46
3018.159405,62,67,0.17,5,0.034,46
3018.159405,57,72,0.51,15,0.034,46
3018.08889,48,57,0.24,9,0.026666667,46
3017.917687,55,77,0.74,22,0.033636364,46
3017.917687,54,78,0.81,24,0.03375,46
3017.906834,58,69,0.38,11,0.034545455,46
3017.906834,57,70,0.45,13,0.034615385,46
3017.906834,56,71,0.52,15,0.034666667,46
3017.745104,44,56,0.41,12,0.034166667,46
3017.745104,43,57,0.48,14,0.034285714,46
3017.745104,42,58,0.55,16,0.034375,46
3017.718772,63,81,0.4,18,0.022222222,46
3017.639577,65,79,0.29,14,0.020714286,46
3017.463393,64,93,0.53,29,0.018275862,46
3017.387592,67,82,0.31,15,0.020666667,46
3017.379877,51,76,0.86,25,0.0344,46
3017.379877,50,77,0.93,27,0.034444444,46
3017.341811,70,75,0.14,5,0.028,46
3017.112757,52,81,0.97,29,0.033448276,46
3016.963638,55,92,0.98,37,0.026486486,46
3016.843751,51,77,0.9,26,0.034615385,46
3016.776978,29,75,0.5,46,0.010869565,46
3016.759289,53,78,0.85,25,0.034,46
3016.630328,57,68,0.33,11,0.03,46
3016.630328,56,69,0.39,13,0.03,46
3016.630328,55,70,0.45,15,0.03,46
3016.602154,45,55,0.34,10,0.034,46
3016.45951,61,96,0.62,35,0.017714286,46
3016.268633,54,78,0.72,24,0.03,46
3016.015012,57,74,0.57,17,0.033529412,46
3015.863998,47,59,0.29,12,0.024166667,46
3015.688808,51,79,0.95,28,0.033928571,46
3015.540909,65,67,0.06,2,0.03,46
3015.540909,64,68,0.12,4,0.03,46
3015.540909,63,69,0.18,6,0.03,46
3015.540909,62,70,0.24,8,0.03,46
3015.540909,61,71,0.3,10,0.03,46
3015.540909,60,72,0.36,12,0.03,46
3015.528745,56,71,0.5,15,0.033333333,46
3015.256047,59,69,0.34,10,0.034,46
3014.999039,48,57,0.26,9,0.028888889,46
3014.8946,70,89,0.33,19,0.017368421,46
3014.414654,65,95,0.52,30,0.017333333,46
3014.324358,56,71,0.53,15,0.035333333,46
3014.324358,55,72,0.6,17,0.035294118,46
3014.324358,53,75,0.77,22,0.035,46
3014.324358,52,76,0.84,24,0.035,46
3014.124246,52,75,0.67,23,0.029130435,46
3014.124246,51,76,0.73,25,0.0292,46
3013.720081,54,71,0.51,17,0.03,46
3013.720081,54,72,0.53,18,0.029444444,46
3013.720081,53,73,0.59,20,0.0295,46
3013.720081,52,74,0.65,22,0.029545455,46
3013.672956,64,79,0.34,15,0.022666667,46
3013.532081,47,58,0.29,11,0.026363636,46
3013.021778,60,87,0.7,27,0.025925926,46
3013.021778,57,90,0.86,33,0.026060606,46
3012.97345,55,75,0.68,20,0.034,46
3012.97345,54,76,0.75,22,0.034090909,46
3012.784544,54,85,0.89,31,0.028709677,46
3012.75195,64,78,0.39,14,0.027857143,46
3012.75195,61,82,0.58,21,0.027619048,46
3012.538582,60,86,0.53,26,0.020384615,46
3012.455245,50,76,0.93,26,0.035769231,46
3012.438608,58,72,0.48,14,0.034285714,46
3012.438608,57,73,0.55,16,0.034375,46
3012.438608,56,74,0.62,18,0.034444444,46
3011.994355,61,95,0.63,34,0.018529412,46
3011.994355,60,96,0.67,36,0.018611111,46
3011.701614,58,70,0.41,12,0.034166667,46
3011.436317,46,61,0.39,15,0.026,46
3011.250541,52,78,0.88,26,0.033846154,46
3011.178931,60,65,0.18,5,0.036,46
3011.062722,50,78,0.98,28,0.035,46
3010.777232,63,82,0.54,19,0.028421053,46
3010.765284,65,80,0.4,15,0.026666667,46
3010.765284,62,83,0.56,21,0.026666667,46
3010.765284,62,84,0.58,22,0.026363636,46
3010.723176,34,54,0.75,20,0.0375,46
3010.721052,60,85,0.55,25,0.022,46
3010.592066,56,81,0.67,25,0.0268,46
3010.563432,60,70,0.34,10,0.034,46
3010.301075,63,80,0.37,17,0.021764706,46
3009.72721,36,74,0.99,38,0.026052632,46
3009.692424,55,87,0.89,32,0.0278125,46
3009.692424,54,88,0.95,34,0.027941176,46
3009.30658,54,91,0.94,37,0.025405405,46
3009.223737,42,65,0.7,23,0.030434783,46
3008.922999,54,97,0.93,43,0.021627907,46
3008.731028,67,77,0.27,10,0.027,46
3008.662249,51,84,0.95,33,0.028787879,46
3008.588637,55,84,0.77,29,0.026551724,46
3008.470679,61,87,0.55,26,0.021153846,46
3008.42382,37,50,0.5,13,0.038461538,46
3008.149599,52,82,0.88,30,0.029333333,46
3007.924728,65,81,0.31,16,0.019375,46
3007.884037,38,49,0.42,11,0.038181818,46
3007.585575,60,77,0.49,17,0.028823529,46
3007.551032,67,79,0.34,12,0.028333333,46
3007.524769,54,75,0.49,21,0.023333333,46
3007.365813,75,83,0.14,8,0.0175,46
3007.185585,58,88,0.8,30,0.026666667,46
3007.185585,56,91,0.93,35,0.026571429,46
3006.745077,60,86,0.69,26,0.026538462,46
3006.671934,69,73,0.09,4,0.0225,46
3006.479087,66,75,0.26,9,0.028888889,46
3006.07055,54,88,0.94,34,0.027647059,46
3006.07055,54,89,0.96,35,0.027428571,46
3005.609658,51,76,0.74,25,0.0296,46
3005.609658,50,77,0.8,27,0.02962963,46
3005.495481,49,78,0.86,29,0.029655172,46
3005.3825,55,74,0.44,19,0.023157895,46
3005.233383,60,87,0.75,27,0.027777778,46
3004.906549,41,66,0.65,25,0.026,46
3004.875064,53,91,0.99,38,0.026052632,46
3004.8712,58,80,0.63,22,0.028636364,46
3004.820621,58,77,0.52,19,0.027368421,46
3004.589333,37,51,0.54,14,0.038571429,46
3004.432466,64,78,0.32,14,0.022857143,46
3004.386966,40,61,0.71,21,0.033809524,46
3004.303947,53,89,0.98,36,0.027222222,46
3004.216074,51,80,0.97,29,0.033448276,46
3004.153553,39,68,0.96,29,0.033103448,46
3004.148267,54,79,0.83,25,0.0332,46
3004.129979,51,79,0.94,28,0.033571429,46
3004.10123,66,89,0.44,23,0.019130435,46
3003.92771,63,79,0.44,16,0.0275,46
3003.739211,51,78,0.92,27,0.034074074,46
3003.739211,50,79,0.99,29,0.034137931,46
3003.664788,65,77,0.27,12,0.0225,46
3003.464606,58,92,0.71,34,0.020882353,46
3003.442007,46,54,0.27,8,0.03375,46
3003.395788,55,81,0.71,26,0.027307692,46
3003.370631,54,90,0.93,36,0.025833333,46
3003.00641,55,78,0.69,23,0.03,46
3002.909557,52,76,0.79,24,0.032916667,46
3002.909557,51,77,0.86,26,0.033076923,46
3002.737872,46,60,0.34,14,0.024285714,46
3002.578471,57,95,0.78,38,0.020526316,46
3002.473549,69,76,0.15,7,0.021428571,46
3002.327033,68,74,0.17,6,0.028333333,46
3002.30911,54,79,0.75,25,0.03,46
3002.30911,53,80,0.81,27,0.03,46
3002.115772,57,91,0.93,34,0.027352941,46
3002.115772,56,92,0.99,36,0.0275,46
3002.024111,67,78,0.31,11,0.028181818,46
3001.566214,57,81,0.73,24,0.030416667,46
3001.542428,63,95,0.56,32,0.0175,46
3001.519755,65,87,0.44,22,0.02,46
3001.458166,65,77,0.33,12,0.0275,46
3001.364692,54,75,0.71,21,0.033809524,46
3001.364692,53,76,0.78,23,0.033913043,46
3001.351186,62,85,0.47,23,0.020434783,46
3001.159106,62,65,0.1,3,0.033333333,46
3001.154956,52,88,0.96,36,0.026666667,46
3001.133296,36,53,0.6,17,0.035294118,46
3000.95443,69,86,0.32,17,0.018823529,46
3000.858843,49,55,0.16,6,0.026666667,46
3000.776305,60,91,0.65,31,0.020967742,46
3000.757116,37,72,0.92,35,0.026285714,46
3000.528731,59,73,0.47,14,0.033571429,46
3000.453681,43,63,0.62,20,0.031,46
3000.310109,61,86,0.69,25,0.0276,46
3000.221166,67,72,0.12,5,0.024,46
2999.895042,55,73,0.59,18,0.032777778,46
2999.811683,58,71,0.44,13,0.033846154,46
2999.811683,54,76,0.74,22,0.033636364,46
2999.811683,53,77,0.81,24,0.03375,46
2999.728291,56,77,0.7,21,0.033333333,46
2999.562958,65,76,0.31,11,0.028181818,46
2999.479739,57,88,0.7,31,0.022580645,46
2999.382779,53,74,0.7,21,0.033333333,46
2999.382779,52,75,0.77,23,0.033478261,46
2999.382779,51,76,0.84,25,0.0336,46
2999.202829,69,75,0.16,6,0.026666667,46
2999.12031,56,82,0.75,26,0.028846154,46
2999.039024,56,75,0.64,19,0.033684211,46
2998.916354,51,75,0.86,24,0.035833333,46
2998.854585,41,60,0.64,19,0.033684211,46
2998.82887,62,85,0.45,23,0.019565217,46
2998.714324,58,74,0.48,16,0.03,46
2998.671854,67,88,0.4,21,0.019047619,46
2998.547634,60,78,0.51,18,0.028333333,46
2998.547634,59,79,0.57,20,0.0285,46
2998.532805,64,82,0.35,18,0.019444444,46
2998.244803,41,67,0.62,26,0.023846154,46
2998.156884,59,88,0.75,29,0.025862069,46
2998.152655,68,73,0.14,5,0.028,46
2998.001579,54,72,0.65,18,0.036111111,46
2997.880896,57,76,0.55,19,0.028947368,46
2997.880896,56,77,0.61,21,0.029047619,46
2997.838427,56,72,0.52,16,0.0325,46
2997.780138,41,68,0.7,27,0.025925926,46
2997.728035,54,75,0.72,21,0.034285714,46
2997.728035,53,76,0.79,23,0.034347826,46
2997.728035,52,77,0.86,25,0.0344,46
2997.529889,51,77,0.91,26,0.035,46
2997.346161,59,86,0.61,27,0.022592593,46
2996.974399,37,54,0.6,17,0.035294118,46
2996.935954,61,83,0.63,22,0.028636364,46
2996.854423,63,79,0.46,16,0.02875,46
2996.83787,64,78,0.4,14,0.028571429,46
2996.748345,55,78,0.67,23,0.029130435,46
2996.680584,59,79,0.6,20,0.03,46
2996.680584,56,83,0.8,27,0.02962963,46
2996.583726,56,83,0.76,27,0.028148148,46
2996.583726,55,84,0.82,29,0.028275862,46
2996.534088,67,83,0.3,16,0.01875,46
2996.156037,62,80,0.4,18,0.022222222,46
2996.066961,55,83,0.87,28,0.031071429,46
2995.972389,49,79,0.88,30,0.029333333,46
2995.954591,57,84,0.75,27,0.027777778,46
2995.954591,55,87,0.88,32,0.0275,46
2995.889331,64,82,0.51,18,0.028333333,46
2995.871571,52,75,0.82,23,0.035652174,46
2995.565495,29,74,0.49,45,0.010888889,46
2995.176793,42,59,0.57,17,0.033529412,46
2995.087497,57,90,0.87,33,0.026363636,46
2994.988156,58,75,0.49,17,0.028823529,46
2994.972398,54,85,0.82,31,0.026451613,46
2994.968451,52,76,0.83,24,0.034583333,46
2994.968451,51,78,0.93,27,0.034444444,46
2994.85604,57,78,0.58,21,0.027619048,46
2994.843678,43,63,0.54,20,0.027,46
2994.823781,53,74,0.75,21,0.035714286,46
2994.823781,52,76,0.85,24,0.035416667,46
2994.816358,60,97,0.71,37,0.019189189,46
2994.816358,59,98,0.75,39,0.019230769,46
2994.816358,58,99,0.79,41,0.019268293,46
2994.755734,58,87,0.65,29,0.022413793,46
2994.281535,36,55,0.66,19,0.034736842,46
2994.241961,60,96,0.7,36,0.019444444,46
2994.192954,50,77,0.97,27,0.035925926,46
2993.856663,55,79,0.68,24,0.028333333,46
2993.856663,54,80,0.74,26,0.028461538,46
2993.856663,53,81,0.8,28,0.028571429,46
2993.856663,52,82,0.86,30,0.028666667,46
2993.692198,57,82,0.7,25,0.028,46
2993.692198,54,86,0.89,32,0.0278125,46
2993.692198,53,87,0.95,34,0.027941176,46
2993.590426,57,81,0.64,24,0.026666667,46
2993.494264,57,89,0.68,32,0.02125,46
2993.228297,67,75,0.23,8,0.02875,46
2992.916583,52,80,0.95,28,0.033928571,46
2992.895529,58,88,0.66,30,0.022,46
2992.817606,56,72,0.55,16,0.034375,46
2992.724294,51,77,0.92,26,0.035384615,46
2992.724294,50,78,0.99,28,0.035357143,46
2992.651907,29,74,0.5,45,0.011111111,46
2992.357207,60,67,0.23,7,0.032857143,46
2992.277174,57,69,0.43,12,0.035833333,46
2991.811239,58,84,0.59,26,0.022692308,46
2991.707846,54,84,0.94,30,0.031333333,46
2991.654279,60,98,0.67,38,0.017631579,46
2991.556559,41,68,0.71,27,0.026296296,46
2991.507481,68,78,0.21,10,0.021,46
2991.397574,61,86,0.51,25,0.0204,46
2990.939001,54,87,0.86,33,0.026060606,46
2990.816845,41,65,0.72,24,0.03,46
2990.755873,38,71,0.86,33,0.026060606,46
2990.670827,66,84,0.34,18,0.018888889,46
2990.640307,66,83,0.32,17,0.018823529,46
2990.5597,55,73,0.62,18,0.034444444,46
2990.5597,54,74,0.69,20,0.0345,46
2990.5597,53,75,0.76,22,0.034545455,46
2990.535138,42,65,0.69,23,0.03,46
2990.267377,66,82,0.34,16,0.02125,46
2990.065394,66,76,0.28,10,0.028,46
2990.064763,57,68,0.4,11,0.036363636,46
2989.975181,63,83,0.56,20,0.028,46
2989.952347,61,82,0.46,21,0.021904762,46
2989.874458,58,84,0.74,26,0.028461538,46
2989.649185,56,86,0.82,30,0.027333333,46
2989.622553,73,85,0.21,12,0.0175,46
2989.622553,71,87,0.28,16,0.0175,46
2989.584371,57,60,0.11,3,0.036666667,46
2989.511341,65,76,0.25,11,0.022727273,46
2989.508177,59,72,0.44,13,0.033846154,46
2989.506497,59,84,0.56,25,0.0224,46
2989.506497,57,86,0.65,29,0.022413793,46
2989.373038,66,76,0.23,10,0.023,46
2989.319831,58,82,0.69,24,0.02875,46
2989.179944,57,76,0.63,19,0.033157895,46
2989.17808,40,67,0.82,27,0.03037037,46
2989.066722,57,82,0.69,25,0.0276,46
2989.010575,60,83,0.52,23,0.022608696,46
2988.820032,43,63,0.53,20,0.0265,46
2988.777499,59,89,0.61,30,0.020333333,46
2988.732598,57,86,0.64,29,0.022068966,46
2988.701341,53,86,0.88,33,0.026666667,46
2988.66373,59,83,0.54,24,0.0225,46
2988.520555,58,90,0.65,32,0.0203125,46
2988.170759,29,75,0.51,46,0.011086957,46
2988.042142,63,78,0.42,15,0.028,46
2988.042142,59,83,0.67,24,0.027916667,46
2988.024978,61,96,0.63,35,0.018,46
2987.989306,66,80,0.29,14,0.020714286,46
2987.97488,54,79,0.73,25,0.0292,46
2987.878002,60,86,0.52,26,0.02,46
2987.734297,68,91,0.4,23,0.017391304,46
2987.593984,40,66,0.81,26,0.031153846,46
2987.57355,63,82,0.5,19,0.026315789,46
2987.565419,64,75,0.32,11,0.029090909,46
2987.366138,63,85,0.46,22,0.020909091,46
2987.305005,56,89,0.94,33,0.028484848,46
2987.258535,65,94,0.51,29,0.017586207,46
2986.98316,58,83,0.71,25,0.0284,46
2986.979818,36,52,0.61,16,0.038125,46
2986.321461,70,84,0.27,14,0.019285714,46
2986.321461,69,85,0.31,16,0.019375,46
2986.222793,61,86,0.53,25,0.0212,46
2985.792441,41,67,0.77,26,0.029615385,46
2985.52041,60,89,0.6,29,0.020689655,46
2985.476339,52,77,0.85,25,0.034,46
2985.263153,45,61,0.43,16,0.026875,46
2984.877686,37,73,0.93,36,0.025833333,46
2984.764035,56,85,0.81,29,0.027931034,46
2984.578491,53,75,0.72,22,0.032727273,46
2984.512065,59,88,0.61,29,0.021034483,46
2984.477139,56,88,0.71,32,0.0221875,46
2984.477139,55,89,0.75,34,0.022058824,46
2984.102649,55,88,0.74,33,0.022424242,46
2984.056097,35,52,0.67,17,0.039411765,46
2983.897839,51,75,0.87,24,0.03625,46
2983.864979,62,80,0.41,18,0.022777778,46
2983.808109,54,87,0.95,33,0.028787879,46
2983.736948,58,87,0.81,29,0.027931034,46
2983.719986,64,82,0.38,18,0.021111111,46
2983.670027,41,66,0.75,25,0.03,46
2983.360051,57,83,0.75,26,0.028846154,46
2983.288598,60,88,0.6,28,0.021428571,46
2983.28348,44,61,0.46,17,0.027058824,46
2983.030741,63,83,0.42,20,0.021,46
2982.670566,61,84,0.63,23,0.027391304,46
2982.662542,37,72,0.97,35,0.027714286,46
2982.661375,58,91,0.7,33,0.021212121,46
2982.659864,73,75,0.04,2,0.02,46
2982.406058,45,61,0.39,16,0.024375,46
2982.381048,57,85,0.79,28,0.028214286,46
2981.853462,52,87,0.94,35,0.026857143,46
2981.754,54,89,0.95,35,0.027142857,46
2981.716615,54,78,0.8,24,0.033333333,46
2981.460227,61,97,0.63,36,0.0175,46
2981.4292,59,88,0.81,29,0.027931034,46
2981.276745,63,83,0.39,20,0.0195,46
2981.124253,55,74,0.39,19,0.020526316,46
2981.033062,63,77,0.33,14,0.023571429,46
2980.854837,65,90,0.48,25,0.0192,46
2980.83983,59,86,0.75,27,0.027777778,46
2980.83983,57,89,0.88,32,0.0275,46
2980.83983,56,90,0.94,34,0.027647059,46
2980.820101,57,89,0.85,32,0.0265625,46
2980.818753,61,85,0.51,24,0.02125,46
2980.804985,39,69,0.79,30,0.026333333,46
2980.444354,36,51,0.57,15,0.038,46
2979.986168,46,53,0.24,7,0.034285714,46
2979.924931,41,67,0.68,26,0.026153846,46
2979.683669,60,86,0.68,26,0.026153846,46
2979.557731,55,92,0.78,37,0.021081081,46
2979.516806,59,87,0.56,28,0.02,46
2978.868272,61,89,0.58,28,0.020714286,46
2978.805427,56,90,0.91,34,0.026764706,46
2978.785111,51,92,0.94,41,0.022926829,46
2978.52289,57,85,0.64,28,0.022857143,46
2978.507708,45,54,0.31,9,0.034444444,46
2978.310126,55,90,0.76,35,0.021714286,46
2978.296835,62,88,0.54,26,0.020769231,46
2978.183536,62,81,0.42,19,0.022105263,46
2978.107626,52,55,0.08,3,0.026666667,46
2978.074219,39,51,0.41,12,0.034166667,46
2977.798172,68,76,0.17,8,0.02125,46
2977.510327,61,95,0.64,34,0.018823529,46
2977.300924,58,93,0.74,35,0.021142857,46
2977.297999,59,67,0.27,8,0.03375,46
2977.217833,60,83,0.5,23,0.02173913,46
2977.130992,57,73,0.54,16,0.03375,46
2976.821389,55,97,0.87,42,0.020714286,46
2976.818954,56,90,0.73,34,0.021470588,46
2976.750202,56,77,0.63,21,0.03,46
2976.721882,52,74,0.79,22,0.035909091,46
2976.637204,60,86,0.57,26,0.021923077,46
2976.53457,59,85,0.59,26,0.022692308,46
2976.477394,37,53,0.55,16,0.034375,46
2976.405464,68,79,0.23,11,0.020909091,46
2976.353898,60,86,0.55,26,0.021153846,46
2976.352811,70,74,0.11,4,0.0275,46
2976.352811,68,76,0.22,8,0.0275,46
2976.352811,66,78,0.33,12,0.0275,46
2976.344431,33,59,0.93,26,0.035769231,46
2976.317922,41,66,0.66,25,0.0264,46
2976.288096,37,72,0.93,35,0.026571429,46
2976.283171,65,83,0.37,18,0.020555556,46
2975.950672,53,78,0.84,25,0.0336,46
2975.856832,59,85,0.58,26,0.022307692,46
2975.773855,53,92,0.99,39,0.025384615,46
2975.588156,54,84,0.88,30,0.029333333,46
2975.432636,67,73,0.17,6,0.028333333,46
2975.432636,64,76,0.34,12,0.028333333,46
2975.432636,59,82,0.65,23,0.02826087,46
2975.195246,45,62,0.44,17,0.025882353,46
2975.167155,60,91,0.64,31,0.020645161,46
2975.167155,59,92,0.68,33,0.020606061,46
2975.12103,40,67,0.72,27,0.026666667,46
2975.109016,63,80,0.46,17,0.027058824,46
2975.109016,61,82,0.57,21,0.027142857,46
2974.99065,41,59,0.62,18,0.034444444,46
2974.969338,60,85,0.54,25,0.0216,46
2974.854875,62,96,0.62,34,0.018235294,46
2974.823637,51,83,0.94,32,0.029375,46
2974.805205,50,77,0.9,27,0.033333333,46
2974.805205,49,78,0.97,29,0.033448276,46
2974.796661,69,72,0.07,3,0.023333333,46
2974.597323,64,82,0.47,18,0.026111111,46
2974.540152,54,82,0.77,28,0.0275,46
2974.540152,53,83,0.83,30,0.027666667,46
2974.455712,68,82,0.27,14,0.019285714,46
2974.372905,65,81,0.34,16,0.02125,46
2974.357635,52,78,0.92,26,0.035384615,46
2974.343591,60,96,0.68,36,0.018888889,46
2974.343591,58,99,0.77,41,0.018780488,46
2974.199076,58,71,0.46,13,0.035384615,46
2974.077215,54,99,0.92,45,0.020444444,46
2974.061864,62,83,0.57,21,0.027142857,46
2974.008468,60,99,0.73,39,0.018717949,46
2973.970119,53,88,0.92,35,0.026285714,46
2973.817744,42,67,0.64,25,0.0256,46
2973.694478,41,59,0.61,18,0.033888889,46
2973.599203,62,79,0.49,17,0.028823529,46
2973.599203,58,83,0.72,25,0.0288,46
2973.599203,57,84,0.78,27,0.028888889,46
2973.572587,52,83,0.88,31,0.028387097,46
2973.559198,62,82,0.45,20,0.0225,46
2973.559198,60,84,0.54,24,0.0225,46
2973.22371,62,83,0.45,21,0.021428571,46
2973.01791,56,84,0.76,28,0.027142857,46
2973.01791,55,85,0.82,30,0.027333333,46
2973.01791,54,86,0.87,32,0.0271875,46
2972.936131,63,79,0.45,16,0.028125,46
2972.936131,60,83,0.64,23,0.027826087,46
2972.909278,62,84,0.47,22,0.021363636,46
2972.732833,67,73,0.14,6,0.023333333,46
2972.662401,69,73,0.11,4,0.0275,46
2972.662401,67,75,0.22,8,0.0275,46
2972.662401,62,81,0.52,19,0.027368421,46
2972.62245,53,79,0.88,26,0.033846154,46
2972.567677,42,58,0.54,16,0.03375,46
2972.525576,61,76,0.43,15,0.028666667,46
2972.306163,64,78,0.31,14,0.022142857,46
2972.235643,63,89,0.68,26,0.026153846,46
2972.235643,60,93,0.86,33,0.026060606,46
2971.930176,55,83,0.81,28,0.028928571,46
2971.827148,60,78,0.5,18,0.027777778,46
2971.785891,40,68,0.84,28,0.03,46
2971.781527,28,75,0.53,47,0.011276596,46
2971.669047,52,80,0.94,28,0.033571429,46
2971.638627,54,86,0.88,32,0.0275,46
2971.587972,59,88,0.8,29,0.027586207,46
2971.528059,58,92,0.7,34,0.020588235,46
2971.43173,56,91,0.75,35,0.021428571,46
2971.22394,52,83,0.89,31,0.028709677,46
2971.13489,60,83,0.63,23,0.027391304,46
2971.041982,30,73,0.47,43,0.010930233,46
2970.713718,60,66,0.2,6,0.033333333,46
2970.578162,54,85,0.88,31,0.028387097,46
2970.362338,34,57,0.83,23,0.036086957,46
2970.14361,36,53,0.65,17,0.038235294,46
2970.023339,57,91,0.71,34,0.020882353,46
2969.754931,55,88,0.89,33,0.026969697,46
2969.693206,67,83,0.31,16,0.019375,46
2969.625942,56,92,0.93,36,0.025833333,46
2969.327458,48,58,0.26,10,0.026,46
2969.30176,54,85,0.94,31,0.030322581,46
2969.177325,33,58,0.89,25,0.0356,46
2969.16142,40,60,0.69,20,0.0345,46
