% profit,ema1,ema2,threshold,diff,thresh / diff,ID
3753.541757,42,74,0.97,32,0.0303125,25
3739.472456,35,63,0.98,28,0.035,25
3687.022938,44,50,0.23,6,0.038333333,25
3682.686031,35,63,0.97,28,0.034642857,25
3671.108448,40,53,0.47,13,0.036153846,25
3658.135513,42,52,0.38,10,0.038,25
3631.669944,36,61,0.9,25,0.036,25
3631.669944,35,62,0.98,27,0.036296296,25
3619.827435,42,54,0.43,12,0.035833333,25
3617.599285,38,58,0.72,20,0.036,25
3613.733923,35,62,0.96,27,0.035555556,25
3613.024535,40,54,0.54,14,0.038571429,25
3612.780218,36,61,0.89,25,0.0356,25
3611.482417,41,56,0.53,15,0.035333333,25
3606.568845,39,61,0.75,22,0.034090909,25
3601.774354,40,55,0.54,15,0.036,25
3580.935175,40,58,0.63,18,0.035,25
3575.682004,39,56,0.65,17,0.038235294,25
3575.682004,38,57,0.73,19,0.038421053,25
3569.613887,42,74,0.98,32,0.030625,25
3565.532864,38,58,0.71,20,0.0355,25
3558.406933,54,77,0.75,23,0.032608696,25
3555.046914,41,53,0.46,12,0.038333333,25
3554.09742,38,57,0.72,19,0.037894737,25
3547.621021,59,71,0.39,12,0.0325,25
3544.422823,42,72,0.83,30,0.027666667,25
3544.207681,34,61,0.98,27,0.036296296,25
3541.845028,44,68,0.76,24,0.031666667,25
3541.177215,42,50,0.3,8,0.0375,25
3539.408004,35,62,0.97,27,0.035925926,25
3538.026636,43,51,0.3,8,0.0375,25
3533.994412,43,51,0.29,8,0.03625,25
3532.91387,42,53,0.41,11,0.037272727,25
3526.952698,46,49,0.11,3,0.036666667,25
3523.837697,43,52,0.33,9,0.036666667,25
3521.956217,44,51,0.26,7,0.037142857,25
3520.37131,51,69,0.47,18,0.026111111,25
3520.130543,59,72,0.42,13,0.032307692,25
3519.601278,43,70,0.84,27,0.031111111,25
3519.474148,41,55,0.5,14,0.035714286,25
3517.056599,61,67,0.2,6,0.033333333,25
3516.084649,45,48,0.11,3,0.036666667,25
3516.067622,36,60,0.86,24,0.035833333,25
3513.010536,44,48,0.15,4,0.0375,25
3511.489312,42,53,0.39,11,0.035454545,25
3511.050893,55,71,0.55,16,0.034375,25
3511.050893,54,72,0.62,18,0.034444444,25
3508.10441,57,74,0.55,17,0.032352941,25
3507.145828,51,76,0.86,25,0.0344,25
3507.145828,50,77,0.93,27,0.034444444,25
3506.472926,51,77,0.89,26,0.034230769,25
3506.434569,41,54,0.46,13,0.035384615,25
3506.18286,37,59,0.79,22,0.035909091,25
3504.013653,45,67,0.69,22,0.031363636,25
3501.550078,63,67,0.13,4,0.0325,25
3500.576276,39,57,0.63,18,0.035,25
3500.288254,58,72,0.46,14,0.032857143,25
3500.260885,52,76,0.82,24,0.034166667,25
3499.07453,39,56,0.61,17,0.035882353,25
3495.625993,40,55,0.56,15,0.037333333,25
3495.625993,39,56,0.64,17,0.037647059,25
3493.173042,69,82,0.25,13,0.019230769,25
3493.173042,68,83,0.29,15,0.019333333,25
3493.173042,67,84,0.33,17,0.019411765,25
3492.497108,47,65,0.51,18,0.028333333,25
3491.312645,62,65,0.1,3,0.033333333,25
3490.524144,35,61,0.98,26,0.037692308,25
3490.406092,38,58,0.7,20,0.035,25
3489.698227,40,75,0.96,35,0.027428571,25
3489.536935,60,84,0.5,24,0.020833333,25
3488.053004,35,62,0.99,27,0.036666667,25
3486.791955,61,69,0.26,8,0.0325,25
3482.690035,50,78,0.96,28,0.034285714,25
3482.180869,38,58,0.73,20,0.0365,25
3481.083889,41,57,0.56,16,0.035,25
3481.011554,58,70,0.4,12,0.033333333,25
3480.816651,36,60,0.85,24,0.035416667,25
3479.399789,45,49,0.15,4,0.0375,25
3478.622969,56,72,0.54,16,0.03375,25
3475.164795,36,60,0.9,24,0.0375,25
3473.993997,38,57,0.68,19,0.035789474,25
3473.314767,55,72,0.58,17,0.034117647,25
3472.92636,58,69,0.37,11,0.033636364,25
3472.446014,43,55,0.42,12,0.035,25
3472.446014,42,56,0.49,14,0.035,25
3470.595686,54,78,0.78,24,0.0325,25
3468.581929,37,58,0.76,21,0.036190476,25
3468.378384,51,80,0.96,29,0.033103448,25
3465.763012,35,59,0.89,24,0.037083333,25
3464.881165,40,54,0.51,14,0.036428571,25
3464.474855,56,71,0.51,15,0.034,25
3463.262378,35,61,0.93,26,0.035769231,25
3463.128625,63,88,0.49,25,0.0196,25
3463.128625,62,89,0.53,27,0.01962963,25
3463.048879,57,71,0.47,14,0.033571429,25
3463.035152,37,59,0.81,22,0.036818182,25
3462.23531,38,59,0.74,21,0.035238095,25
3461.864413,40,59,0.67,19,0.035263158,25
3460.540934,53,75,0.75,22,0.034090909,25
3459.950915,41,54,0.47,13,0.036153846,25
3458.49707,63,69,0.19,6,0.031666667,25
3458.49707,60,72,0.38,12,0.031666667,25
3458.405181,53,73,0.69,20,0.0345,25
3458.283639,43,56,0.45,13,0.034615385,25
3458.041484,40,60,0.68,20,0.034,25
3457.481177,54,73,0.65,19,0.034210526,25
3457.481177,53,74,0.72,21,0.034285714,25
3456.759311,64,87,0.45,23,0.019565217,25
3456.338222,42,52,0.36,10,0.036,25
3455.753053,62,83,0.43,21,0.02047619,25
3455.029673,42,51,0.33,9,0.036666667,25
3454.326875,57,70,0.44,13,0.033846154,25
3453.424649,34,60,0.98,26,0.037692308,25
3452.991786,52,74,0.76,22,0.034545455,25
3451.869177,39,55,0.58,16,0.03625,25
3450.783075,39,60,0.73,21,0.034761905,25
3449.884038,52,79,0.9,27,0.033333333,25
3449.607188,61,84,0.47,23,0.020434783,25
3449.602155,57,69,0.41,12,0.034166667,25
3448.496997,55,73,0.61,18,0.033888889,25
3448.358302,52,79,0.89,27,0.032962963,25
3443.593853,63,82,0.39,19,0.020526316,25
3443.220564,37,56,0.71,19,0.037368421,25
3442.909816,59,87,0.57,28,0.020357143,25
3441.880403,56,70,0.48,14,0.034285714,25
3441.765111,43,50,0.27,7,0.038571429,25
3440.777649,54,74,0.68,20,0.034,25
3437.991742,36,59,0.83,23,0.036086957,25
3437.558328,51,80,0.97,29,0.033448276,25
3437.424768,43,83,0.99,40,0.02475,25
3436.918833,50,69,0.5,19,0.026315789,25
3436.780648,38,62,0.84,24,0.035,25
3436.007348,35,62,0.95,27,0.035185185,25
3433.53496,53,79,0.85,26,0.032692308,25
3433.200872,61,66,0.17,5,0.034,25
3433.10642,65,86,0.41,21,0.01952381,25
3432.524065,63,81,0.37,18,0.020555556,25
3431.150985,53,78,0.82,25,0.0328,25
3431.113741,50,70,0.52,20,0.026,25
3429.405924,36,61,0.87,25,0.0348,25
3429.216474,66,85,0.37,19,0.019473684,25
3428.122894,56,75,0.62,19,0.032631579,25
3428.002457,37,63,0.92,26,0.035384615,25
3427.008501,42,75,0.9,33,0.027272727,25
3426.29927,35,59,0.9,24,0.0375,25
3426.247383,64,80,0.33,16,0.020625,25
3425.943905,44,49,0.18,5,0.036,25
3425.383602,52,75,0.79,23,0.034347826,25
3424.794303,52,80,0.92,28,0.032857143,25
3424.518281,61,70,0.29,9,0.032222222,25
3424.518281,58,74,0.51,16,0.031875,25
3424.518281,56,76,0.64,20,0.032,25
3424.403814,36,60,0.88,24,0.036666667,25
3424.141807,65,87,0.43,22,0.019545455,25
3424.141807,64,88,0.47,24,0.019583333,25
3423.994329,63,68,0.16,5,0.032,25
3423.79443,37,59,0.8,22,0.036363636,25
3422.503383,45,54,0.31,9,0.034444444,25
3422.503383,44,55,0.38,11,0.034545455,25
3422.34775,40,56,0.57,16,0.035625,25
3421.959196,40,59,0.66,19,0.034736842,25
3420.579844,54,76,0.74,22,0.033636364,25
3420.329728,36,60,0.89,24,0.037083333,25
3417.378902,62,67,0.17,5,0.034,25
3416.182681,43,70,0.76,27,0.028148148,25
3415.33928,35,61,0.94,26,0.036153846,25
3414.341664,46,67,0.65,21,0.030952381,25
3413.800699,66,79,0.26,13,0.02,25
3412.256514,44,67,0.74,23,0.032173913,25
3411.395568,42,57,0.52,15,0.034666667,25
3410.71987,53,78,0.83,25,0.0332,25
3408.246418,38,61,0.81,23,0.035217391,25
3407.795724,39,60,0.75,21,0.035714286,25
3407.372591,39,60,0.74,21,0.035238095,25
3406.978229,39,58,0.66,19,0.034736842,25
3406.754509,40,57,0.6,17,0.035294118,25
3406.663972,55,76,0.69,21,0.032857143,25
3403.568323,37,59,0.82,22,0.037272727,25
3402.993792,36,62,0.9,26,0.034615385,25
3402.429391,56,74,0.61,18,0.033888889,25
3401.011539,39,56,0.62,17,0.036470588,25
3400.81434,54,77,0.76,23,0.033043478,25
3400.275182,67,78,0.22,11,0.02,25
3399.303079,38,62,0.83,24,0.034583333,25
3399.242152,65,79,0.29,14,0.020714286,25
3398.153275,35,62,0.94,27,0.034814815,25
3397.918021,43,72,0.9,29,0.031034483,25
3396.995275,39,54,0.55,15,0.036666667,25
3396.054931,62,72,0.31,10,0.031,25
3395.225732,39,61,0.76,22,0.034545455,25
3395.119048,43,53,0.36,10,0.036,25
3395.119048,40,57,0.61,17,0.035882353,25
3393.915882,60,70,0.33,10,0.033,25
3393.618082,41,73,0.89,32,0.0278125,25
3392.489468,37,60,0.82,23,0.035652174,25
3392.0789,37,58,0.77,21,0.036666667,25
3389.329611,56,74,0.6,18,0.033333333,25
3389.329611,55,75,0.67,20,0.0335,25
3389.311014,49,63,0.39,14,0.027857143,25
3389.184578,57,73,0.53,16,0.033125,25
3388.61204,37,59,0.78,22,0.035454545,25
3387.399663,41,58,0.59,17,0.034705882,25
3386.155351,35,61,0.95,26,0.036538462,25
3385.938609,37,56,0.7,19,0.036842105,25
3385.595857,38,58,0.75,20,0.0375,25
3385.179615,44,52,0.29,8,0.03625,25
3384.747274,44,69,0.78,25,0.0312,25
3384.256532,39,62,0.78,23,0.033913043,25
3383.99329,48,64,0.5,16,0.03125,25
3383.592324,36,61,0.91,25,0.0364,25
3383.475661,45,66,0.67,21,0.031904762,25
3382.999897,44,69,0.7,25,0.028,25
3382.270839,55,73,0.62,18,0.034444444,25
3381.512857,39,61,0.77,22,0.035,25
3379.510809,55,75,0.68,20,0.034,25
3378.939978,50,71,0.54,21,0.025714286,25
3377.897504,37,62,0.9,25,0.036,25
3375.626367,42,55,0.46,13,0.035384615,25
3375.592683,39,57,0.67,18,0.037222222,25
3375.427863,56,76,0.65,20,0.0325,25
3374.232998,35,60,0.92,25,0.0368,25
3372.904859,39,58,0.69,19,0.036315789,25
3372.303795,42,51,0.35,9,0.038888889,25
3371.374669,41,54,0.49,13,0.037692308,25
3371.240311,36,61,0.88,25,0.0352,25
3370.543773,43,71,0.86,28,0.030714286,25
3370.40271,40,52,0.46,12,0.038333333,25
3369.717008,38,61,0.82,23,0.035652174,25
3369.604259,47,76,0.73,29,0.025172414,25
3368.717629,46,77,0.79,31,0.025483871,25
3368.717629,45,79,0.86,34,0.025294118,25
3368.183606,44,50,0.22,6,0.036666667,25
3367.951818,54,76,0.75,22,0.034090909,25
3367.951818,53,77,0.82,24,0.034166667,25
3367.585453,39,56,0.6,17,0.035294118,25
3367.548433,59,73,0.45,14,0.032142857,25
3366.552341,41,55,0.51,14,0.036428571,25
3366.171789,49,72,0.59,23,0.025652174,25
3365.045609,37,57,0.73,20,0.0365,25
3364.998523,54,74,0.69,20,0.0345,25
3364.236981,38,57,0.69,19,0.036315789,25
3363.941372,37,58,0.79,21,0.037619048,25
3363.581842,41,58,0.6,17,0.035294118,25
3363.084641,41,51,0.37,10,0.037,25
3363.084641,39,53,0.52,14,0.037142857,25
3362.884087,36,60,0.87,24,0.03625,25
3362.724525,41,59,0.62,18,0.034444444,25
3362.5419,59,68,0.31,9,0.034444444,25
3362.5419,58,69,0.38,11,0.034545455,25
3362.5419,57,70,0.45,13,0.034615385,25
3361.983974,54,65,0.29,11,0.026363636,25
3361.776827,42,54,0.44,12,0.036666667,25
3361.776827,40,56,0.59,16,0.036875,25
3360.662158,44,72,0.76,28,0.027142857,25
3360.592064,37,60,0.81,23,0.035217391,25
3359.762914,37,56,0.72,19,0.037894737,25
3359.526481,38,60,0.76,22,0.034545455,25
3357.612751,38,63,0.85,25,0.034,25
3357.4214,38,59,0.78,21,0.037142857,25
3356.658009,37,59,0.77,22,0.035,25
3356.629932,35,61,0.92,26,0.035384615,25
3355.997515,57,75,0.58,18,0.032222222,25
3355.997515,55,77,0.71,22,0.032272727,25
3355.642693,40,52,0.44,12,0.036666667,25
3355.254826,63,87,0.48,24,0.02,25
3354.80259,39,58,0.67,19,0.035263158,25
3354.724655,61,71,0.32,10,0.032,25
3352.786256,39,53,0.54,14,0.038571429,25
3351.011755,40,54,0.5,14,0.035714286,25
3350.716442,40,58,0.64,18,0.035555556,25
3350.431176,62,69,0.23,7,0.032857143,25
3349.363635,37,60,0.8,23,0.034782609,25
3348.989056,38,55,0.62,17,0.036470588,25
3348.950981,40,55,0.57,15,0.038,25
3348.360415,39,56,0.63,17,0.037058824,25
3347.055618,45,79,0.85,34,0.025,25
3346.560683,54,77,0.77,23,0.033478261,25
3346.495798,36,60,0.84,24,0.035,25
3345.664866,39,59,0.71,20,0.0355,25
3344.766683,55,76,0.7,21,0.033333333,25
3344.601174,35,61,0.96,26,0.036923077,25
3344.362157,43,54,0.39,11,0.035454545,25
3343.536031,61,69,0.27,8,0.03375,25
3343.080068,53,59,0.17,6,0.028333333,25
3342.997901,42,70,0.9,28,0.032142857,25
3341.492031,41,53,0.44,12,0.036666667,25
3340.410142,32,56,0.92,24,0.038333333,25
3340.096078,36,59,0.84,23,0.036521739,25
3340.007076,35,64,0.99,29,0.034137931,25
3339.963887,53,60,0.19,7,0.027142857,25
3339.708163,56,71,0.52,15,0.034666667,25
3339.708163,55,72,0.59,17,0.034705882,25
3338.211525,58,73,0.49,15,0.032666667,25
3337.31103,38,57,0.71,19,0.037368421,25
3337.0535,73,75,0.04,2,0.02,25
3337.0535,72,76,0.08,4,0.02,25
3337.0535,71,77,0.12,6,0.02,25
3337.0535,70,78,0.16,8,0.02,25
3337.0535,69,79,0.2,10,0.02,25
3336.15345,43,69,0.83,26,0.031923077,25
3336.092359,56,62,0.16,6,0.026666667,25
3335.154194,58,72,0.47,14,0.033571429,25
3334.962334,45,53,0.28,8,0.035,25
3334.962334,44,54,0.35,10,0.035,25
3334.831417,46,65,0.6,19,0.031578947,25
3334.649257,47,64,0.54,17,0.031764706,25
3334.405496,36,58,0.8,22,0.036363636,25
3334.043972,47,65,0.5,18,0.027777778,25
3333.615976,36,57,0.8,21,0.038095238,25
3333.524871,44,81,0.92,37,0.024864865,25
3333.310803,62,68,0.2,6,0.033333333,25
3332.481008,36,57,0.81,21,0.038571429,25
3331.562037,45,52,0.25,7,0.035714286,25
3330.981161,37,64,0.92,27,0.034074074,25
3329.523403,36,62,0.91,26,0.035,25
3328.522814,41,57,0.57,16,0.035625,25
3327.8522,38,56,0.64,18,0.035555556,25
3327.395408,57,73,0.54,16,0.03375,25
3327.031768,40,53,0.48,13,0.036923077,25
3326.622843,56,75,0.63,19,0.033157895,25
3326.495016,45,68,0.72,23,0.031304348,25
3325.603053,38,60,0.8,22,0.036363636,25
3324.581262,39,59,0.72,20,0.036,25
3324.458453,37,61,0.88,24,0.036666667,25
3324.415029,53,65,0.32,12,0.026666667,25
3324.067846,36,65,0.99,29,0.034137931,25
3323.601936,59,72,0.43,13,0.033076923,25
3322.133586,60,86,0.53,26,0.020384615,25
3319.850797,56,74,0.59,18,0.032777778,25
3319.741843,41,52,0.4,11,0.036363636,25
3319.741843,38,56,0.65,18,0.036111111,25
3318.273404,44,53,0.32,9,0.035555556,25
3318.154624,44,81,0.93,37,0.025135135,25
3317.764059,37,64,0.94,27,0.034814815,25
3315.772049,40,58,0.65,18,0.036111111,25
3314.91009,44,70,0.72,26,0.027692308,25
3314.32987,65,81,0.32,16,0.02,25
3314.048506,57,74,0.56,17,0.032941176,25
3313.482513,60,71,0.36,11,0.032727273,25
3313.167563,38,54,0.62,16,0.03875,25
3313.084685,72,73,0.02,1,0.02,25
3313.084685,71,74,0.06,3,0.02,25
3313.084685,70,75,0.1,5,0.02,25
3313.084685,69,76,0.14,7,0.02,25
3313.084685,68,77,0.18,9,0.02,25
3312.995015,34,60,0.99,26,0.038076923,25
3312.944844,45,69,0.74,24,0.030833333,25
3312.784017,60,67,0.24,7,0.034285714,25
3312.184456,67,77,0.21,10,0.021,25
3311.738133,51,70,0.49,19,0.025789474,25
3311.558409,62,84,0.44,22,0.02,25
3310.933508,55,91,0.74,36,0.020555556,25
3310.196038,41,53,0.43,12,0.035833333,25
3310.081369,38,61,0.83,23,0.036086957,25
3309.170445,42,73,0.95,31,0.030645161,25
3308.959595,39,58,0.7,19,0.036842105,25
3308.801922,42,50,0.29,8,0.03625,25
3308.752576,45,67,0.7,22,0.031818182,25
3308.632579,45,54,0.3,9,0.033333333,25
3308.552505,41,56,0.54,15,0.036,25
3308.428446,64,82,0.36,18,0.02,25
3308.428446,63,83,0.4,20,0.02,25
3308.032803,46,66,0.63,20,0.0315,25
3307.956643,65,84,0.37,19,0.019473684,25
3307.798747,42,54,0.42,12,0.035,25
3307.725026,38,63,0.87,25,0.0348,25
3306.909481,39,55,0.59,16,0.036875,25
3305.779775,35,58,0.89,23,0.038695652,25
3305.353468,36,57,0.78,21,0.037142857,25
3304.974747,55,92,0.75,37,0.02027027,25
3303.42938,45,69,0.64,24,0.026666667,25
3302.96275,44,70,0.82,26,0.031538462,25
3302.84842,59,71,0.4,12,0.033333333,25
3302.503261,59,88,0.58,29,0.02,25
3301.514887,39,53,0.53,14,0.037857143,25
3301.208919,37,64,0.91,27,0.033703704,25
3301.052424,57,88,0.64,31,0.020645161,25
3300.994876,36,59,0.85,23,0.036956522,25
3300.960083,44,51,0.25,7,0.035714286,25
3300.926187,40,60,0.69,20,0.0345,25
3299.173308,46,67,0.57,21,0.027142857,25
3298.774303,39,59,0.7,20,0.035,25
3298.463759,44,68,0.68,24,0.028333333,25
3298.444878,37,58,0.75,21,0.035714286,25
3297.491745,48,74,0.66,26,0.025384615,25
3297.25553,42,71,0.92,29,0.031724138,25
3297.242983,43,53,0.37,10,0.037,25
3297.242983,41,55,0.52,14,0.037142857,25
3295.956479,37,61,0.84,24,0.035,25
3295.42397,56,90,0.69,34,0.020294118,25
3295.419842,46,65,0.61,19,0.032105263,25
3295.109021,40,56,0.6,16,0.0375,25
3294.493393,37,61,0.83,24,0.034583333,25
3293.961603,42,48,0.23,6,0.038333333,25
3292.996192,37,62,0.91,25,0.0364,25
3292.912343,37,59,0.83,22,0.037727273,25
3291.308717,40,61,0.69,21,0.032857143,25
3290.413542,57,89,0.64,32,0.02,25
3290.139981,47,66,0.51,19,0.026842105,25
3289.330408,51,68,0.45,17,0.026470588,25
3288.521399,36,59,0.87,23,0.037826087,25
3288.484902,61,84,0.48,23,0.020869565,25
3287.969546,35,58,0.86,23,0.037391304,25
3287.583695,39,57,0.64,18,0.035555556,25
3287.371903,55,65,0.26,10,0.026,25
3287.369548,46,69,0.63,23,0.027391304,25
3286.888309,64,81,0.35,17,0.020588235,25
3285.874556,61,68,0.23,7,0.032857143,25
3285.664264,42,55,0.47,13,0.036153846,25
3285.664264,40,57,0.62,17,0.036470588,25
3285.368619,43,70,0.85,27,0.031481481,25
3284.992628,43,82,0.99,39,0.025384615,25
3284.718291,35,60,0.9,25,0.036,25
3283.350184,38,57,0.67,19,0.035263158,25
3282.736569,39,55,0.61,16,0.038125,25
3281.814441,68,81,0.26,13,0.02,25
3281.814441,67,82,0.3,15,0.02,25
3281.627661,47,66,0.59,19,0.031052632,25
3281.5785,37,57,0.72,20,0.036,25
3281.468358,58,71,0.43,13,0.033076923,25
3281.468358,55,74,0.63,19,0.033157895,25
3281.423346,49,58,0.24,9,0.026666667,25
3281.213872,43,82,0.96,39,0.024615385,25
3280.796714,67,82,0.29,15,0.019333333,25
3280.473358,46,53,0.23,7,0.032857143,25
3280.328383,44,69,0.68,25,0.0272,25
3280.076571,38,57,0.7,19,0.036842105,25
3280.073398,36,64,0.95,28,0.033928571,25
3279.68302,41,73,0.9,32,0.028125,25
3279.63111,45,68,0.62,23,0.026956522,25
3279.259777,63,81,0.38,18,0.021111111,25
3277.773509,43,52,0.34,9,0.037777778,25
3277.659951,40,52,0.45,12,0.0375,25
3277.306271,42,57,0.5,15,0.033333333,25
3277.210526,35,61,0.99,26,0.038076923,25
3276.993059,36,58,0.82,22,0.037272727,25
3276.992732,42,72,0.8,30,0.026666667,25
3276.457526,42,72,0.93,30,0.031,25
3276.262335,47,66,0.52,19,0.027368421,25
3275.404535,44,70,0.8,26,0.030769231,25
3274.334039,48,65,0.46,17,0.027058824,25
3273.686917,38,63,0.86,25,0.0344,25
3273.568142,40,55,0.53,15,0.035333333,25
3273.014562,63,86,0.46,23,0.02,25
3272.856623,53,76,0.77,23,0.033478261,25
3272.856623,52,77,0.84,25,0.0336,25
3272.664764,49,73,0.61,24,0.025416667,25
3272.099528,43,52,0.32,9,0.035555556,25
3271.995498,54,75,0.7,21,0.033333333,25
3271.705393,66,83,0.33,17,0.019411765,25
3271.490234,36,55,0.73,19,0.038421053,25
3271.019694,50,60,0.32,10,0.032,25
3270.912095,43,83,0.97,40,0.02425,25
3270.678904,48,50,0.07,2,0.035,25
3270.343467,44,81,0.91,37,0.024594595,25
3270.028995,60,85,0.52,25,0.0208,25
3269.889345,35,61,0.97,26,0.037307692,25
3269.36509,44,80,0.91,36,0.025277778,25
3268.808141,43,56,0.43,13,0.033076923,25
3268.294689,36,51,0.61,15,0.040666667,25
3268.248143,57,73,0.52,16,0.0325,25
3267.974244,38,56,0.66,18,0.036666667,25
3266.930795,66,78,0.25,12,0.020833333,25
3266.756064,62,82,0.42,20,0.021,25
3266.336602,60,85,0.51,25,0.0204,25
3265.982076,38,55,0.63,17,0.037058824,25
3265.738504,37,58,0.81,21,0.038571429,25
3265.076836,36,65,0.98,29,0.033793103,25
3264.637658,38,60,0.77,22,0.035,25
3264.538701,65,84,0.38,19,0.02,25
3264.204141,58,88,0.62,30,0.020666667,25
3264.204141,57,89,0.66,32,0.020625,25
3263.71357,50,64,0.38,14,0.027142857,25
3263.62717,46,74,0.73,28,0.026071429,25
3263.287683,38,62,0.82,24,0.034166667,25
3262.604765,51,63,0.32,12,0.026666667,25
3261.896751,35,59,0.91,24,0.037916667,25
3260.414765,62,87,0.52,25,0.0208,25
3259.723979,45,68,0.63,23,0.027391304,25
3259.15504,68,81,0.25,13,0.019230769,25
3258.72883,41,52,0.41,11,0.037272727,25
3258.56937,43,57,0.46,14,0.032857143,25
3257.447609,39,54,0.56,15,0.037333333,25
3257.362293,58,88,0.61,30,0.020333333,25
3257.254627,44,80,0.92,36,0.025555556,25
3256.641131,35,58,0.9,23,0.039130435,25
3256.290819,42,53,0.42,11,0.038181818,25
3256.230875,37,58,0.8,21,0.038095238,25
3255.814283,51,78,0.91,27,0.033703704,25
3255.681081,45,51,0.22,6,0.036666667,25
3255.62982,54,92,0.97,38,0.025526316,25
3255.582479,43,51,0.31,8,0.03875,25
3255.520668,40,55,0.55,15,0.036666667,25
3255.325312,59,70,0.36,11,0.032727273,25
3255.325312,56,73,0.56,17,0.032941176,25
3255.173998,51,84,0.93,33,0.028181818,25
3255.173998,50,85,0.99,35,0.028285714,25
3254.557981,35,60,0.95,25,0.038,25
3254.553643,35,63,0.99,28,0.035357143,25
3253.838958,61,83,0.46,22,0.020909091,25
3252.874095,66,83,0.34,17,0.02,25
3252.789873,43,48,0.19,5,0.038,25
3252.503153,39,59,0.69,20,0.0345,25
3252.112366,44,54,0.36,10,0.036,25
3251.424782,59,86,0.56,27,0.020740741,25
3251.406786,39,60,0.72,21,0.034285714,25
3250.850888,43,71,0.75,28,0.026785714,25
3250.771126,57,89,0.65,32,0.0203125,25
3250.126688,47,74,0.7,27,0.025925926,25
3248.999258,40,54,0.52,14,0.037142857,25
3248.975262,64,85,0.42,21,0.02,25
3248.846074,44,70,0.7,26,0.026923077,25
3248.488306,45,70,0.69,25,0.0276,25
3247.966889,38,54,0.61,16,0.038125,25
3247.909446,43,71,0.76,28,0.027142857,25
3247.72311,36,59,0.82,23,0.035652174,25
3247.709867,42,52,0.37,10,0.037,25
3247.381504,43,54,0.4,11,0.036363636,25
3247.214747,39,55,0.57,16,0.035625,25
3246.956937,52,55,0.08,3,0.026666667,25
3246.669011,48,73,0.64,25,0.0256,25
3246.190656,36,60,0.91,24,0.037916667,25
3245.391085,37,57,0.74,20,0.037,25
3244.393238,63,85,0.47,22,0.021363636,25
3244.322465,44,55,0.36,11,0.032727273,25
3243.573255,60,89,0.61,29,0.021034483,25
3243.353635,41,54,0.48,13,0.036923077,25
3241.867685,38,59,0.73,21,0.034761905,25
3241.729168,63,80,0.36,17,0.021176471,25
3240.768027,42,73,0.82,31,0.026451613,25
3240.348387,46,51,0.18,5,0.036,25
3240.330389,37,55,0.69,18,0.038333333,25
3240.287556,36,58,0.81,22,0.036818182,25
3240.181374,47,51,0.14,4,0.035,25
3240.181374,46,52,0.21,6,0.035,25
3239.993496,36,63,0.93,27,0.034444444,25
3239.944192,55,75,0.66,20,0.033,25
3239.611665,63,89,0.51,26,0.019615385,25
3238.996945,43,70,0.74,27,0.027407407,25
3238.81017,61,68,0.24,7,0.034285714,25
3238.770876,42,56,0.5,14,0.035714286,25
3237.295606,41,59,0.6,18,0.033333333,25
3236.171138,51,79,0.94,28,0.033571429,25
3235.476898,40,56,0.56,16,0.035,25
3235.463708,54,59,0.14,5,0.028,25
3235.281887,49,71,0.58,22,0.026363636,25
3234.965839,55,81,0.7,26,0.026923077,25
3234.221983,42,57,0.53,15,0.035333333,25
3234.196513,42,58,0.53,16,0.033125,25
3234.187569,46,64,0.58,18,0.032222222,25
3234.014585,34,61,0.99,27,0.036666667,25
3232.302071,34,59,0.98,25,0.0392,25
3232.282833,35,60,0.91,25,0.0364,25
3230.944355,48,72,0.63,24,0.02625,25
3230.667707,57,88,0.79,31,0.025483871,25
3230.217101,39,54,0.57,15,0.038,25
3230.11326,44,71,0.74,27,0.027407407,25
3230.083319,67,76,0.19,9,0.021111111,25
3229.868758,38,61,0.8,23,0.034782609,25
3228.712675,41,53,0.45,12,0.0375,25
3228.712675,40,54,0.53,14,0.037857143,25
3228.353518,62,73,0.25,11,0.022727273,25
3228.253603,44,68,0.77,24,0.032083333,25
3227.150728,37,63,0.89,26,0.034230769,25
3227.116785,41,74,0.88,33,0.026666667,25
3226.857553,43,50,0.26,7,0.037142857,25
3226.696934,46,75,0.75,29,0.025862069,25
3226.449385,43,56,0.46,13,0.035384615,25
3225.792024,43,49,0.23,6,0.038333333,25
3224.51169,44,49,0.19,5,0.038,25
3224.44353,60,90,0.62,30,0.020666667,25
3224.084229,42,49,0.26,7,0.037142857,25
3223.845388,60,75,0.34,15,0.022666667,25
3223.231201,43,68,0.81,25,0.0324,25
3222.807277,60,86,0.52,26,0.02,25
3222.549297,41,56,0.55,15,0.036666667,25
3221.622866,54,92,0.96,38,0.025263158,25
3221.354292,48,66,0.5,18,0.027777778,25
3221.353535,42,73,0.97,31,0.031290323,25
3220.005959,36,59,0.86,23,0.037391304,25
3219.989873,46,66,0.57,20,0.0285,25
3219.197352,40,53,0.49,13,0.037692308,25
3218.358618,41,77,0.97,36,0.026944444,25
3217.726801,59,79,0.44,20,0.022,25
3217.682832,44,80,0.9,36,0.025,25
3217.134686,60,76,0.36,16,0.0225,25
3216.929312,42,72,0.81,30,0.027,25
3216.635899,49,63,0.44,14,0.031428571,25
3216.561506,50,62,0.34,12,0.028333333,25
3215.596224,40,60,0.7,20,0.035,25
3215.591929,41,55,0.49,14,0.035,25
3215.442441,38,56,0.69,18,0.038333333,25
3215.091799,49,71,0.57,22,0.025909091,25
3214.875058,36,59,0.88,23,0.03826087,25
3214.841029,40,75,0.97,35,0.027714286,25
3213.444121,44,55,0.39,11,0.035454545,25
3213.1878,45,66,0.68,21,0.032380952,25
3212.229444,48,75,0.68,27,0.025185185,25
3211.906243,50,61,0.35,11,0.031818182,25
3211.275645,42,73,0.85,31,0.027419355,25
3210.833752,37,58,0.74,21,0.035238095,25
3210.671409,56,91,0.71,35,0.020285714,25
3209.674201,44,86,0.98,42,0.023333333,25
3209.516108,36,58,0.83,22,0.037727273,25
3208.636979,51,78,0.92,27,0.034074074,25
3208.162309,36,52,0.64,16,0.04,25
3208.063555,45,76,0.8,31,0.025806452,25
3207.874076,62,83,0.44,21,0.020952381,25
3207.593651,43,72,0.77,29,0.026551724,25
3207.413141,43,71,0.78,28,0.027857143,25
3207.405874,42,71,0.84,29,0.028965517,25
3207.359493,35,60,0.94,25,0.0376,25
3207.109215,40,59,0.65,19,0.034210526,25
3206.934247,59,86,0.55,27,0.02037037,25
3206.910275,42,54,0.45,12,0.0375,25
3206.798741,36,64,0.96,28,0.034285714,25
3206.79869,47,76,0.74,29,0.025517241,25
3206.777593,66,86,0.38,20,0.019,25
3206.759074,37,58,0.78,21,0.037142857,25
3206.557799,52,78,0.87,26,0.033461538,25
3205.986882,42,49,0.27,7,0.038571429,25
3205.655194,50,84,0.98,34,0.028823529,25
3204.40828,59,90,0.65,31,0.020967742,25
3203.928758,46,52,0.2,6,0.033333333,25
3203.91678,47,66,0.61,19,0.032105263,25
3203.884918,60,68,0.27,8,0.03375,25
3203.266673,42,73,0.83,31,0.026774194,25
3202.885188,37,57,0.75,20,0.0375,25
3202.509255,57,64,0.18,7,0.025714286,25
3201.848802,44,82,0.94,38,0.024736842,25
3201.689965,46,67,0.59,21,0.028095238,25
3201.561243,50,72,0.56,22,0.025454545,25
3201.500126,45,53,0.29,8,0.03625,25
3201.416595,45,67,0.63,22,0.028636364,25
3201.284073,54,94,0.99,40,0.02475,25
3201.201427,40,60,0.67,20,0.0335,25
3201.148952,69,77,0.16,8,0.02,25
3201.070504,57,72,0.5,15,0.033333333,25
3201.034608,52,83,0.9,31,0.029032258,25
3201.02439,41,59,0.63,18,0.035,25
3200.903643,43,72,0.89,29,0.030689655,25
3200.868398,58,88,0.6,30,0.02,25
3200.658206,68,78,0.2,10,0.02,25
3200.150079,51,67,0.43,16,0.026875,25
3200.008923,38,54,0.6,16,0.0375,25
3199.818279,42,51,0.34,9,0.037777778,25
3199.621317,45,50,0.18,5,0.036,25
3199.160337,45,50,0.19,5,0.038,25
3199.095931,50,79,0.99,29,0.034137931,25
3198.746795,57,79,0.5,22,0.022727273,25
3198.686826,44,72,0.78,28,0.027857143,25
3198.523088,58,87,0.6,29,0.020689655,25
3198.285474,43,70,0.77,27,0.028518519,25
3197.558561,51,71,0.51,20,0.0255,25
3196.397187,44,84,0.95,40,0.02375,25
3196.301338,57,90,0.67,33,0.02030303,25
3196.285188,38,56,0.67,18,0.037222222,25
3196.170515,58,70,0.41,12,0.034166667,25
3195.671209,40,56,0.58,16,0.03625,25
3194.632217,59,91,0.66,32,0.020625,25
3194.618811,44,87,0.99,43,0.023023256,25
3194.3573,56,90,0.86,34,0.025294118,25
3193.695891,41,57,0.58,16,0.03625,25
3193.673274,39,59,0.73,20,0.0365,25
3193.571138,67,84,0.34,17,0.02,25
3192.931674,41,74,0.89,33,0.026969697,25
3192.695124,39,55,0.62,16,0.03875,25
3192.647806,65,80,0.3,15,0.02,25
3192.120249,59,87,0.58,28,0.020714286,25
3191.926008,42,52,0.39,10,0.039,25
3191.802991,41,50,0.35,9,0.038888889,25
3191.524938,63,70,0.2,7,0.028571429,25
3191.524938,59,74,0.43,15,0.028666667,25
3191.456932,41,72,0.87,31,0.028064516,25
3191.235472,42,75,0.89,33,0.026969697,25
3191.157712,62,90,0.53,28,0.018928571,25
3191.156057,57,71,0.48,14,0.034285714,25
3191.084225,36,58,0.84,22,0.038181818,25
3190.802548,38,61,0.79,23,0.034347826,25
3190.802548,37,62,0.86,25,0.0344,25
3190.634133,35,57,0.84,22,0.038181818,25
3190.54111,52,70,0.46,18,0.025555556,25
3190.28587,39,57,0.68,18,0.037777778,25
3190.068517,51,84,0.96,33,0.029090909,25
3190.054725,45,53,0.27,8,0.03375,25
3189.67471,35,53,0.72,18,0.04,25
3189.658879,38,55,0.65,17,0.038235294,25
3189.279438,63,86,0.48,23,0.020869565,25
3188.230571,48,73,0.65,25,0.026,25
3188.225509,44,85,0.96,41,0.023414634,25
3187.706581,56,94,0.8,38,0.021052632,25
3187.23031,41,71,0.85,30,0.028333333,25
3186.974182,38,53,0.57,15,0.038,25
3186.932842,41,58,0.58,17,0.034117647,25
3186.54278,48,51,0.1,3,0.033333333,25
3185.876028,36,57,0.82,21,0.039047619,25
3185.816445,44,72,0.77,28,0.0275,25
3185.755145,59,87,0.56,28,0.02,25
3185.74095,53,81,0.82,28,0.029285714,25
3185.74095,52,82,0.88,30,0.029333333,25
3185.318175,61,88,0.57,27,0.021111111,25
3185.15526,45,68,0.64,23,0.027826087,25
3185.057149,47,77,0.75,30,0.025,25
3184.424776,55,80,0.73,25,0.0292,25
3184.396967,53,77,0.81,24,0.03375,25
3184.359378,54,93,0.98,39,0.025128205,25
3184.22089,44,53,0.33,9,0.036666667,25
3184.162735,51,64,0.3,13,0.023076923,25
3183.88695,49,61,0.39,12,0.0325,25
3183.758076,49,62,0.41,13,0.031538462,25
3183.675817,42,73,0.96,31,0.030967742,25
3183.607122,49,70,0.56,21,0.026666667,25
3183.146387,50,59,0.29,9,0.032222222,25
3183.145536,62,88,0.51,26,0.019615385,25
3183.019353,37,54,0.65,17,0.038235294,25
3182.243137,42,73,0.99,31,0.031935484,25
3182.051084,37,56,0.69,19,0.036315789,25
3182.035495,43,73,0.83,30,0.027666667,25
3181.893719,48,66,0.49,18,0.027222222,25
3181.836821,67,81,0.3,14,0.021428571,25
3181.791484,57,90,0.83,33,0.025151515,25
3181.791484,56,92,0.89,36,0.024722222,25
3181.202767,52,83,0.87,31,0.028064516,25
3180.998256,70,81,0.21,11,0.019090909,25
3180.761365,57,81,0.53,24,0.022083333,25
3180.759354,43,44,0.04,1,0.04,25
3180.759354,42,45,0.12,3,0.04,25
3180.743597,35,60,0.96,25,0.0384,25
3180.308918,57,72,0.51,15,0.034,25
3180.299906,51,60,0.23,9,0.025555556,25
3180.086594,63,82,0.38,19,0.02,25
3180.086594,62,83,0.42,21,0.02,25
3180.048244,58,71,0.44,13,0.033846154,25
3180.048244,54,75,0.71,21,0.033809524,25
3180.048244,53,76,0.78,23,0.033913043,25
3180.048244,52,77,0.85,25,0.034,25
3180.015028,64,81,0.34,17,0.02,25
3179.610149,37,65,0.96,28,0.034285714,25
3179.45103,44,77,0.86,33,0.026060606,25
3179.147681,64,88,0.45,24,0.01875,25
3179.029274,44,55,0.37,11,0.033636364,25
3178.897211,74,76,0.04,2,0.02,25
3178.432358,34,58,0.93,24,0.03875,25
3178.330179,39,62,0.77,23,0.033478261,25
3177.543341,40,74,0.95,34,0.027941176,25
3177.276709,61,89,0.55,28,0.019642857,25
3177.035335,46,81,0.86,35,0.024571429,25
3177.006491,59,85,0.67,26,0.025769231,25
3177.006491,56,89,0.85,33,0.025757576,25
3176.743771,60,89,0.73,29,0.025172414,25
3176.353295,35,59,0.92,24,0.038333333,25
3176.10109,50,83,0.99,33,0.03,25
3176.036564,57,88,0.65,31,0.020967742,25
3175.577396,49,70,0.55,21,0.026190476,25
3175.353805,69,81,0.23,12,0.019166667,25
3175.179982,41,76,0.94,35,0.026857143,25
3174.913726,44,68,0.7,24,0.029166667,25
3174.849738,72,74,0.04,2,0.02,25
3174.849738,71,75,0.08,4,0.02,25
3174.849738,70,76,0.12,6,0.02,25
3174.304363,74,75,0.02,1,0.02,25
3174.304363,73,76,0.06,3,0.02,25
3174.304363,72,77,0.1,5,0.02,25
3174.304363,71,78,0.14,7,0.02,25
3174.304363,70,79,0.18,9,0.02,25
3174.304363,69,80,0.22,11,0.02,25
3174.046244,65,67,0.06,2,0.03,25
3174.046244,64,68,0.12,4,0.03,25
3174.046244,63,69,0.18,6,0.03,25
3173.753663,52,82,0.86,30,0.028666667,25
3173.331036,44,52,0.3,8,0.0375,25
3173.073076,43,73,0.82,30,0.027333333,25
3172.714391,62,73,0.3,11,0.027272727,25
3172.714391,60,75,0.41,15,0.027333333,25
3172.42223,44,56,0.41,12,0.034166667,25
3172.359759,66,83,0.35,17,0.020588235,25
3172.307163,36,56,0.74,20,0.037,25
3172.273974,65,87,0.42,22,0.019090909,25
3172.129855,51,62,0.3,11,0.027272727,25
3171.913925,63,89,0.49,26,0.018846154,25
3171.690394,37,62,0.87,25,0.0348,25
3171.558314,54,81,0.78,27,0.028888889,25
3171.558314,53,82,0.84,29,0.028965517,25
3170.892009,40,51,0.43,11,0.039090909,25
3169.686714,59,76,0.39,17,0.022941176,25
3169.522157,55,93,0.94,38,0.024736842,25
3169.452523,56,72,0.55,16,0.034375,25
3169.077083,64,71,0.16,7,0.022857143,25
3168.837959,59,90,0.78,31,0.02516129,25
3168.618799,46,67,0.58,21,0.027619048,25
3168.557919,43,72,0.8,29,0.027586207,25
3168.369981,35,57,0.82,22,0.037272727,25
3168.207302,55,57,0.05,2,0.025,25
3168.207302,54,58,0.1,4,0.025,25
3167.835949,55,90,0.91,35,0.026,25
3167.606077,51,85,0.98,34,0.028823529,25
3167.347547,56,79,0.66,23,0.028695652,25
3167.162468,63,86,0.45,23,0.019565217,25
3167.162468,62,87,0.49,25,0.0196,25
3167.162468,61,88,0.53,27,0.01962963,25
3167.162468,60,89,0.57,29,0.019655172,25
3167.041546,54,82,0.76,28,0.027142857,25
3166.921529,39,54,0.54,15,0.036,25
3166.849996,38,55,0.64,17,0.037647059,25
3166.770247,40,73,0.93,33,0.028181818,25
3166.512387,44,54,0.34,10,0.034,25
3166.413184,42,58,0.54,16,0.03375,25
3165.911944,69,78,0.18,9,0.02,25
3165.911944,68,79,0.22,11,0.02,25
3165.818338,52,81,0.86,29,0.029655172,25
3165.818338,51,82,0.92,31,0.029677419,25
3165.736701,55,91,0.91,36,0.025277778,25
3165.671412,42,71,0.82,29,0.028275862,25
3165.514064,42,55,0.48,13,0.036923077,25
3165.493394,51,84,0.98,33,0.02969697,25
3165.300473,45,71,0.64,26,0.024615385,25
3164.601517,49,76,0.67,27,0.024814815,25
3164.28644,47,73,0.69,26,0.026538462,25
3164.209769,43,49,0.22,6,0.036666667,25
3163.619709,36,62,0.92,26,0.035384615,25
3163.274557,41,74,0.91,33,0.027575758,25
3163.109053,53,83,0.84,30,0.028,25
3163.003931,58,89,0.62,31,0.02,25
3162.942149,56,90,0.7,34,0.020588235,25
3162.927435,61,72,0.33,11,0.03,25
3162.927435,60,73,0.39,13,0.03,25
3162.915263,52,84,0.91,32,0.0284375,25
3162.397657,63,81,0.46,18,0.025555556,25
3161.981583,47,75,0.72,28,0.025714286,25
3161.682545,60,74,0.4,14,0.028571429,25
3161.672491,58,92,0.69,34,0.020294118,25
3161.267427,62,86,0.47,24,0.019583333,25
3161.267427,61,87,0.51,26,0.019615385,25
3160.511338,49,64,0.42,15,0.028,25
3160.395729,59,85,0.55,26,0.021153846,25
3160.284317,40,76,0.98,36,0.027222222,25
3160.034017,66,78,0.31,12,0.025833333,25
3160.034017,65,79,0.36,14,0.025714286,25
3160.034017,61,84,0.59,23,0.025652174,25
3159.928526,57,90,0.66,33,0.02,25
3159.863238,40,57,0.63,17,0.037058824,25
3159.625332,39,62,0.79,23,0.034347826,25
3159.48718,58,86,0.73,28,0.026071429,25
3159.404202,55,57,0.06,2,0.03,25
3159.404202,54,58,0.12,4,0.03,25
3159.404202,53,59,0.18,6,0.03,25
3159.332978,45,71,0.69,26,0.026538462,25
3159.315157,61,85,0.49,24,0.020416667,25
3159.169287,45,52,0.24,7,0.034285714,25
3159.083585,41,46,0.2,5,0.04,25
3158.986287,56,89,0.69,33,0.020909091,25
3158.917804,65,80,0.31,15,0.020666667,25
3158.802129,68,79,0.24,11,0.021818182,25
3157.909649,51,62,0.31,11,0.028181818,25
3157.879969,59,91,0.78,32,0.024375,25
3157.819006,60,79,0.41,19,0.021578947,25
3157.31104,47,64,0.49,17,0.028823529,25
3157.307497,61,90,0.57,29,0.019655172,25
3157.071375,35,59,0.86,24,0.035833333,25
3156.910462,62,86,0.61,24,0.025416667,25
3156.906645,57,93,0.75,36,0.020833333,25
3156.792548,51,85,0.99,34,0.029117647,25
3156.74017,54,81,0.77,27,0.028518519,25
3156.727371,58,89,0.63,31,0.020322581,25
3156.723093,59,87,0.71,28,0.025357143,25
3156.668797,67,80,0.26,13,0.02,25
3156.668797,66,81,0.3,15,0.02,25
3156.668797,65,82,0.34,17,0.02,25
3156.668797,64,83,0.38,19,0.02,25
3156.562161,65,86,0.42,21,0.02,25
3156.551589,57,76,0.6,19,0.031578947,25
3156.541268,40,59,0.68,19,0.035789474,25
3156.40122,54,80,0.76,26,0.029230769,25
3156.010719,43,55,0.43,12,0.035833333,25
3155.139449,54,80,0.77,26,0.029615385,25
3155.076431,36,63,0.94,27,0.034814815,25
3154.974714,37,54,0.67,17,0.039411765,25
3154.148384,40,47,0.28,7,0.04,25
3153.880737,66,75,0.25,9,0.027777778,25
3153.880737,60,82,0.61,22,0.027727273,25
3153.765752,57,91,0.84,34,0.024705882,25
3153.765752,55,94,0.96,39,0.024615385,25
3153.719497,56,73,0.58,17,0.034117647,25
3153.719497,55,74,0.65,19,0.034210526,25
3153.603729,55,79,0.7,24,0.029166667,25
3153.117631,51,83,0.94,32,0.029375,25
3152.946687,58,92,0.71,34,0.020882353,25
3152.628477,56,83,0.75,27,0.027777778,25
3152.628477,55,84,0.81,29,0.027931034,25
3152.628477,53,86,0.92,33,0.027878788,25
3152.628477,53,87,0.94,34,0.027647059,25
3152.628477,52,87,0.98,35,0.028,25
3152.366194,45,80,0.86,35,0.024571429,25
3152.14025,50,58,0.21,8,0.02625,25
3152.109825,38,50,0.48,12,0.04,25
3152.095649,37,51,0.56,14,0.04,25
3151.959473,58,81,0.5,23,0.02173913,25
3151.791381,47,67,0.56,20,0.028,25
3151.743738,47,49,0.07,2,0.035,25
3151.743738,46,50,0.14,4,0.035,25
3151.548916,61,89,0.56,28,0.02,25
3151.548916,60,90,0.6,30,0.02,25
3151.444319,49,65,0.43,16,0.026875,25
3151.416429,53,77,0.8,24,0.033333333,25
3151.135795,52,60,0.2,8,0.025,25
3151.135795,51,61,0.25,10,0.025,25
3150.933076,59,70,0.37,11,0.033636364,25
3150.933076,56,73,0.57,17,0.033529412,25
3150.933076,55,74,0.64,19,0.033684211,25
3150.899613,60,84,0.62,24,0.025833333,25
3150.847183,58,75,0.49,17,0.028823529,25
3150.847183,56,78,0.63,22,0.028636364,25
3150.819835,51,83,0.92,32,0.02875,25
3150.797952,54,76,0.73,22,0.033181818,25
3150.701172,51,86,0.95,35,0.027142857,25
3150.357839,43,70,0.86,27,0.031851852,25
3150.196237,46,76,0.77,30,0.025666667,25
3150.146303,41,51,0.38,10,0.038,25
3149.829927,37,57,0.77,20,0.0385,25
3149.545377,58,86,0.59,28,0.021071429,25
3149.456581,46,69,0.64,23,0.027826087,25
3149.331522,43,83,0.98,40,0.0245,25
3149.255481,43,82,0.97,39,0.024871795,25
3148.756933,61,73,0.34,12,0.028333333,25
3148.732714,56,92,0.9,36,0.025,25
3148.69286,64,86,0.44,22,0.02,25
3148.477797,56,95,0.95,39,0.024358974,25
3148.435885,61,73,0.35,12,0.029166667,25
3148.310431,42,57,0.51,15,0.034,25
3148.262901,60,77,0.38,17,0.022352941,25
3148.19055,57,75,0.53,18,0.029444444,25
3147.732905,47,78,0.76,31,0.024516129,25
3147.732905,46,79,0.81,33,0.024545455,25
3147.690952,53,80,0.8,27,0.02962963,25
3147.671274,53,79,0.78,26,0.03,25
3147.597966,58,87,0.74,29,0.025517241,25
3147.096907,49,64,0.41,15,0.027333333,25
3146.975758,43,51,0.27,8,0.03375,25
3146.710897,55,90,0.92,35,0.026285714,25
3146.675329,64,80,0.41,16,0.025625,25
3146.652708,41,76,0.97,35,0.027714286,25
3146.482657,55,90,0.73,35,0.020857143,25
3145.907983,59,75,0.47,16,0.029375,25
3145.907983,58,76,0.53,18,0.029444444,25
3145.697916,43,55,0.41,12,0.034166667,25
3145.683944,46,75,0.76,29,0.026206897,25
3145.477677,37,61,0.85,24,0.035416667,25
3145.473046,61,88,0.56,27,0.020740741,25
3145.473046,58,92,0.7,34,0.020588235,25
3145.334415,66,85,0.38,19,0.02,25
3145.334415,63,89,0.52,26,0.02,25
3145.334415,62,90,0.56,28,0.02,25
3145.263132,39,57,0.65,18,0.036111111,25
3144.948092,41,52,0.43,11,0.039090909,25
3144.906715,44,69,0.79,25,0.0316,25
3144.78714,46,51,0.17,5,0.034,25
3144.419721,41,77,0.96,36,0.026666667,25
3144.32439,54,85,0.89,31,0.028709677,25
3144.02784,57,93,0.9,36,0.025,25
3143.984312,66,82,0.31,16,0.019375,25
3143.941433,62,82,0.51,20,0.0255,25
3143.888912,46,66,0.56,20,0.028,25
3143.861045,59,69,0.34,10,0.034,25
3143.794306,38,62,0.85,24,0.035416667,25
3143.361823,45,80,0.88,35,0.025142857,25
3142.961978,43,56,0.44,13,0.033846154,25
3142.944413,54,75,0.72,21,0.034285714,25
3142.738034,52,78,0.88,26,0.033846154,25
3142.68805,42,56,0.48,14,0.034285714,25
3142.605443,67,77,0.26,10,0.026,25
3142.605443,62,83,0.54,21,0.025714286,25
3142.242658,44,77,0.85,33,0.025757576,25
3142.21534,40,58,0.66,18,0.036666667,25
3142.202269,35,59,0.88,24,0.036666667,25
3142.130057,38,59,0.75,21,0.035714286,25
3141.80213,57,88,0.8,31,0.025806452,25
3141.80213,56,89,0.86,33,0.026060606,25
3141.681677,44,68,0.69,24,0.02875,25
3141.630355,56,94,0.82,38,0.021578947,25
3141.434949,51,82,0.93,31,0.03,25
3141.070545,53,80,0.79,27,0.029259259,25
3140.735465,57,92,0.76,35,0.021714286,25
3140.639805,38,50,0.47,12,0.039166667,25
3140.174305,35,59,0.93,24,0.03875,25
3140.162803,45,83,0.9,38,0.023684211,25
3139.790036,39,55,0.6,16,0.0375,25
3139.610774,60,71,0.34,11,0.030909091,25
3139.394782,49,64,0.45,15,0.03,25
3139.32788,52,80,0.86,28,0.030714286,25
3139.327835,57,76,0.56,19,0.029473684,25
3139.327835,56,77,0.62,21,0.02952381,25
3139.100269,48,62,0.46,14,0.032857143,25
3138.936234,68,83,0.3,15,0.02,25
3138.819995,52,87,0.92,35,0.026285714,25
3138.819995,51,88,0.98,37,0.026486486,25
3138.590867,38,60,0.81,22,0.036818182,25
3138.356259,70,73,0.08,3,0.026666667,25
3137.964509,58,76,0.51,18,0.028333333,25
3137.84417,65,66,0.03,1,0.03,25
3137.84417,64,67,0.09,3,0.03,25
3137.84417,63,68,0.15,5,0.03,25
3137.84417,62,69,0.21,7,0.03,25
3137.84417,61,70,0.27,9,0.03,25
3137.804863,51,79,0.95,28,0.033928571,25
3137.544049,64,85,0.41,21,0.01952381,25
3137.532676,55,79,0.68,24,0.028333333,25
3137.532676,55,80,0.7,25,0.028,25
3137.521658,43,71,0.87,28,0.031071429,25
3137.457445,63,81,0.47,18,0.026111111,25
3137.374194,54,84,0.87,30,0.029,25
3137.346803,52,85,0.95,33,0.028787879,25
3137.310918,44,66,0.72,22,0.032727273,25
3137.166562,38,56,0.68,18,0.037777778,25
3137.166562,37,57,0.76,20,0.038,25
3136.753083,56,75,0.59,19,0.031052632,25
3136.55879,52,84,0.92,32,0.02875,25
3136.338341,47,64,0.55,17,0.032352941,25
3136.226562,54,97,0.92,43,0.021395349,25
3136.194687,51,83,0.97,32,0.0303125,25
3136.011679,51,89,0.99,38,0.026052632,25
3135.877527,57,90,0.85,33,0.025757576,25
3135.701662,63,66,0.1,3,0.033333333,25
3135.701662,60,69,0.3,9,0.033333333,25
3135.06548,67,78,0.28,11,0.025454545,25
3135.06548,66,79,0.33,13,0.025384615,25
3135.06548,65,80,0.38,15,0.025333333,25
3134.833612,48,63,0.48,15,0.032,25
3134.329619,47,74,0.71,27,0.026296296,25
3134.23103,36,64,0.99,28,0.035357143,25
3134.226404,64,84,0.39,20,0.0195,25
3134.226404,63,85,0.43,22,0.019545455,25
3134.206626,59,72,0.4,13,0.030769231,25
3134.110184,54,81,0.79,27,0.029259259,25
3134.110184,53,82,0.85,29,0.029310345,25
3134.019122,57,78,0.59,21,0.028095238,25
3134.019122,56,79,0.65,23,0.02826087,25
3133.903864,53,59,0.15,6,0.025,25
3133.783111,54,92,0.98,38,0.025789474,25
3133.629405,57,77,0.59,20,0.0295,25
3133.629405,56,78,0.65,22,0.029545455,25
3133.629405,55,79,0.71,24,0.029583333,25
3133.612723,61,89,0.57,28,0.020357143,25
3133.588339,44,53,0.31,9,0.034444444,25
3133.467723,57,76,0.55,19,0.028947368,25
3133.467723,56,77,0.61,21,0.029047619,25
3133.467723,55,78,0.67,23,0.029130435,25
3133.467723,55,79,0.69,24,0.02875,25
3133.467723,54,80,0.75,26,0.028846154,25
3133.341776,34,58,0.94,24,0.039166667,25
3133.242643,65,83,0.35,18,0.019444444,25
3133.020632,52,84,0.88,32,0.0275,25
3133.020632,51,85,0.94,34,0.027647059,25
3132.889957,61,85,0.48,24,0.02,25
3132.265855,50,83,0.98,33,0.02969697,25
3132.167623,53,82,0.86,29,0.029655172,25
3132.167623,52,83,0.92,31,0.029677419,25
3132.157085,39,57,0.66,18,0.036666667,25
3131.862664,59,74,0.45,15,0.03,25
3131.862664,58,75,0.51,17,0.03,25
3131.862664,57,76,0.57,19,0.03,25
3131.862664,54,80,0.78,26,0.03,25
3131.862664,53,81,0.84,28,0.03,25
3131.743063,58,88,0.76,30,0.025333333,25
3131.743063,55,92,0.93,37,0.025135135,25
3131.604702,37,64,0.95,27,0.035185185,25
3131.59225,43,73,0.84,30,0.028,25
3131.378365,63,87,0.47,24,0.019583333,25
3131.222083,44,85,0.97,41,0.023658537,25
3130.820507,61,91,0.6,30,0.02,25
3130.820174,70,78,0.17,8,0.02125,25
3130.820174,66,82,0.34,16,0.02125,25
3130.820174,64,85,0.44,21,0.020952381,25
3130.820174,62,87,0.53,25,0.0212,25
3130.740211,61,84,0.6,23,0.026086957,25
3130.740211,58,88,0.78,30,0.026,25
3130.565929,41,58,0.61,17,0.035882353,25
3130.533358,34,59,0.92,25,0.0368,25
3130.31595,51,82,0.95,31,0.030645161,25
3130.085279,43,69,0.82,26,0.031538462,25
3130.024536,56,90,0.87,34,0.025588235,25
3130.024536,55,91,0.92,36,0.025555556,25
3129.756032,56,82,0.58,26,0.022307692,25
3129.756032,55,84,0.64,29,0.022068966,25
3129.599067,51,87,0.97,36,0.026944444,25
3129.519775,56,94,0.95,38,0.025,25
3129.426544,37,65,0.97,28,0.034642857,25
3129.358651,39,56,0.57,17,0.033529412,25
3129.134935,35,60,0.93,25,0.0372,25
3129.118665,55,80,0.71,25,0.0284,25
3128.866253,70,80,0.19,10,0.019,25
3128.855897,44,68,0.75,24,0.03125,25
3128.720803,41,50,0.34,9,0.037777778,25
3128.494001,37,54,0.64,17,0.037647059,25
3128.466082,53,81,0.81,28,0.028928571,25
3128.143421,60,90,0.61,30,0.020333333,25
3128.132679,66,70,0.09,4,0.0225,25
3128.132679,64,72,0.18,8,0.0225,25
3128.132679,62,74,0.27,12,0.0225,25
3127.866914,45,79,0.87,34,0.025588235,25
3127.753602,51,84,0.97,33,0.029393939,25
3127.683848,37,63,0.93,26,0.035769231,25
3127.450096,37,55,0.68,18,0.037777778,25
3127.271273,55,96,0.85,41,0.020731707,25
3127.187848,59,91,0.65,32,0.0203125,25
3127.063126,61,85,0.61,24,0.025416667,25
3127.063126,60,86,0.66,26,0.025384615,25
3127.063126,58,89,0.78,31,0.02516129,25
3126.683767,61,91,0.58,30,0.019333333,25
3126.683767,60,92,0.62,32,0.019375,25
3125.777272,58,77,0.53,19,0.027894737,25
3125.708351,40,72,0.91,32,0.0284375,25
3125.704295,39,61,0.78,22,0.035454545,25
3125.629353,40,51,0.42,11,0.038181818,25
3125.421781,59,78,0.42,19,0.022105263,25
3124.949238,37,63,0.91,26,0.035,25
3124.911364,53,83,0.86,30,0.028666667,25
3124.853829,39,58,0.68,19,0.035789474,25
3124.724353,58,73,0.46,15,0.030666667,25
3124.724353,55,77,0.67,22,0.030454545,25
3124.433692,64,86,0.45,22,0.020454545,25
3124.433692,63,87,0.49,24,0.020416667,25
3124.433692,60,91,0.63,31,0.020322581,25
3124.432548,53,76,0.79,23,0.034347826,25
3124.069208,54,79,0.74,25,0.0296,25
3124.044297,64,88,0.46,24,0.019166667,25
3123.83158,36,56,0.76,20,0.038,25
3123.748927,56,91,0.88,35,0.025142857,25
3123.590946,55,81,0.71,26,0.027307692,25
3123.5003,62,91,0.54,29,0.01862069,25
3123.442906,52,81,0.87,29,0.03,25
3123.369195,51,59,0.26,8,0.0325,25
3123.275658,57,77,0.57,20,0.0285,25
3123.168239,58,75,0.5,17,0.029411765,25
3123.168239,55,78,0.68,23,0.029565217,25
3123.153225,50,73,0.58,23,0.025217391,25
3123.080525,54,79,0.73,25,0.0292,25
3122.96993,41,72,0.88,31,0.028387097,25
3122.845784,54,80,0.74,26,0.028461538,25
3122.845784,53,81,0.8,28,0.028571429,25
3122.845784,52,84,0.89,32,0.0278125,25
3122.845784,51,85,0.95,34,0.027941176,25
3122.796406,44,80,0.93,36,0.025833333,25
3122.796406,43,81,0.98,38,0.025789474,25
3122.357929,64,79,0.39,15,0.026,25
3121.779953,34,62,0.99,28,0.035357143,25
3121.772368,59,86,0.69,27,0.025555556,25
3121.680762,37,51,0.55,14,0.039285714,25
3121.482095,69,78,0.23,9,0.025555556,25
3121.482095,63,85,0.56,22,0.025454545,25
3121.409717,39,60,0.76,21,0.036190476,25
3121.126364,56,77,0.63,21,0.03,25
3121.126364,54,79,0.76,25,0.0304,25
3121.126364,53,80,0.82,27,0.03037037,25
3121.126364,52,82,0.9,30,0.03,25
3121.119959,64,84,0.43,20,0.0215,25
3120.817606,41,47,0.24,6,0.04,25
3120.720391,67,79,0.24,12,0.02,25
3120.70714,43,79,0.92,36,0.025555556,25
3120.413486,58,74,0.47,16,0.029375,25
3120.388716,53,83,0.87,30,0.029,25
3120.326212,54,92,0.99,38,0.026052632,25
3119.946493,63,90,0.51,27,0.018888889,25
3119.662562,53,84,0.88,31,0.028387097,25
3119.662562,52,85,0.94,33,0.028484848,25
3119.51459,35,57,0.85,22,0.038636364,25
3119.144142,53,72,0.67,19,0.035263158,25
3118.944785,50,62,0.3,12,0.025,25
3118.939514,36,59,0.81,23,0.035217391,25
3118.76232,54,93,0.99,39,0.025384615,25
3118.576131,59,90,0.66,31,0.021290323,25
3118.576131,58,91,0.7,33,0.021212121,25
3118.576131,57,93,0.76,36,0.021111111,25
3118.576131,55,96,0.86,41,0.02097561,25
3118.528545,43,71,0.88,28,0.031428571,25
3118.500304,57,89,0.81,32,0.0253125,25
3118.295071,53,82,0.83,29,0.02862069,25
3118.290865,52,86,0.96,34,0.028235294,25
3118.135054,55,78,0.69,23,0.03,25
3118.017707,41,73,0.86,32,0.026875,25
3117.972933,70,77,0.18,7,0.025714286,25
3117.922319,54,78,0.74,24,0.030833333,25
3117.922319,53,79,0.8,26,0.030769231,25
3117.738092,60,94,0.63,34,0.018529412,25
3117.679024,60,93,0.62,33,0.018787879,25
3117.670883,62,71,0.26,9,0.028888889,25
3117.586177,43,74,0.82,31,0.026451613,25
3117.521064,44,84,0.96,40,0.024,25
3117.497816,46,78,0.8,32,0.025,25
3117.294563,55,80,0.72,25,0.0288,25
3117.259465,66,71,0.11,5,0.022,25
3117.232618,68,79,0.28,11,0.025454545,25
3117.030952,52,82,0.89,30,0.029666667,25
3117.030952,51,83,0.95,32,0.0296875,25
3116.820788,65,79,0.37,14,0.026428571,25
3116.820788,62,83,0.55,21,0.026190476,25
3116.680027,46,82,0.87,36,0.024166667,25
3116.463957,57,80,0.67,23,0.029130435,25
3116.463957,56,81,0.73,25,0.0292,25
3116.463957,55,83,0.81,28,0.028928571,25
3115.862033,33,55,0.84,22,0.038181818,25
3115.784481,38,58,0.74,20,0.037,25
3115.753051,52,81,0.88,29,0.030344828,25
3115.601965,64,70,0.17,6,0.028333333,25
3115.373284,62,90,0.54,28,0.019285714,25
3115.286282,43,57,0.48,14,0.034285714,25
3115.035932,46,50,0.15,4,0.0375,25
3114.876956,43,82,0.98,39,0.025128205,25
3114.713409,41,49,0.31,8,0.03875,25
3114.710428,73,77,0.08,4,0.02,25
3114.710428,72,78,0.12,6,0.02,25
3114.710428,71,79,0.16,8,0.02,25
3114.710428,70,80,0.2,10,0.02,25
3114.710428,69,81,0.24,12,0.02,25
3114.508375,59,76,0.47,17,0.027647059,25
3114.417374,63,74,0.32,11,0.029090909,25
3114.417374,62,75,0.38,13,0.029230769,25
3114.417374,60,78,0.52,18,0.028888889,25
3114.417374,59,79,0.58,20,0.029,25
3114.291172,57,79,0.61,22,0.027727273,25
3114.252643,61,76,0.44,15,0.029333333,25
3114.252643,57,81,0.7,24,0.029166667,25
3114.062122,36,58,0.78,22,0.035454545,25
3113.766933,45,69,0.65,24,0.027083333,25
3113.681929,60,78,0.51,18,0.028333333,25
3113.369383,62,70,0.24,8,0.03,25
3113.369383,61,71,0.3,10,0.03,25
3113.369383,60,72,0.36,12,0.03,25
3113.369383,59,73,0.42,14,0.03,25
3113.369383,58,74,0.48,16,0.03,25
3113.369383,57,75,0.54,18,0.03,25
3113.331676,47,61,0.37,14,0.026428571,25
3113.287471,54,93,0.8,39,0.020512821,25
3113.120999,52,84,0.9,32,0.028125,25
3113.074049,63,82,0.49,19,0.025789474,25
3112.930179,51,85,0.97,34,0.028529412,25
3112.110195,46,81,0.84,35,0.024,25
3112.061294,43,47,0.15,4,0.0375,25
3112.061294,41,49,0.3,8,0.0375,25
3111.637769,56,81,0.67,25,0.0268,25
3111.553337,67,76,0.24,9,0.026666667,25
3111.350152,54,91,0.98,37,0.026486486,25
3111.334272,55,92,0.76,37,0.020540541,25
3111.187963,41,73,0.87,32,0.0271875,25
3111.138264,66,76,0.27,10,0.027,25
3111.138264,59,84,0.67,25,0.0268,25
3111.131007,66,83,0.36,17,0.021176471,25
3111.029315,50,65,0.36,15,0.024,25
3110.831342,42,80,0.97,38,0.025526316,25
3110.657448,49,77,0.98,28,0.035,25
3110.5794,53,85,0.93,32,0.0290625,25
3109.839423,65,78,0.34,13,0.026153846,25
3109.839423,61,83,0.57,22,0.025909091,25
3109.692804,34,60,0.96,26,0.036923077,25
3109.64401,38,59,0.76,21,0.036190476,25
3109.625604,63,89,0.5,26,0.019230769,25
3109.564409,62,85,0.46,23,0.02,25
3109.564409,61,86,0.5,25,0.02,25
3109.552762,44,69,0.69,25,0.0276,25
3109.543163,53,84,0.83,31,0.026774194,25
3109.233586,60,73,0.41,13,0.031538462,25
3108.826791,52,68,0.42,16,0.02625,25
3108.76799,57,75,0.55,18,0.030555556,25
3108.76799,56,76,0.61,20,0.0305,25
3108.539219,63,90,0.52,27,0.019259259,25
3108.481165,46,68,0.62,22,0.028181818,25
3108.225139,43,69,0.84,26,0.032307692,25
3108.20923,54,90,0.93,36,0.025833333,25
3108.103954,58,88,0.77,30,0.025666667,25
3108.103954,57,90,0.84,33,0.025454545,25
3108.082437,54,97,0.9,43,0.020930233,25
3108.076626,50,86,0.99,36,0.0275,25
3108.00901,56,76,0.6,20,0.03,25
3108.00901,55,77,0.66,22,0.03,25
3107.839453,59,89,0.59,30,0.019666667,25
3107.801937,46,68,0.61,22,0.027727273,25
3107.774836,52,86,0.9,34,0.026470588,25
3107.774836,51,87,0.96,36,0.026666667,25
3107.772316,52,81,0.85,29,0.029310345,25
3107.772316,51,82,0.91,31,0.029354839,25
3107.772316,51,83,0.93,32,0.0290625,25
3107.772316,50,84,0.99,34,0.029117647,25
3107.715566,55,68,0.46,13,0.035384615,25
3107.603843,52,83,0.89,31,0.028709677,25
3107.603843,51,84,0.95,33,0.028787879,25
3107.603326,57,93,0.77,36,0.021388889,25
3107.29563,66,82,0.4,16,0.025,25
3107.15614,43,71,0.77,28,0.0275,25
3106.769361,36,58,0.85,22,0.038636364,25
3106.681971,42,72,0.96,30,0.032,25
3106.5351,35,60,0.89,25,0.0356,25
3106.424524,52,83,0.91,31,0.029354839,25
3106.038105,40,74,0.97,34,0.028529412,25
3105.61109,45,70,0.7,25,0.028,25
3105.376958,55,84,0.83,29,0.02862069,25
3105.234124,38,54,0.59,16,0.036875,25
3105.172469,47,63,0.52,16,0.0325,25
3105.007032,36,56,0.77,20,0.0385,25
3104.950185,37,56,0.73,19,0.038421053,25
3104.845771,55,93,0.96,38,0.025263158,25
3104.809227,55,91,0.93,36,0.025833333,25
3104.405723,49,64,0.36,15,0.024,25
3104.141835,43,70,0.75,27,0.027777778,25
3103.77843,37,55,0.67,18,0.037222222,25
3103.765041,52,88,0.99,36,0.0275,25
3103.509331,60,85,0.65,25,0.026,25
3103.397191,35,61,0.91,26,0.035,25
3103.347602,61,92,0.58,31,0.018709677,25
3103.275133,47,50,0.11,3,0.036666667,25
3103.195097,56,88,0.85,32,0.0265625,25
3103.159775,52,84,0.93,32,0.0290625,25
3102.990808,61,90,0.59,29,0.020344828,25
3102.958903,40,74,0.96,34,0.028235294,25
3102.873854,48,62,0.45,14,0.032142857,25
3102.81062,45,82,0.91,37,0.024594595,25
3102.724727,41,72,0.9,31,0.029032258,25
3102.691793,44,78,0.87,34,0.025588235,25
3102.686617,61,77,0.35,16,0.021875,25
3102.6233,56,83,0.77,27,0.028518519,25
3102.478304,41,59,0.61,18,0.033888889,25
3102.334473,65,83,0.45,18,0.025,25
3102.334473,62,87,0.62,25,0.0248,25
3102.334473,61,88,0.67,27,0.024814815,25
3102.334473,58,92,0.84,34,0.024705882,25
3102.230439,57,76,0.58,19,0.030526316,25
3102.230439,56,77,0.64,21,0.03047619,25
3102.20228,38,61,0.84,23,0.036521739,25
3102.201906,52,85,0.97,33,0.029393939,25
3102.126285,54,91,0.97,37,0.026216216,25
3101.985706,42,74,0.87,32,0.0271875,25
3101.959022,60,75,0.42,15,0.028,25
3101.833551,56,68,0.43,12,0.035833333,25
3101.55439,55,92,0.94,37,0.025405405,25
3101.422545,46,77,0.8,31,0.025806452,25
3101.245611,64,73,0.26,9,0.028888889,25
3101.225125,42,81,0.98,39,0.025128205,25
3101.19864,59,83,0.67,24,0.027916667,25
3100.835025,61,76,0.33,15,0.022,25
3099.87887,46,76,0.76,30,0.025333333,25
3099.709713,56,80,0.67,24,0.027916667,25
3099.709713,55,81,0.73,26,0.028076923,25
3099.626764,56,79,0.67,23,0.029130435,25
3099.580298,63,71,0.23,8,0.02875,25
3099.566628,43,71,0.9,28,0.032142857,25
3099.536982,47,73,0.68,26,0.026153846,25
3099.511025,38,53,0.59,15,0.039333333,25
3099.504762,60,87,0.68,27,0.025185185,25
3099.504762,59,88,0.73,29,0.025172414,25
3099.465242,43,81,0.99,38,0.026052632,25
3099.462745,43,72,0.92,29,0.031724138,25
3099.3158,64,71,0.19,7,0.027142857,25
3099.3158,58,78,0.54,20,0.027,25
3099.3158,56,80,0.65,24,0.027083333,25
3099.313814,50,71,0.55,21,0.026190476,25
3099.203501,57,77,0.56,20,0.028,25
3098.945987,59,87,0.73,28,0.026071429,25
3098.796711,61,71,0.31,10,0.031,25
3098.71159,54,96,0.91,42,0.021666667,25
3098.682049,42,57,0.54,15,0.036,25
3098.678707,57,82,0.69,25,0.0276,25
3098.678707,54,85,0.86,31,0.027741935,25
3098.678707,54,86,0.88,32,0.0275,25
3098.502278,58,79,0.47,21,0.022380952,25
3098.119967,53,88,0.93,35,0.026571429,25
3097.942578,59,91,0.64,32,0.02,25
3097.927762,64,67,0.1,3,0.033333333,25
3097.877492,54,83,0.85,29,0.029310345,25
3097.877492,53,84,0.91,31,0.029354839,25
3097.72309,45,73,0.78,28,0.027857143,25
3097.644415,49,75,0.65,26,0.025,25
3097.423481,67,81,0.35,14,0.025,25
3097.357151,55,93,0.95,38,0.025,25
3097.319172,56,63,0.18,7,0.025714286,25
3097.146439,37,49,0.47,12,0.039166667,25
3096.904306,63,79,0.44,16,0.0275,25
3096.869535,51,83,0.96,32,0.03,25
3096.835555,54,84,0.8,30,0.026666667,25
3096.80051,49,72,0.6,23,0.026086957,25
3096.779129,53,60,0.17,7,0.024285714,25
3096.770645,53,86,0.95,33,0.028787879,25
3096.734131,41,52,0.42,11,0.038181818,25
3096.686419,69,74,0.13,5,0.026,25
3096.632062,43,73,0.85,30,0.028333333,25
3096.551393,46,83,0.87,37,0.023513514,25
3096.551393,46,84,0.88,38,0.023157895,25
3096.551393,45,85,0.93,40,0.02325,25
3096.545321,48,81,0.77,33,0.023333333,25
3096.545321,47,82,0.82,35,0.023428571,25
3096.490014,58,74,0.52,16,0.0325,25
3096.307618,56,95,0.81,39,0.020769231,25
3096.256419,53,84,0.84,31,0.027096774,25
3096.174237,48,66,0.48,18,0.026666667,25
3096.107787,55,93,0.97,38,0.025526316,25
3096.032707,42,73,0.98,31,0.031612903,25
3095.943229,51,85,0.96,34,0.028235294,25
3095.877473,54,79,0.75,25,0.03,25
3095.877473,53,80,0.81,27,0.03,25
3095.533979,46,64,0.59,18,0.032777778,25
3095.53192,40,61,0.68,21,0.032380952,25
3095.449146,43,73,0.86,30,0.028666667,25
3095.403243,61,82,0.56,21,0.026666667,25
3095.403243,58,86,0.74,28,0.026428571,25
3095.29735,52,82,0.87,30,0.029,25
3095.255483,62,69,0.22,7,0.031428571,25
3095.227411,67,79,0.32,12,0.026666667,25
3095.032878,50,63,0.37,13,0.028461538,25
3094.899348,56,74,0.38,18,0.021111111,25
3094.809183,54,93,0.97,39,0.024871795,25
3094.775419,43,72,0.91,29,0.03137931,25
3094.690345,58,77,0.52,19,0.027368421,25
3094.629817,59,76,0.48,17,0.028235294,25
3094.563279,44,71,0.76,27,0.028148148,25
3094.555656,57,91,0.85,34,0.025,25
3094.444488,40,76,0.99,36,0.0275,25
3094.370743,47,60,0.37,13,0.028461538,25
3094.25343,51,86,0.96,35,0.027428571,25
3094.219121,45,75,0.79,30,0.026333333,25
3094.067556,38,55,0.61,17,0.035882353,25
3093.492621,55,82,0.72,27,0.026666667,25
3093.379343,53,98,0.97,45,0.021555556,25
3093.274635,61,87,0.66,26,0.025384615,25
3093.082333,59,89,0.66,30,0.022,25
3092.974268,37,60,0.86,23,0.037391304,25
3092.833911,58,98,0.74,40,0.0185,25
3092.812603,64,87,0.46,23,0.02,25
3092.812603,63,88,0.5,25,0.02,25
3092.685213,42,75,0.91,33,0.027575758,25
3092.316782,57,85,0.74,28,0.026428571,25
3092.208075,51,85,0.93,34,0.027352941,25
3091.963639,53,98,0.96,45,0.021333333,25
3091.69169,34,58,0.92,24,0.038333333,25
3091.181029,54,97,0.91,43,0.021162791,25
3091.172835,57,83,0.56,26,0.021538462,25
3090.973552,49,77,0.99,28,0.035357143,25
3090.579279,37,63,0.9,26,0.034615385,25
3090.364403,67,82,0.31,15,0.020666667,25
3090.220847,60,77,0.5,17,0.029411765,25
3090.220847,58,80,0.64,22,0.029090909,25
3090.160251,54,81,0.76,27,0.028148148,25
3090.160251,53,82,0.82,29,0.028275862,25
3090.160251,52,83,0.88,31,0.028387097,25
3090.099233,52,73,0.74,21,0.035238095,25
3089.947467,50,64,0.33,14,0.023571429,25
3089.923111,39,52,0.51,13,0.039230769,25
3089.848423,51,74,0.82,23,0.035652174,25
3089.842231,58,79,0.61,21,0.029047619,25
3089.842231,57,81,0.69,24,0.02875,25
3089.842231,56,82,0.75,26,0.028846154,25
3089.810261,49,74,0.63,25,0.0252,25
3089.776587,68,82,0.29,14,0.020714286,25
3089.776587,64,86,0.46,22,0.020909091,25
3089.684204,52,80,0.85,28,0.030357143,25
3089.578439,45,65,0.65,20,0.0325,25
3089.532469,60,69,0.19,9,0.021111111,25
3089.410723,43,67,0.79,24,0.032916667,25
3089.407572,36,57,0.77,21,0.036666667,25
3089.383485,38,53,0.56,15,0.037333333,25
3089.242987,56,77,0.67,21,0.031904762,25
3089.015059,66,72,0.13,6,0.021666667,25
3088.959933,62,88,0.52,26,0.02,25
3088.877576,39,51,0.45,12,0.0375,25
3088.569066,64,78,0.39,14,0.027857143,25
3088.509126,68,74,0.16,6,0.026666667,25
3088.283694,34,54,0.8,20,0.04,25
3088.012871,57,93,0.89,36,0.024722222,25
3087.975529,64,78,0.38,14,0.027142857,25
3087.975529,62,80,0.49,18,0.027222222,25
3087.974535,40,50,0.39,10,0.039,25
3087.740649,59,85,0.68,26,0.026153846,25
3086.952533,53,83,0.81,30,0.027,25
3086.849533,57,89,0.91,32,0.0284375,25
3086.849533,56,90,0.97,34,0.028529412,25
3086.767007,68,73,0.14,5,0.028,25
3086.767007,62,80,0.5,18,0.027777778,25
3086.192414,53,83,0.82,30,0.027333333,25
3085.908799,46,68,0.59,22,0.026818182,25
3085.673912,51,86,0.93,35,0.026571429,25
3085.651273,42,74,0.88,32,0.0275,25
3085.635148,62,84,0.56,22,0.025454545,25
3085.489101,46,72,0.72,26,0.027692308,25
3085.437513,56,93,0.91,37,0.024594595,25
3085.093321,53,85,0.85,32,0.0265625,25
3084.817508,52,71,0.48,19,0.025263158,25
3084.817508,51,72,0.53,21,0.025238095,25
3084.784938,54,82,0.81,28,0.028928571,25
3084.747999,61,89,0.58,28,0.020714286,25
3084.49981,70,76,0.16,6,0.026666667,25
3084.499353,40,60,0.71,20,0.0355,25
3084.359519,44,82,0.93,38,0.024473684,25
3084.199761,53,81,0.83,28,0.029642857,25
3083.954117,42,56,0.51,14,0.036428571,25
3083.836882,55,86,0.82,31,0.026451613,25
3083.836882,54,88,0.89,34,0.026176471,25
3083.836882,53,89,0.95,36,0.026388889,25
3083.577029,60,83,0.61,23,0.026521739,25
3083.460831,55,82,0.79,27,0.029259259,25
3083.094035,61,78,0.47,17,0.027647059,25
3082.761023,58,75,0.54,17,0.031764706,25
3082.686402,61,77,0.46,16,0.02875,25
3082.639179,46,79,0.82,33,0.024848485,25
3082.639179,45,80,0.87,35,0.024857143,25
3082.491148,55,70,0.53,15,0.035333333,25
3082.462681,59,75,0.46,16,0.02875,25
3082.462681,58,76,0.52,18,0.028888889,25
3082.367206,51,86,0.94,35,0.026857143,25
3082.283606,60,88,0.55,28,0.019642857,25
3082.21346,43,71,0.89,28,0.031785714,25
3082.205597,60,86,0.67,26,0.025769231,25
3082.205597,59,87,0.72,28,0.025714286,25
3082.16302,44,72,0.75,28,0.026785714,25
3081.998158,54,82,0.77,28,0.0275,25
3081.788079,51,88,0.97,37,0.026216216,25
3081.509314,61,87,0.56,26,0.021538462,25
3081.509314,58,91,0.71,33,0.021515152,25
3081.509314,56,94,0.81,38,0.021315789,25
3081.444654,46,78,0.81,32,0.0253125,25
3081.411205,52,87,0.95,35,0.027142857,25
3081.405956,58,85,0.75,27,0.027777778,25
3081.346408,57,82,0.7,25,0.028,25
3081.26807,55,81,0.72,26,0.027692308,25
3081.257233,39,52,0.48,13,0.036923077,25
3081.173429,52,84,0.94,32,0.029375,25
3081.165396,58,77,0.54,19,0.028421053,25
3081.165396,57,78,0.6,21,0.028571429,25
3081.080068,60,85,0.64,25,0.0256,25
3081.012009,62,72,0.28,10,0.028,25
3080.875777,62,88,0.54,26,0.020769231,25
3080.807376,52,67,0.4,15,0.026666667,25
3080.772657,56,92,0.92,36,0.025555556,25
3080.739126,57,99,0.78,42,0.018571429,25
3080.35556,60,72,0.37,12,0.030833333,25
3080.272767,59,92,0.67,33,0.02030303,25
3080.211144,55,96,0.87,41,0.021219512,25
3079.886607,48,76,0.7,28,0.025,25
3079.730723,43,70,0.73,27,0.027037037,25
3079.729669,37,56,0.74,19,0.038947368,25
3079.39016,54,81,0.75,27,0.027777778,25
3079.39016,53,82,0.81,29,0.027931034,25
3079.155038,42,71,0.83,29,0.02862069,25
3078.978594,64,79,0.32,15,0.021333333,25
3078.964604,48,68,0.47,20,0.0235,25
3078.940839,45,70,0.66,25,0.0264,25
3078.920587,67,69,0.06,2,0.03,25
3078.920587,66,70,0.12,4,0.03,25
3078.920587,65,71,0.18,6,0.03,25
3078.920587,64,72,0.24,8,0.03,25
3078.920587,63,73,0.3,10,0.03,25
3078.920587,62,74,0.36,12,0.03,25
3078.920587,61,75,0.42,14,0.03,25
3078.920587,60,76,0.48,16,0.03,25
3078.778817,52,89,0.99,37,0.026756757,25
3078.665329,42,72,0.97,30,0.032333333,25
3078.619146,54,79,0.8,25,0.032,25
3078.443332,45,81,0.89,36,0.024722222,25
3078.372072,52,85,0.89,33,0.026969697,25
3078.311602,53,88,0.96,35,0.027428571,25
3078.126641,47,65,0.57,18,0.031666667,25
3078.018983,65,76,0.31,11,0.028181818,25
3077.967722,36,63,0.95,27,0.035185185,25
3077.539936,57,77,0.58,20,0.029,25
3077.539936,56,78,0.64,22,0.029090909,25
3077.477138,56,92,0.91,36,0.025277778,25
3077.20425,59,73,0.43,14,0.030714286,25
3077.177176,60,74,0.41,14,0.029285714,25
3077.159089,60,88,0.6,28,0.021428571,25
3077.15349,64,81,0.44,17,0.025882353,25
3077.151216,51,82,0.94,31,0.030322581,25
3077.136901,47,52,0.17,5,0.034,25
3077.08996,56,96,0.77,40,0.01925,25
3077.073124,53,86,0.87,33,0.026363636,25
3076.790608,44,70,0.81,26,0.031153846,25
3076.749362,62,71,0.27,9,0.03,25
3076.600824,52,86,0.91,34,0.026764706,25
3076.391704,59,82,0.61,23,0.026521739,25
3076.391704,58,84,0.68,26,0.026153846,25
3076.391704,56,86,0.79,30,0.026333333,25
3076.391704,55,88,0.86,33,0.026060606,25
3076.391704,54,89,0.92,35,0.026285714,25
3076.33459,56,80,0.68,24,0.028333333,25
3076.181618,36,62,0.93,26,0.035769231,25
3076.126057,65,76,0.29,11,0.026363636,25
3076.126057,62,80,0.47,18,0.026111111,25
3075.959221,63,74,0.24,11,0.021818182,25
3075.895457,43,69,0.74,26,0.028461538,25
3075.715336,51,64,0.31,13,0.023846154,25
3075.162286,51,81,0.93,30,0.031,25
3074.643555,53,91,0.99,38,0.026052632,25
3074.643037,59,81,0.59,22,0.026818182,25
3074.643037,55,86,0.83,31,0.026774194,25
3074.495779,50,76,0.91,26,0.035,25
3074.084074,39,62,0.76,23,0.033043478,25
3074.06263,61,70,0.3,9,0.033333333,25
3074.06263,58,73,0.5,15,0.033333333,25
3073.616449,52,84,0.87,32,0.0271875,25
3073.502195,58,82,0.65,24,0.027083333,25
3073.502195,56,84,0.76,28,0.027142857,25
3073.33153,36,64,0.97,28,0.034642857,25
3073.105232,51,84,0.94,33,0.028484848,25
3072.959375,67,73,0.16,6,0.026666667,25
3072.923398,51,60,0.26,9,0.028888889,25
3072.836947,50,63,0.35,13,0.026923077,25
3072.739934,65,83,0.36,18,0.02,25
3072.739934,64,84,0.4,20,0.02,25
3072.69103,58,81,0.64,23,0.027826087,25
3072.554662,67,83,0.31,16,0.019375,25
3072.527174,56,79,0.63,23,0.027391304,25
3072.277699,62,91,0.55,29,0.018965517,25
3072.227215,54,84,0.88,30,0.029333333,25
3072.215113,53,82,0.87,29,0.03,25
3072.215113,52,82,0.91,30,0.030333333,25
3072.215113,52,83,0.93,31,0.03,25
3072.215113,51,84,0.99,33,0.03,25
3071.890488,61,72,0.32,11,0.029090909,25
3071.779513,50,61,0.32,11,0.029090909,25
3071.743535,55,78,0.7,23,0.030434783,25
3071.742092,37,62,0.89,25,0.0356,25
3071.739692,42,80,0.98,38,0.025789474,25
3071.647372,66,85,0.39,19,0.020526316,25
3071.604326,44,71,0.72,27,0.026666667,25
3071.421324,55,81,0.74,26,0.028461538,25
3071.421324,54,82,0.8,28,0.028571429,25
3071.111749,37,60,0.83,23,0.036086957,25
3070.983428,40,52,0.47,12,0.039166667,25
3070.773623,56,82,0.69,26,0.026538462,25
3070.604817,42,74,0.9,32,0.028125,25
3070.602924,63,84,0.42,21,0.02,25
3070.598271,36,64,0.98,28,0.035,25
3070.521821,59,96,0.68,37,0.018378378,25
3070.354425,65,80,0.39,15,0.026,25
3070.246355,57,74,0.52,17,0.030588235,25
3070.163778,59,94,0.67,35,0.019142857,25
3069.901964,66,76,0.26,10,0.026,25
3069.901964,62,81,0.49,19,0.025789474,25
3069.720855,39,52,0.49,13,0.037692308,25
3069.707111,59,74,0.44,15,0.029333333,25
3069.68149,60,91,0.61,31,0.019677419,25
3069.549654,71,76,0.11,5,0.022,25
3069.549654,68,80,0.26,12,0.021666667,25
3069.513471,70,75,0.13,5,0.026,25
3069.513471,62,84,0.57,22,0.025909091,25
3069.450209,54,71,0.6,17,0.035294118,25
3069.312052,56,83,0.76,27,0.028148148,25
3069.312052,55,84,0.82,29,0.028275862,25
3069.312052,54,85,0.88,31,0.028387097,25
3069.312052,53,86,0.94,33,0.028484848,25
3069.249224,65,77,0.33,12,0.0275,25
3069.245329,68,75,0.18,7,0.025714286,25
3068.369679,57,94,0.73,37,0.01972973,25
3068.348307,44,71,0.77,27,0.028518519,25
3068.318978,42,50,0.31,8,0.03875,25
3068.244037,54,83,0.78,29,0.026896552,25
3068.140187,54,78,0.72,24,0.03,25
3068.060056,61,81,0.55,20,0.0275,25
3068.060056,60,83,0.62,23,0.026956522,25
3068.060056,59,84,0.68,25,0.0272,25
3068.060056,58,85,0.74,27,0.027407407,25
3068.060056,57,86,0.79,29,0.027241379,25
3068.060056,55,89,0.92,34,0.027058824,25
3067.89514,61,93,0.6,32,0.01875,25
3067.89514,60,94,0.64,34,0.018823529,25
3067.875038,48,65,0.41,17,0.024117647,25
3067.652693,61,70,0.28,9,0.031111111,25
3067.509736,54,59,0.12,5,0.024,25
3067.497827,47,64,0.5,17,0.029411765,25
3067.307268,52,85,0.92,33,0.027878788,25
3067.307268,52,86,0.93,34,0.027352941,25
3067.307268,51,87,0.99,36,0.0275,25
3067.280155,59,95,0.67,36,0.018611111,25
3067.221275,43,80,0.93,37,0.025135135,25
3067.184434,63,81,0.48,18,0.026666667,25
3066.984097,60,73,0.38,13,0.029230769,25
3066.91127,51,68,0.53,17,0.031176471,25
3066.840536,73,74,0.02,1,0.02,25
3066.840536,72,75,0.06,3,0.02,25
3066.840536,71,76,0.1,5,0.02,25
3066.840536,70,77,0.14,7,0.02,25
3066.836419,54,83,0.8,29,0.027586207,25
3066.836419,53,84,0.86,31,0.027741935,25
3066.836419,52,85,0.91,33,0.027575758,25
3066.793817,60,88,0.62,28,0.022142857,25
3066.793817,58,90,0.71,32,0.0221875,25
3066.793817,57,92,0.77,35,0.022,25
3066.764481,42,74,0.92,32,0.02875,25
3066.691727,53,79,0.79,26,0.030384615,25
3066.622871,55,91,0.94,36,0.026111111,25
3066.421813,44,67,0.67,23,0.029130435,25
3066.331139,41,70,0.85,29,0.029310345,25
3066.138607,60,78,0.39,18,0.021666667,25
3065.817522,45,77,0.82,32,0.025625,25
3065.79977,53,61,0.19,8,0.02375,25
3065.717211,37,60,0.85,23,0.036956522,25
3065.592519,35,58,0.85,23,0.036956522,25
3065.346116,50,63,0.36,13,0.027692308,25
3065.01439,58,74,0.49,16,0.030625,25
3064.961559,54,78,0.73,24,0.030416667,25
3064.951642,57,86,0.8,29,0.027586207,25
3064.951642,54,90,0.99,36,0.0275,25
3064.943857,44,79,0.88,35,0.025142857,25
3064.199797,35,99,0.15,64,0.00234375,25
3064.11266,40,73,0.96,33,0.029090909,25
3064.073592,62,82,0.52,20,0.026,25
3063.856762,41,72,0.89,31,0.028709677,25
3063.854744,68,82,0.27,14,0.019285714,25
3063.663505,55,80,0.69,25,0.0276,25
3063.661143,47,68,0.56,21,0.026666667,25
3063.631393,59,89,0.67,30,0.022333333,25
3063.562815,57,83,0.71,26,0.027307692,25
3063.530429,58,88,0.84,30,0.028,25
3063.459876,45,84,0.94,39,0.024102564,25
3063.228506,61,92,0.59,31,0.019032258,25
3063.12212,55,95,0.86,40,0.0215,25
3063.101313,59,79,0.57,20,0.0285,25
3063.101313,58,80,0.63,22,0.028636364,25
3063.014484,41,77,0.98,36,0.027222222,25
3062.990136,64,68,0.13,4,0.0325,25
3062.990136,62,70,0.26,8,0.0325,25
3062.990136,60,72,0.39,12,0.0325,25
3062.940904,47,81,0.81,34,0.023823529,25
3062.847782,41,77,0.99,36,0.0275,25
3062.846111,40,73,0.97,33,0.029393939,25
3062.78131,53,73,0.7,20,0.035,25
3062.78131,52,74,0.77,22,0.035,25
3062.699646,64,81,0.48,17,0.028235294,25
3062.693486,57,71,0.33,14,0.023571429,25
3062.622096,43,69,0.76,26,0.029230769,25
3062.498876,59,91,0.67,32,0.0209375,25
3062.458298,48,65,0.51,17,0.03,25
3062.448216,52,68,0.41,16,0.025625,25
3062.166357,37,67,0.99,30,0.033,25
3062.078648,59,80,0.58,21,0.027619048,25
3062.027372,55,82,0.75,27,0.027777778,25
3062.027372,53,85,0.88,32,0.0275,25
3062.027372,52,86,0.94,34,0.027647059,25
3061.941272,57,87,0.79,30,0.026333333,25
3061.775935,53,88,0.95,35,0.027142857,25
3061.717732,60,82,0.58,22,0.026363636,25
3061.717732,59,84,0.65,25,0.026,25
3061.717732,57,86,0.76,29,0.026206897,25
3061.717732,56,88,0.83,32,0.0259375,25
3061.547849,62,91,0.56,29,0.019310345,25
3061.547849,61,92,0.6,31,0.019354839,25
3061.547849,60,93,0.64,33,0.019393939,25
3061.313072,62,88,0.53,26,0.020384615,25
3061.222886,63,72,0.26,9,0.028888889,25
3061.222886,57,79,0.63,22,0.028636364,25
3060.882366,56,58,0.05,2,0.025,25
3060.882366,55,59,0.1,4,0.025,25
3060.882366,54,60,0.15,6,0.025,25
3060.882366,53,61,0.2,8,0.025,25
3060.882366,52,62,0.25,10,0.025,25
3060.790745,52,85,0.88,33,0.026666667,25
3060.752942,59,76,0.49,17,0.028823529,25
3060.752942,58,77,0.55,19,0.028947368,25
3060.698656,58,91,0.72,33,0.021818182,25
3060.119313,39,72,0.98,33,0.02969697,25
3059.894571,52,67,0.39,15,0.026,25
3059.775671,65,82,0.44,17,0.025882353,25
3059.775671,61,87,0.67,26,0.025769231,25
3059.612097,50,74,0.6,24,0.025,25
3059.508151,52,86,0.95,34,0.027941176,25
3059.179293,58,87,0.75,29,0.025862069,25
3059.159556,56,95,0.82,39,0.021025641,25
3059.07221,58,74,0.5,16,0.03125,25
3058.86131,41,51,0.39,10,0.039,25
3058.835763,58,90,0.64,32,0.02,25
3058.78102,47,63,0.51,16,0.031875,25
3058.650116,40,72,0.92,32,0.02875,25
3058.616073,45,83,0.92,38,0.024210526,25
3058.565415,62,79,0.45,17,0.026470588,25
3058.493094,54,77,0.48,23,0.020869565,25
3058.348479,52,60,0.23,8,0.02875,25
3058.284859,64,80,0.42,16,0.02625,25
3057.984817,56,76,0.62,20,0.031,25
3057.978653,68,81,0.27,13,0.020769231,25
3057.914143,56,78,0.66,22,0.03,25
3057.914143,55,79,0.72,24,0.03,25
3057.907111,63,84,0.43,21,0.02047619,25
3057.523395,45,69,0.67,24,0.027916667,25
3057.508618,57,89,0.83,32,0.0259375,25
3057.508618,56,91,0.9,35,0.025714286,25
3057.426436,69,81,0.25,12,0.020833333,25
3057.425344,38,57,0.66,19,0.034736842,25
3057.40972,49,65,0.38,16,0.02375,25
3057.40972,48,66,0.43,18,0.023888889,25
3057.408451,45,84,0.92,39,0.023589744,25
3057.320907,48,79,0.75,31,0.024193548,25
3057.163398,37,54,0.66,17,0.038823529,25
3057.163398,36,55,0.74,19,0.038947368,25
3057.130862,64,76,0.32,12,0.026666667,25
3057.130862,61,80,0.5,19,0.026315789,25
3057.009706,41,72,0.96,31,0.030967742,25
3056.996024,53,67,0.37,14,0.026428571,25
3056.977294,38,63,0.88,25,0.0352,25
3056.893885,52,88,0.98,36,0.027222222,25
3056.827077,54,90,0.94,36,0.026111111,25
3056.779276,65,85,0.41,20,0.0205,25
3056.779276,62,89,0.55,27,0.02037037,25
3056.757087,39,52,0.5,13,0.038461538,25
3056.756263,55,85,0.82,30,0.027333333,25
3056.632044,38,59,0.77,21,0.036666667,25
3056.573197,38,59,0.69,21,0.032857143,25
3056.393042,67,84,0.35,17,0.020588235,25
3055.950187,55,95,0.87,40,0.02175,25
3055.873459,61,86,0.56,25,0.0224,25
3055.826778,36,61,0.92,25,0.0368,25
3055.745687,66,84,0.35,18,0.019444444,25
3055.6202,40,75,0.99,35,0.028285714,25
3055.607501,46,65,0.56,19,0.029473684,25
3055.478413,40,51,0.4,11,0.036363636,25
3055.459116,63,85,0.44,22,0.02,25
3055.407095,56,85,0.77,29,0.026551724,25
3055.40286,42,52,0.34,10,0.034,25
3055.40286,41,53,0.41,12,0.034166667,25
3055.330373,58,84,0.73,26,0.028076923,25
3055.260569,59,75,0.45,16,0.028125,25
3055.215121,47,75,0.71,28,0.025357143,25
3055.20365,60,85,0.66,25,0.0264,25
3055.124657,42,72,0.84,30,0.028,25
3055.030305,58,89,0.79,31,0.025483871,25
3054.51051,45,77,0.83,32,0.0259375,25
3054.297386,58,93,0.69,35,0.019714286,25
3054.277011,56,87,0.86,31,0.027741935,25
3054.277011,55,88,0.92,33,0.027878788,25
3054.020056,43,81,0.97,38,0.025526316,25
3053.947754,51,75,0.84,24,0.035,25
3053.611099,50,76,0.63,26,0.024230769,25
3053.604558,62,81,0.5,19,0.026315789,25
3052.932648,59,82,0.48,23,0.020869565,25
3052.706877,56,94,0.96,38,0.025263158,25
3052.653193,36,55,0.71,19,0.037368421,25
3052.553062,58,88,0.79,30,0.026333333,25
3052.553062,56,91,0.91,35,0.026,25
3052.449898,40,50,0.37,10,0.037,25
3052.254874,62,78,0.43,16,0.026875,25
3052.254874,60,80,0.54,20,0.027,25
3052.032929,65,81,0.43,16,0.026875,25
3051.844347,54,83,0.83,29,0.02862069,25
3051.844347,53,84,0.89,31,0.028709677,25
3051.656108,63,83,0.52,20,0.026,25
3051.511462,65,86,0.43,21,0.02047619,25
3051.471089,55,77,0.72,22,0.032727273,25
3051.370602,47,78,0.77,31,0.02483871,25
3051.364653,59,86,0.7,27,0.025925926,25
3051.364653,57,89,0.82,32,0.025625,25
3051.342855,44,67,0.73,23,0.03173913,25
3051.264987,52,57,0.13,5,0.026,25
3051.054146,58,82,0.66,24,0.0275,25
3051.054146,56,85,0.79,29,0.027241379,25
3051.054146,54,88,0.92,34,0.027058824,25
3051.004543,52,86,0.99,34,0.029117647,25
3050.958728,42,70,0.8,28,0.028571429,25
3050.700983,45,68,0.65,23,0.02826087,25
3050.68839,68,77,0.23,9,0.025555556,25
3050.510357,36,59,0.89,23,0.038695652,25
3050.477783,52,84,0.95,32,0.0296875,25
3050.399739,54,80,0.79,26,0.030384615,25
3050.394196,55,85,0.81,30,0.027,25
3050.291206,65,85,0.39,20,0.0195,25
3050.291206,64,86,0.43,22,0.019545455,25
3050.173466,57,91,0.68,34,0.02,25
3050.170732,46,69,0.62,23,0.026956522,25
3050.155275,51,63,0.3,12,0.025,25
3050.080724,47,62,0.39,15,0.026,25
3049.948059,59,92,0.63,33,0.019090909,25
3049.906092,54,82,0.79,28,0.028214286,25
3049.893981,54,82,0.78,28,0.027857143,25
3049.893981,51,86,0.97,35,0.027714286,25
3049.809413,57,94,0.76,37,0.020540541,25
3049.575621,37,54,0.63,17,0.037058824,25
3049.45895,44,71,0.68,27,0.025185185,25
3049.354191,53,99,0.98,46,0.021304348,25
3049.353392,35,57,0.83,22,0.037727273,25
3049.344579,64,82,0.41,18,0.022777778,25
3049.287108,50,61,0.34,11,0.030909091,25
3049.081795,60,93,0.63,33,0.019090909,25
3048.730166,48,80,0.76,32,0.02375,25
3048.562011,52,82,0.93,30,0.031,25
3048.551441,76,98,0.15,22,0.006818182,25
3048.523856,54,85,0.87,31,0.028064516,25
3048.489918,56,91,0.72,35,0.020571429,25
3048.478721,42,70,0.88,28,0.031428571,25
3048.47136,61,91,0.57,30,0.019,25
3048.027353,38,60,0.78,22,0.035454545,25
3047.983906,43,54,0.41,11,0.037272727,25
3047.498374,42,71,0.9,29,0.031034483,25
3047.314786,42,72,0.82,30,0.027333333,25
3047.241513,36,53,0.65,17,0.038235294,25
3046.61406,51,63,0.29,12,0.024166667,25
3046.551451,44,78,0.88,34,0.025882353,25
3046.527116,44,85,0.99,41,0.024146341,25
3046.492291,57,88,0.89,31,0.028709677,25
3045.9453,59,83,0.63,24,0.02625,25
3045.9453,58,85,0.7,27,0.025925926,25
3045.9453,57,86,0.75,29,0.025862069,25
3045.9453,56,87,0.81,31,0.026129032,25
3045.9453,55,89,0.88,34,0.025882353,25
3045.9453,54,91,0.95,37,0.025675676,25
3045.765505,36,63,0.96,27,0.035555556,25
3045.613115,55,87,0.84,32,0.02625,25
3045.613115,54,89,0.91,35,0.026,25
3045.613115,53,90,0.97,37,0.026216216,25
3045.613115,53,91,0.98,38,0.025789474,25
3045.484408,38,56,0.71,18,0.039444444,25
3045.385727,37,61,0.86,24,0.035833333,25
3045.193255,37,60,0.84,23,0.036521739,25
3045.122755,54,83,0.81,29,0.027931034,25
3045.103891,44,70,0.83,26,0.031923077,25
3045.07543,41,74,0.9,33,0.027272727,25
3044.994064,50,75,0.89,25,0.0356,25
3044.787585,38,55,0.66,17,0.038823529,25
3044.782767,62,85,0.51,23,0.022173913,25
3044.481583,62,76,0.3,14,0.021428571,25
3044.141395,66,80,0.28,14,0.02,25
3044.058661,55,58,0.07,3,0.023333333,25
3044.041821,50,65,0.35,15,0.023333333,25
3043.885702,41,73,0.92,32,0.02875,25
3043.85223,45,70,0.71,25,0.0284,25
3043.805944,58,91,0.73,33,0.022121212,25
3043.502037,62,89,0.54,27,0.02,25
3043.468615,42,69,0.88,27,0.032592593,25
3043.409733,55,77,0.68,22,0.030909091,25
3043.28034,61,85,0.62,24,0.025833333,25
3043.121607,44,69,0.71,25,0.0284,25
3043.023523,64,83,0.42,19,0.022105263,25
3042.906067,41,74,0.93,33,0.028181818,25
3042.900853,47,69,0.52,22,0.023636364,25
3042.893362,34,59,0.94,25,0.0376,25
3042.846406,56,84,0.77,28,0.0275,25
3042.750246,57,87,0.77,30,0.025666667,25
3042.750246,56,88,0.82,32,0.025625,25
3042.635341,56,78,0.67,22,0.030454545,25
3042.490172,55,79,0.73,24,0.030416667,25
3042.429845,39,57,0.62,18,0.034444444,25
3042.175656,48,70,0.6,22,0.027272727,25
3042.058712,59,78,0.56,19,0.029473684,25
3042.058712,58,79,0.62,21,0.02952381,25
3042.058712,57,80,0.68,23,0.029565217,25
3041.993424,48,74,0.67,26,0.025769231,25
3041.954655,44,67,0.75,23,0.032608696,25
3041.87918,43,68,0.73,25,0.0292,25
3041.87918,42,69,0.79,27,0.029259259,25
3041.865128,41,71,0.87,30,0.029,25
3041.838955,58,85,0.73,27,0.027037037,25
3041.812156,46,66,0.58,20,0.029,25
3041.657867,52,88,0.94,36,0.026111111,25
3041.596044,50,70,0.53,20,0.0265,25
3041.544547,64,79,0.4,15,0.026666667,25
3041.4618,44,83,0.94,39,0.024102564,25
3041.264698,60,87,0.61,27,0.022592593,25
3040.939991,38,62,0.86,24,0.035833333,25
3040.620923,58,73,0.47,15,0.031333333,25
3040.428735,41,75,0.93,34,0.027352941,25
3040.340163,46,80,0.84,34,0.024705882,25
3040.313662,48,66,0.44,18,0.024444444,25
3040.308045,42,70,0.89,28,0.031785714,25
3040.257769,53,84,0.87,31,0.028064516,25
3040.195024,46,65,0.55,19,0.028947368,25
3039.950261,55,88,0.87,33,0.026363636,25
3039.892267,57,91,0.86,34,0.025294118,25
3039.774236,57,82,0.71,25,0.0284,25
3039.700518,68,82,0.28,14,0.02,25
3039.495117,65,78,0.35,13,0.026923077,25
3039.25983,52,85,0.9,33,0.027272727,25
3039.223385,55,91,0.75,36,0.020833333,25
3039.195547,68,80,0.24,12,0.02,25
3039.195547,67,81,0.28,14,0.02,25
3039.195547,66,82,0.32,16,0.02,25
3039.073061,37,57,0.71,20,0.0355,25
3038.973572,39,72,0.97,33,0.029393939,25
3038.952778,64,88,0.48,24,0.02,25
3038.943866,45,76,0.81,31,0.026129032,25
3038.83468,58,90,0.84,32,0.02625,25
3038.713684,34,58,0.91,24,0.037916667,25
3038.589943,43,58,0.48,15,0.032,25
3038.420139,62,86,0.53,24,0.022083333,25
3038.321327,52,61,0.21,9,0.023333333,25
3038.121579,42,71,0.79,29,0.027241379,25
3037.91765,42,72,0.94,30,0.031333333,25
3037.912333,55,92,0.92,37,0.024864865,25
3037.889324,62,72,0.29,10,0.029,25
3037.872006,60,74,0.39,14,0.027857143,25
3037.864278,45,73,0.79,28,0.028214286,25
3037.727708,54,97,0.93,43,0.021627907,25
3037.535101,56,69,0.42,13,0.032307692,25
3037.495598,62,88,0.5,26,0.019230769,25
3037.456347,48,60,0.39,12,0.0325,25
3037.206065,46,74,0.74,28,0.026428571,25
3037.117184,53,88,0.94,35,0.026857143,25
3036.974113,66,81,0.33,15,0.022,25
3036.974113,61,87,0.57,26,0.021923077,25
3036.890275,55,75,0.42,20,0.021,25
3036.802922,62,76,0.4,14,0.028571429,25
3036.595313,41,76,0.98,35,0.028,25
3036.529647,57,84,0.72,27,0.026666667,25
3036.529647,55,87,0.85,32,0.0265625,25
3036.40204,60,87,0.54,27,0.02,25
3036.300508,43,45,0.08,2,0.04,25
3036.300508,42,46,0.16,4,0.04,25
3036.053286,54,83,0.86,29,0.029655172,25
3036.028623,43,50,0.25,7,0.035714286,25
3035.989439,52,62,0.24,10,0.024,25
3035.832972,37,98,0.13,61,0.002131148,25
3035.762483,39,54,0.58,15,0.038666667,25
3035.721042,42,74,0.89,32,0.0278125,25
3035.706077,46,69,0.61,23,0.026521739,25
3035.638047,58,94,0.88,36,0.024444444,25
3035.572934,59,90,0.67,31,0.021612903,25
3035.480851,43,72,0.84,29,0.028965517,25
3035.402502,58,83,0.67,25,0.0268,25
3035.402502,56,85,0.78,29,0.026896552,25
3035.272259,52,85,0.93,33,0.028181818,25
3035.272259,51,86,0.99,35,0.028285714,25
3034.987577,40,56,0.53,16,0.033125,25
3034.965382,57,81,0.68,24,0.028333333,25
3034.962076,35,57,0.81,22,0.036818182,25
3034.921223,40,48,0.31,8,0.03875,25
3034.833364,47,79,0.79,32,0.0246875,25
3034.733619,61,83,0.63,22,0.028636364,25
3034.477568,44,84,0.97,40,0.02425,25
3034.468729,37,65,0.94,28,0.033571429,25
3034.367666,48,77,0.71,29,0.024482759,25
3034.033895,46,67,0.64,21,0.03047619,25
3034.017057,36,55,0.75,19,0.039473684,25
3033.950081,49,62,0.38,13,0.029230769,25
3033.852807,55,80,0.75,25,0.03,25
3033.773529,62,82,0.53,20,0.0265,25
3033.773529,61,83,0.58,22,0.026363636,25
3033.773529,59,85,0.69,26,0.026538462,25
3033.773529,59,86,0.71,27,0.026296296,25
3033.773529,58,87,0.76,29,0.026206897,25
3033.649174,66,78,0.32,12,0.026666667,25
3033.561613,63,84,0.47,21,0.022380952,25
3033.561584,36,99,0.13,63,0.002063492,25
3033.520056,51,86,0.98,35,0.028,25
3033.502286,40,53,0.5,13,0.038461538,25
3033.295334,61,83,0.6,22,0.027272727,25
3033.252655,56,79,0.64,23,0.027826087,25
3033.252655,53,83,0.83,30,0.027666667,25
3033.172941,60,87,0.69,27,0.025555556,25
3033.136843,42,71,0.91,29,0.03137931,25
3033.126529,55,89,0.93,34,0.027352941,25
3033.101804,40,72,0.93,32,0.0290625,25
3032.988014,44,70,0.84,26,0.032307692,25
3032.929879,40,75,0.95,35,0.027142857,25
3032.764728,41,76,0.95,35,0.027142857,25
3032.632618,41,53,0.47,12,0.039166667,25
3032.531397,63,75,0.26,12,0.021666667,25
3032.523875,55,89,0.9,34,0.026470588,25
3032.484025,37,64,0.93,27,0.034444444,25
3032.315989,57,92,0.86,35,0.024571429,25
3032.215665,44,47,0.11,3,0.036666667,25
3031.9758,46,77,0.81,31,0.026129032,25
3031.560424,35,57,0.8,22,0.036363636,25
3031.38998,58,89,0.8,31,0.025806452,25
3031.266417,58,91,0.84,33,0.025454545,25
3031.195151,56,86,0.69,30,0.023,25
3031.115302,53,87,0.97,34,0.028529412,25
3031.107008,43,78,0.91,35,0.026,25
3031.061869,46,67,0.68,21,0.032380952,25
3030.994937,49,60,0.36,11,0.032727273,25
3030.747312,40,71,0.91,31,0.029354839,25
3030.654242,60,84,0.69,24,0.02875,25
3030.568133,68,76,0.21,8,0.02625,25
3030.56461,54,87,0.89,33,0.026969697,25
3030.552551,56,86,0.8,30,0.026666667,25
3030.552551,55,86,0.84,31,0.027096774,25
3030.552551,54,88,0.91,34,0.026764706,25
3030.552551,54,89,0.93,35,0.026571429,25
3030.552551,53,89,0.97,36,0.026944444,25
3030.552551,53,90,0.98,37,0.026486486,25
3030.500274,38,53,0.58,15,0.038666667,25
3030.407687,56,91,0.89,35,0.025428571,25
3030.399443,43,79,0.93,36,0.025833333,25
3030.093631,48,57,0.26,9,0.028888889,25
3030.067258,49,73,0.62,24,0.025833333,25
3029.894811,48,71,0.61,23,0.026521739,25
3029.862927,59,78,0.52,19,0.027368421,25
3029.762048,67,76,0.26,9,0.028888889,25
3029.737732,66,79,0.34,13,0.026153846,25
3029.475556,42,71,0.93,29,0.032068966,25
3029.397644,59,77,0.5,18,0.027777778,25
3029.378323,56,77,0.65,21,0.030952381,25
3029.378323,55,78,0.71,23,0.030869565,25
3029.378323,54,79,0.78,25,0.0312,25
3029.378323,53,80,0.84,27,0.031111111,25
3029.378323,53,81,0.86,28,0.030714286,25
3029.223495,41,71,0.86,30,0.028666667,25
3028.990385,42,75,0.92,33,0.027878788,25
3028.894714,63,75,0.34,12,0.028333333,25
3028.704684,54,86,0.87,32,0.0271875,25
3028.704684,53,87,0.93,34,0.027352941,25
3028.700834,60,84,0.63,24,0.02625,25
3028.572198,55,90,0.9,35,0.025714286,25
3028.544979,62,81,0.4,19,0.021052632,25
3028.535496,35,62,0.93,27,0.034444444,25
3028.471916,63,79,0.42,16,0.02625,25
3028.471916,63,80,0.44,17,0.025882353,25
3028.471916,61,82,0.55,21,0.026190476,25
3028.471916,60,83,0.6,23,0.026086957,25
3028.471916,57,87,0.78,30,0.026,25
3028.296411,62,85,0.61,23,0.026521739,25
3028.296411,60,87,0.72,27,0.026666667,25
3028.296411,57,91,0.9,34,0.026470588,25
3028.126322,36,62,0.94,26,0.036153846,25
3028.110302,65,84,0.4,19,0.021052632,25
3027.933951,48,65,0.47,17,0.027647059,25
3027.753524,63,70,0.22,7,0.031428571,25
3027.619076,63,80,0.46,17,0.027058824,25
3027.526759,34,59,0.93,25,0.0372,25
3027.470813,58,90,0.8,32,0.025,25
3027.470813,56,93,0.92,37,0.024864865,25
3027.470813,55,94,0.97,39,0.024871795,25
3027.409669,39,55,0.56,16,0.035,25
3027.350335,56,89,0.84,33,0.025454545,25
3027.157917,56,94,0.83,38,0.021842105,25
3026.448155,54,97,0.95,43,0.022093023,25
3026.44351,57,87,0.8,30,0.026666667,25
3026.419472,59,74,0.46,15,0.030666667,25
3026.361783,55,94,0.99,39,0.025384615,25
3026.349997,45,82,0.89,37,0.024054054,25
3026.317032,56,95,0.83,39,0.021282051,25
3026.307115,53,87,0.96,34,0.028235294,25
3026.178365,57,96,0.93,39,0.023846154,25
3026.178365,56,97,0.98,41,0.023902439,25
3026.092422,63,83,0.51,20,0.0255,25
3025.974771,49,63,0.4,14,0.028571429,25
3025.92434,57,88,0.81,31,0.026129032,25
3025.92434,56,90,0.88,34,0.025882353,25
3025.630996,57,90,0.86,33,0.026060606,25
3025.61634,55,86,0.85,31,0.027419355,25
3025.589021,48,64,0.45,16,0.028125,25
3025.58245,54,87,0.9,33,0.027272727,25
3025.573853,46,83,0.88,37,0.023783784,25
3025.523168,60,92,0.64,32,0.02,25
3025.502358,40,70,0.95,30,0.031666667,25
3025.48659,44,76,0.85,32,0.0265625,25
3025.311418,58,92,0.72,34,0.021176471,25
3025.15784,58,61,0.08,3,0.026666667,25
3025.15784,55,64,0.24,9,0.026666667,25
3024.899296,46,66,0.62,20,0.031,25
3024.847812,48,64,0.46,16,0.02875,25
3024.842235,45,69,0.7,24,0.029166667,25
3024.842235,44,70,0.76,26,0.029230769,25
3024.728571,58,87,0.82,29,0.028275862,25
3024.638302,61,86,0.63,25,0.0252,25
3024.569207,37,62,0.88,25,0.0352,25
3024.475549,62,85,0.52,23,0.022608696,25
3024.425453,42,53,0.4,11,0.036363636,25
3024.386264,63,71,0.24,8,0.03,25
3024.34397,67,83,0.32,16,0.02,25
3024.34397,66,84,0.36,18,0.02,25
3024.34397,65,85,0.4,20,0.02,25
3024.324807,53,81,0.85,28,0.030357143,25
3024.290192,57,87,0.81,30,0.027,25
3023.88133,55,82,0.73,27,0.027037037,25
3023.759925,58,92,0.85,34,0.025,25
3023.759925,57,95,0.93,38,0.024473684,25
3023.728552,60,70,0.34,10,0.034,25
3023.694777,62,72,0.23,10,0.023,25
3023.560091,49,65,0.39,16,0.024375,25
3023.443082,47,71,0.66,24,0.0275,25
3023.437166,51,61,0.28,10,0.028,25
3023.384637,64,84,0.5,20,0.025,25
3023.384637,60,89,0.72,29,0.024827586,25
3023.363029,53,90,0.96,37,0.025945946,25
3023.241533,53,83,0.85,30,0.028333333,25
3023.223151,66,76,0.28,10,0.028,25
3023.223151,61,82,0.58,21,0.027619048,25
3023.158979,52,83,0.94,31,0.030322581,25
3023.119398,55,92,0.96,37,0.025945946,25
3023.106476,56,82,0.74,26,0.028461538,25
3023.106476,55,83,0.8,28,0.028571429,25
3023.106476,54,84,0.86,30,0.028666667,25
3023.106476,53,86,0.93,33,0.028181818,25
3023.106476,53,87,0.95,34,0.027941176,25
3023.106476,52,87,0.99,35,0.028285714,25
3022.903812,39,59,0.74,20,0.037,25
3022.887765,39,55,0.63,16,0.039375,25
3022.886847,40,54,0.55,14,0.039285714,25
3022.877459,47,67,0.54,20,0.027,25
3022.843938,56,78,0.62,22,0.028181818,25
3022.690554,63,84,0.46,21,0.021904762,25
3022.690554,60,88,0.61,28,0.021785714,25
3022.525452,57,80,0.62,23,0.026956522,25
3022.506508,41,72,0.97,31,0.031290323,25
3022.407812,55,95,0.88,40,0.022,25
3022.391508,64,80,0.46,16,0.02875,25
3022.369758,48,77,0.72,29,0.024827586,25
3022.287609,59,88,0.75,29,0.025862069,25
3022.226472,46,68,0.66,22,0.03,25
3022.079374,54,79,0.77,25,0.0308,25
3022.016386,62,86,0.48,24,0.02,25
3022.016386,61,87,0.52,26,0.02,25
3022.013687,38,53,0.55,15,0.036666667,25
3021.919132,56,89,0.87,33,0.026363636,25
3021.798181,48,66,0.51,18,0.028333333,25
3021.710868,40,73,0.95,33,0.028787879,25
3021.645152,54,86,0.9,32,0.028125,25
3021.624157,54,90,0.98,36,0.027222222,25
3021.521177,70,79,0.19,9,0.021111111,25
3021.499032,59,96,0.69,37,0.018648649,25
3021.499032,58,97,0.73,39,0.018717949,25
3021.495749,40,51,0.41,11,0.037272727,25
3021.164093,63,84,0.55,21,0.026190476,25
3020.926182,38,65,0.9,27,0.033333333,25
3020.926182,37,66,0.97,29,0.033448276,25
3020.875779,44,69,0.72,25,0.0288,25
3020.849354,45,67,0.64,22,0.029090909,25
3020.81941,50,77,0.94,27,0.034814815,25
3020.757814,58,76,0.54,18,0.03,25
3020.695708,37,60,0.79,23,0.034347826,25
3020.629385,34,60,0.94,26,0.036153846,25
3020.122136,66,81,0.39,15,0.026,25
3020.107395,62,77,0.32,15,0.021333333,25
3020.029275,55,64,0.23,9,0.025555556,25
3020.028547,65,78,0.36,13,0.027692308,25
3019.982917,41,56,0.56,15,0.037333333,25
3019.621982,59,86,0.77,27,0.028518519,25
3019.621982,58,87,0.83,29,0.02862069,25
3019.614762,59,83,0.7,24,0.029166667,25
3019.405841,66,77,0.29,11,0.026363636,25
3019.325991,56,82,0.76,26,0.029230769,25
3019.325991,55,83,0.82,28,0.029285714,25
3019.310348,45,78,0.83,33,0.025151515,25
3019.271319,48,79,0.76,31,0.024516129,25
3019.267054,58,90,0.72,32,0.0225,25
3019.267054,56,93,0.83,37,0.022432432,25
3019.152995,44,71,0.81,27,0.03,25
3019.093799,54,81,0.8,27,0.02962963,25
3018.979431,47,65,0.52,18,0.028888889,25
3018.945716,67,79,0.31,12,0.025833333,25
3018.927069,60,81,0.56,21,0.026666667,25
3018.926768,61,79,0.38,18,0.021111111,25
3018.820463,63,72,0.25,9,0.027777778,25
3018.819926,43,72,0.87,29,0.03,25
3018.767141,57,75,0.56,18,0.031111111,25
3018.708107,62,86,0.52,24,0.021666667,25
3018.640252,47,62,0.48,15,0.032,25
3018.586059,51,83,0.99,32,0.0309375,25
3018.518812,55,77,0.69,22,0.031363636,25
3018.469302,47,67,0.57,20,0.0285,25
3018.404446,65,74,0.19,9,0.021111111,25
3018.3866,53,76,0.49,23,0.021304348,25
3017.998488,34,55,0.84,21,0.04,25
3017.950055,71,77,0.13,6,0.021666667,25
3017.893703,34,62,0.98,28,0.035,25
3017.754216,57,78,0.58,21,0.027619048,25
3017.69946,35,58,0.84,23,0.036521739,25
3017.640926,47,68,0.5,21,0.023809524,25
3017.588741,42,56,0.52,14,0.037142857,25
3017.527025,54,75,0.49,21,0.023333333,25
3017.524644,58,83,0.66,25,0.0264,25
3017.524644,54,88,0.9,34,0.026470588,25
3017.488993,48,63,0.47,15,0.031333333,25
3017.434227,61,81,0.56,20,0.028,25
3017.368108,63,80,0.45,17,0.026470588,25
3017.31787,57,82,0.72,25,0.0288,25
3017.230401,53,97,0.99,44,0.0225,25
3016.954534,56,96,0.96,40,0.024,25
3016.618177,49,76,0.96,27,0.035555556,25
3016.508384,73,75,0.05,2,0.025,25
3016.508384,72,76,0.1,4,0.025,25
3016.508384,71,77,0.15,6,0.025,25
3016.438189,42,58,0.52,16,0.0325,25
3016.366594,36,99,0.15,63,0.002380952,25
3016.303103,50,63,0.39,13,0.03,25
3016.131216,58,91,0.69,33,0.020909091,25
3016.075057,46,61,0.43,15,0.028666667,25
3015.95267,59,95,0.68,36,0.018888889,25
3015.90852,46,84,0.89,38,0.023421053,25
3015.90852,45,85,0.94,40,0.0235,25
3015.854572,61,76,0.41,15,0.027333333,25
3015.808384,57,83,0.7,26,0.026923077,25
3015.588333,49,63,0.46,14,0.032857143,25
3015.49357,44,69,0.77,25,0.0308,25
3015.201301,58,78,0.56,20,0.028,25
3015.120542,57,78,0.61,21,0.029047619,25
3015.112661,41,71,0.97,30,0.032333333,25
3015.049293,41,72,0.91,31,0.029354839,25
3014.935588,53,89,0.96,36,0.026666667,25
3014.87346,39,57,0.6,18,0.033333333,25
3014.734836,58,84,0.7,26,0.026923077,25
3014.729914,58,92,0.73,34,0.021470588,25
3014.710103,60,94,0.65,34,0.019117647,25
3014.710103,59,95,0.69,36,0.019166667,25
3014.710103,58,96,0.73,38,0.019210526,25
3014.626927,57,74,0.53,17,0.031176471,25
3014.336077,59,92,0.8,33,0.024242424,25
3014.336077,58,93,0.85,35,0.024285714,25
3014.29336,60,85,0.71,25,0.0284,25
3014.221608,37,55,0.66,18,0.036666667,25
3014.068095,57,93,0.79,36,0.021944444,25
3014.062962,63,81,0.51,18,0.028333333,25
3013.953105,52,69,0.43,17,0.025294118,25
3013.953105,51,70,0.48,19,0.025263158,25
3013.889519,36,66,0.98,30,0.032666667,25
3013.7928,53,89,0.98,36,0.027222222,25
3013.689174,49,74,0.64,25,0.0256,25
3013.689174,48,75,0.69,27,0.025555556,25
3013.630216,64,73,0.2,9,0.022222222,25
3013.607936,40,59,0.69,19,0.036315789,25
3013.60545,62,74,0.34,12,0.028333333,25
3013.596263,47,68,0.53,21,0.025238095,25
3013.596263,46,69,0.58,23,0.025217391,25
3013.482833,53,80,0.83,27,0.030740741,25
3013.482833,52,81,0.89,29,0.030689655,25
3013.425299,53,85,0.92,32,0.02875,25
3013.425299,52,86,0.98,34,0.028823529,25
3013.330272,57,92,0.78,35,0.022285714,25
3013.330272,55,95,0.89,40,0.02225,25
3013.063993,45,76,0.82,31,0.026451613,25
3013.033786,55,89,0.89,34,0.026176471,25
3012.995338,42,72,0.85,30,0.028333333,25
3012.965253,39,49,0.39,10,0.039,25
3012.924627,43,70,0.78,27,0.028888889,25
3012.847992,36,57,0.79,21,0.037619048,25
3012.778543,39,73,0.99,34,0.029117647,25
3012.68196,43,78,0.92,35,0.026285714,25
3012.597583,56,69,0.46,13,0.035384615,25
3012.513329,67,73,0.14,6,0.023333333,25
3012.444422,56,80,0.69,24,0.02875,25
3012.444422,55,81,0.75,26,0.028846154,25
3012.396264,52,88,0.95,36,0.026388889,25
3012.148474,45,66,0.61,21,0.029047619,25
3012.028822,68,77,0.25,9,0.027777778,25
3012.028822,65,80,0.42,15,0.028,25
3011.945472,41,73,0.91,32,0.0284375,25
3011.873611,57,62,0.13,5,0.026,25
3011.781546,65,81,0.36,16,0.0225,25
3011.746691,58,85,0.71,27,0.026296296,25
3011.629362,63,76,0.36,13,0.027692308,25
3011.629362,60,81,0.57,21,0.027142857,25
3011.629362,58,83,0.68,25,0.0272,25
3011.629362,56,86,0.81,30,0.027,25
3011.618765,64,84,0.44,20,0.022,25
3011.50628,45,78,0.84,33,0.025454545,25
3011.374126,44,51,0.24,7,0.034285714,25
3011.265282,60,80,0.42,20,0.021,25
3011.187076,63,87,0.46,24,0.019166667,25
3011.168845,62,81,0.51,19,0.026842105,25
3011.086926,63,79,0.45,16,0.028125,25
3010.969666,56,90,0.96,34,0.028235294,25
3010.950736,39,51,0.47,12,0.039166667,25
3010.864083,57,67,0.36,10,0.036,25
3010.864083,52,73,0.75,21,0.035714286,25
3010.835112,86,95,0.05,9,0.005555556,25
3010.716751,48,63,0.44,15,0.029333333,25
3010.495971,61,80,0.44,19,0.023157895,25
3010.470665,58,79,0.58,21,0.027619048,25
3010.435067,54,91,0.78,37,0.021081081,25
3010.435067,54,92,0.79,38,0.020789474,25
3010.428336,36,61,0.93,25,0.0372,25
3010.227843,39,74,0.99,35,0.028285714,25
3010.100215,46,68,0.63,22,0.028636364,25
3010.100215,45,69,0.69,24,0.02875,25
3009.867917,45,83,0.91,38,0.023947368,25
3009.86201,46,82,0.86,36,0.023888889,25
3009.437936,37,97,0.13,60,0.002166667,25
3009.341851,36,56,0.73,20,0.0365,25
3009.212522,53,67,0.36,14,0.025714286,25
3009.179296,58,84,0.58,26,0.022307692,25
3008.901512,56,73,0.36,17,0.021176471,25
3008.789216,58,78,0.57,20,0.0285,25
3008.671585,60,73,0.4,13,0.030769231,25
3008.661791,66,77,0.3,11,0.027272727,25
3008.661791,62,82,0.54,20,0.027,25
3008.621985,42,71,0.81,29,0.027931034,25
3008.59607,54,85,0.82,31,0.026451613,25
3008.26456,66,68,0.06,2,0.03,25
3008.26456,65,69,0.12,4,0.03,25
3008.26456,64,70,0.18,6,0.03,25
3008.167968,36,66,0.97,30,0.032333333,25
3008.137715,43,71,0.91,28,0.0325,25
3008.120213,41,50,0.33,9,0.036666667,25
3008.03292,53,86,0.88,33,0.026666667,25
3008.03292,52,87,0.94,35,0.026857143,25
3007.98657,63,82,0.5,19,0.026315789,25
3007.975863,62,82,0.57,20,0.0285,25
3007.963727,65,79,0.4,14,0.028571429,25
3007.930189,61,87,0.58,26,0.022307692,25
3007.89942,45,68,0.71,23,0.030869565,25
3007.570883,53,85,0.86,32,0.026875,25
3007.561129,43,72,0.78,29,0.026896552,25
3007.529047,52,84,0.97,32,0.0303125,25
3007.444969,44,86,0.99,42,0.023571429,25
3007.414151,61,88,0.54,27,0.02,25
3007.414151,60,89,0.58,29,0.02,25
3007.414151,59,90,0.62,31,0.02,25
3007.343973,67,83,0.33,16,0.020625,25
3007.343973,64,87,0.47,23,0.020434783,25
3007.30798,69,80,0.23,11,0.020909091,25
3007.30798,63,87,0.5,24,0.020833333,25
3007.177022,34,59,0.91,25,0.0364,25
3006.933333,56,88,0.84,32,0.02625,25
3006.904588,59,93,0.66,34,0.019411765,25
3006.859502,52,78,0.55,26,0.021153846,25
3006.802125,65,80,0.41,15,0.027333333,25
3006.71542,41,51,0.36,10,0.036,25
3006.639833,66,79,0.36,13,0.027692308,25
3006.344457,56,91,0.92,35,0.026285714,25
3006.342303,43,72,0.74,29,0.025517241,25
3006.317021,48,74,0.68,26,0.026153846,25
3006.196682,49,65,0.44,16,0.0275,25
3006.149277,54,87,0.88,33,0.026666667,25
3006.006887,44,77,0.88,33,0.026666667,25
3005.880065,54,86,0.91,32,0.0284375,25
3005.848841,48,67,0.45,19,0.023684211,25
3005.53392,38,59,0.7,21,0.033333333,25
3005.489358,54,85,0.84,31,0.027096774,25
3005.489358,53,86,0.9,33,0.027272727,25
3005.485687,67,80,0.29,13,0.022307692,25
3005.485687,65,82,0.38,17,0.022352941,25
3005.348987,58,84,0.69,26,0.026538462,25
3005.34817,57,94,0.9,37,0.024324324,25
3005.136555,55,92,0.95,37,0.025675676,25
3005.126714,55,85,0.83,30,0.027666667,25
3005.108454,38,52,0.55,14,0.039285714,25
3005.076156,49,78,0.71,29,0.024482759,25
3004.864292,64,83,0.49,19,0.025789474,25
3004.787125,33,60,0.99,27,0.036666667,25
3004.742595,61,78,0.49,17,0.028823529,25
3004.742595,60,80,0.57,20,0.0285,25
3004.646788,69,75,0.17,6,0.028333333,25
3004.646788,66,78,0.34,12,0.028333333,25
3004.646788,61,84,0.65,23,0.02826087,25
3004.610585,61,73,0.36,12,0.03,25
3004.609156,41,73,0.93,32,0.0290625,25
3004.447309,61,86,0.67,25,0.0268,25
3004.430133,42,75,0.93,33,0.028181818,25
3004.413523,66,84,0.37,18,0.020555556,25
3004.413523,63,88,0.51,25,0.0204,25
3004.355315,35,56,0.83,21,0.03952381,25
3004.336325,47,80,0.8,33,0.024242424,25
3004.336325,46,81,0.85,35,0.024285714,25
3004.274964,52,87,0.93,35,0.026571429,25
3004.268922,66,80,0.37,14,0.026428571,25
3004.262618,41,72,0.99,31,0.031935484,25
3004.061894,57,77,0.6,20,0.03,25
3004.001215,39,53,0.51,14,0.036428571,25
3003.993337,55,93,0.98,38,0.025789474,25
3003.935192,49,76,0.66,27,0.024444444,25
3003.89246,60,89,0.63,29,0.021724138,25
3003.600447,66,67,0.03,1,0.03,25
3003.600447,65,68,0.09,3,0.03,25
3003.600447,64,69,0.15,5,0.03,25
3003.600447,63,70,0.21,7,0.03,25
3003.535472,55,86,0.86,31,0.027741935,25
3003.535472,54,87,0.92,33,0.027878788,25
3003.528119,61,93,0.61,32,0.0190625,25
3003.393412,61,74,0.36,13,0.027692308,25
3003.35472,44,85,0.98,41,0.023902439,25
3003.232605,69,77,0.21,8,0.02625,25
3003.232605,62,85,0.6,23,0.026086957,25
3003.167817,40,71,0.93,31,0.03,25
3002.979526,61,75,0.38,14,0.027142857,25
3002.979526,59,77,0.49,18,0.027222222,25
3002.979526,57,79,0.6,22,0.027272727,25
3002.817978,49,66,0.4,17,0.023529412,25
3002.809507,43,68,0.74,25,0.0296,25
3002.701616,41,71,0.89,30,0.029666667,25
3002.640004,55,88,0.96,33,0.029090909,25
3002.55665,78,95,0.12,17,0.007058824,25
3002.514752,53,85,0.94,32,0.029375,25
3002.514752,53,86,0.96,33,0.029090909,25
3002.45333,63,80,0.47,17,0.027647059,25
3002.413067,54,88,0.88,34,0.025882353,25
3002.302577,56,87,0.83,31,0.026774194,25
3002.158368,55,89,0.94,34,0.027647059,25
3002.157256,60,79,0.53,19,0.027894737,25
3001.923579,45,84,0.93,39,0.023846154,25
3001.82734,60,92,0.61,32,0.0190625,25
3001.771725,56,90,0.71,34,0.020882353,25
3001.520832,41,73,0.99,32,0.0309375,25
3001.441316,42,74,0.96,32,0.03,25
3001.156249,56,95,0.8,39,0.020512821,25
3001.122756,59,84,0.69,25,0.0276,25
3001.103453,45,66,0.66,21,0.031428571,25
3000.856127,69,76,0.18,7,0.025714286,25
3000.856127,64,82,0.46,18,0.025555556,25
3000.853494,46,75,0.77,29,0.026551724,25
3000.821952,39,71,0.97,32,0.0303125,25
3000.79321,64,77,0.37,13,0.028461538,25
3000.79321,61,80,0.54,19,0.028421053,25
3000.700665,60,89,0.62,29,0.02137931,25
3000.496452,46,68,0.55,22,0.025,25
3000.45272,61,88,0.59,27,0.021851852,25
3000.45272,59,90,0.68,31,0.021935484,25
3000.45272,57,93,0.78,36,0.021666667,25
3000.45272,55,96,0.89,41,0.021707317,25
3000.347812,62,85,0.59,23,0.025652174,25
3000.042758,52,61,0.25,9,0.027777778,25
3000.042462,37,56,0.68,19,0.035789474,25
