% profit,ema1,ema2,threshold,diff,thresh / diff,ID
3569.177641,67,69,0.06,2,0.03,51
3569.177641,66,70,0.12,4,0.03,51
3569.177641,65,71,0.18,6,0.03,51
3569.177641,64,72,0.24,8,0.03,51
3569.177641,63,73,0.3,10,0.03,51
3569.177641,62,74,0.36,12,0.03,51
3516.374535,61,75,0.42,14,0.03,51
3516.374535,60,76,0.48,16,0.03,51
3509.454015,59,78,0.57,19,0.03,51
3509.454015,58,79,0.63,21,0.03,51
3491.471903,51,74,0.8,23,0.034782609,51
3465.697373,67,68,0.03,1,0.03,51
3465.697373,66,69,0.09,3,0.03,51
3465.697373,65,70,0.15,5,0.03,51
3465.697373,64,71,0.21,7,0.03,51
3455.408118,55,69,0.49,14,0.035,51
3417.72732,63,74,0.33,11,0.03,51
3413.949582,60,77,0.51,17,0.03,51
3388.212505,62,75,0.39,13,0.03,51
3382.365006,61,76,0.45,15,0.03,51
3346.565861,60,69,0.29,9,0.032222222,51
3320.572797,62,65,0.1,3,0.033333333,51
3291.201014,57,71,0.46,14,0.032857143,51
3252.740776,57,72,0.49,15,0.032666667,51
3252.740776,55,74,0.62,19,0.032631579,51
3244.553075,59,70,0.36,11,0.032727273,51
3240.454068,59,69,0.33,10,0.033,51
3237.728361,57,70,0.44,13,0.033846154,51
3236.769963,62,71,0.28,9,0.031111111,51
3235.197616,61,66,0.17,5,0.034,51
3233.357557,60,68,0.27,8,0.03375,51
3226.806467,54,75,0.69,21,0.032857143,51
3226.806467,53,76,0.76,23,0.033043478,51
3225.243543,59,68,0.3,9,0.033333333,51
3222.72921,56,72,0.53,16,0.033125,51
3218.415327,56,73,0.56,17,0.032941176,51
3215.850845,56,72,0.54,16,0.03375,51
3215.529157,61,67,0.2,6,0.033333333,51
3215.529157,58,70,0.4,12,0.033333333,51
3215.529157,55,73,0.6,18,0.033333333,51
3215.529157,54,74,0.67,20,0.0335,51
3215.529157,53,75,0.74,22,0.033636364,51
3213.971531,58,69,0.37,11,0.033636364,51
3209.728822,61,63,0.07,2,0.035,51
3208.890827,57,68,0.38,11,0.034545455,51
3207.424485,57,71,0.47,14,0.033571429,51
3207.166461,55,74,0.63,19,0.033157895,51
3207.166461,52,77,0.83,25,0.0332,51
3206.965914,58,75,0.53,17,0.031176471,51
3199.082232,58,71,0.43,13,0.033076923,51
3197.944275,52,77,0.84,25,0.0336,51
3187.975421,54,75,0.7,21,0.033333333,51
3187.975421,52,78,0.86,26,0.033076923,51
3183.382977,60,74,0.43,14,0.030714286,51
3183.270691,50,75,0.87,25,0.0348,51
3182.084575,62,70,0.25,8,0.03125,51
3180.360763,53,76,0.77,23,0.033478261,51
3179.215759,56,71,0.51,15,0.034,51
3178.488655,51,79,0.93,28,0.033214286,51
3175.940028,52,71,0.67,19,0.035263158,51
3174.618355,60,65,0.17,5,0.034,51
3165.421977,69,80,0.21,11,0.019090909,51
3163.736122,57,74,0.54,17,0.031764706,51
3162.71627,56,74,0.58,18,0.032222222,51
3162.704271,53,70,0.6,17,0.035294118,51
3160.600198,63,69,0.19,6,0.031666667,51
3160.283884,55,72,0.58,17,0.034117647,51
3159.904541,58,77,0.58,19,0.030526316,51
3159.736162,60,70,0.32,10,0.032,51
3158.926635,55,71,0.55,16,0.034375,51
3156.233031,59,73,0.44,14,0.031428571,51
3155.995045,61,73,0.37,12,0.030833333,51
3154.93257,57,69,0.41,12,0.034166667,51
3154.93257,56,70,0.48,14,0.034285714,51
3153.801034,54,70,0.56,16,0.035,51
3150.965289,72,82,0.18,10,0.018,51
3144.566171,61,72,0.34,11,0.030909091,51
3144.198103,51,78,0.9,27,0.033333333,51
3144.198103,50,79,0.97,29,0.033448276,51
3137.123592,55,73,0.61,18,0.033888889,51
3137.123592,55,74,0.64,19,0.033684211,51
3137.123592,54,74,0.68,20,0.034,51
3137.106837,75,80,0.09,5,0.018,51
3135.730689,58,68,0.34,10,0.034,51
3135.009196,60,64,0.14,4,0.035,51
3135.009196,59,65,0.21,6,0.035,51
3135.009196,58,66,0.28,8,0.035,51
3134.562835,55,75,0.65,20,0.0325,51
3134.400549,60,71,0.35,11,0.031818182,51
3134.400549,58,72,0.45,14,0.032142857,51
3133.757209,63,68,0.16,5,0.032,51
3131.480551,53,71,0.63,18,0.035,51
3128.005232,52,72,0.7,20,0.035,51
3128.005232,51,73,0.77,22,0.035,51
3127.645893,52,76,0.81,24,0.03375,51
3125.744444,51,78,0.91,27,0.033703704,51
3125.744444,50,79,0.98,29,0.033793103,51
3123.90962,51,79,0.94,28,0.033571429,51
3122.709211,54,76,0.72,22,0.032727273,51
3122.533938,52,79,0.88,27,0.032592593,51
3121.160703,55,70,0.52,15,0.034666667,51
3118.46052,53,77,0.79,24,0.032916667,51
3118.35174,71,83,0.22,12,0.018333333,51
3117.696482,56,69,0.45,13,0.034615385,51
3117.539535,54,72,0.62,18,0.034444444,51
3117.539535,53,73,0.69,20,0.0345,51
3114.375713,57,72,0.5,15,0.033333333,51
3113.777245,51,80,0.95,29,0.032758621,51
3111.830498,62,69,0.22,7,0.031428571,51
3111.547091,74,80,0.11,6,0.018333333,51
3110.618015,60,72,0.38,12,0.031666667,51
3108.631007,60,69,0.3,9,0.033333333,51
3108.477055,57,67,0.35,10,0.035,51
3108.477055,56,68,0.42,12,0.035,51
3107.60441,72,83,0.2,11,0.018181818,51
3107.60441,69,86,0.31,17,0.018235294,51
3100.640758,54,71,0.59,17,0.034705882,51
3100.640758,53,72,0.66,19,0.034736842,51
3100.640758,52,73,0.73,21,0.034761905,51
3098.868325,70,85,0.27,15,0.018,51
3098.868325,67,88,0.38,21,0.018095238,51
3098.292401,68,87,0.34,19,0.017894737,51
3096.927579,61,68,0.23,7,0.032857143,51
3092.123585,46,62,0.42,16,0.02625,51
3090.681713,45,48,0.11,3,0.036666667,51
3090.396952,51,77,0.88,26,0.033846154,51
3088.24025,54,73,0.65,19,0.034210526,51
3088.24025,53,74,0.72,21,0.034285714,51
3086.183824,46,63,0.44,17,0.025882353,51
3085.958097,59,76,0.52,17,0.030588235,51
3085.694663,69,85,0.29,16,0.018125,51
3084.707927,54,75,0.71,21,0.033809524,51
3084.674097,56,77,0.66,21,0.031428571,51
3082.830453,58,74,0.51,16,0.031875,51
3080.868923,54,79,0.79,25,0.0316,51
3075.885529,58,67,0.31,9,0.034444444,51
3071.087197,59,67,0.27,8,0.03375,51
3070.833237,56,71,0.5,15,0.033333333,51
3070.833237,55,72,0.57,17,0.033529412,51
3070.814463,57,77,0.62,20,0.031,51
3068.727668,53,80,0.86,27,0.031851852,51
3066.562493,51,76,0.85,25,0.034,51
3061.28169,59,74,0.47,15,0.031333333,51
3060.08465,54,73,0.64,19,0.033684211,51
3060.08465,53,74,0.71,21,0.033809524,51
3060.08465,52,75,0.78,23,0.033913043,51
3058.416753,64,71,0.22,7,0.031428571,51
3057.149972,59,66,0.24,7,0.034285714,51
3057.149972,54,72,0.61,18,0.033888889,51
3057.115309,52,81,0.93,29,0.032068966,51
3056.692154,56,73,0.57,17,0.033529412,51
3055.336562,42,43,0.04,1,0.04,51
3055.336562,41,44,0.12,3,0.04,51
3055.336562,40,45,0.2,5,0.04,51
3055.049942,71,85,0.25,14,0.017857143,51
3052.290166,57,79,0.67,22,0.030454545,51
3050.083401,58,76,0.56,18,0.031111111,51
3049.61133,70,85,0.28,15,0.018666667,51
3049.215199,60,73,0.41,13,0.031538462,51
3048.283175,55,79,0.75,24,0.03125,51
3048.283175,53,81,0.88,28,0.031428571,51
3047.859373,60,75,0.46,15,0.030666667,51
3047.083572,66,89,0.42,23,0.01826087,51
3047.023677,57,75,0.57,18,0.031666667,51
3046.413223,57,75,0.58,18,0.032222222,51
3046.413223,55,77,0.71,22,0.032272727,51
3045.687668,61,70,0.29,9,0.032222222,51
3045.687668,56,76,0.64,20,0.032,51
3042.990684,55,71,0.54,16,0.03375,51
3042.693792,58,73,0.48,15,0.032,51
3042.693792,56,75,0.61,19,0.032105263,51
3042.655356,39,46,0.28,7,0.04,51
3039.331082,63,67,0.13,4,0.0325,51
3039.331082,61,69,0.26,8,0.0325,51
3039.331082,59,71,0.39,12,0.0325,51
3038.301652,54,78,0.77,24,0.032083333,51
3036.476516,51,56,0.13,5,0.026,51
3036.266299,54,80,0.82,26,0.031538462,51
3036.266299,52,82,0.95,30,0.031666667,51
3035.587241,73,81,0.15,8,0.01875,51
3033.92533,54,79,0.8,25,0.032,51
3033.461953,59,73,0.45,14,0.032142857,51
3033.221321,54,77,0.74,23,0.032173913,51
3033.159649,62,72,0.32,10,0.032,51
3033.050916,55,77,0.7,22,0.031818182,51
3032.505078,57,76,0.6,19,0.031578947,51
3032.505078,55,78,0.73,23,0.03173913,51
3032.131397,54,81,0.84,27,0.031111111,51
3028.136931,63,66,0.1,3,0.033333333,51
3027.361465,66,81,0.3,15,0.02,51
3027.361465,65,82,0.34,17,0.02,51
3025.509167,53,77,0.8,24,0.033333333,51
3025.509167,52,78,0.87,26,0.033461538,51
3025.509167,51,80,0.96,29,0.033103448,51
3024.7729,53,81,0.89,28,0.031785714,51
3021.8707,60,76,0.49,16,0.030625,51
3021.739081,57,73,0.52,16,0.0325,51
3021.5693,55,76,0.68,21,0.032380952,51
3021.556218,68,86,0.33,18,0.018333333,51
3021.408724,56,78,0.69,22,0.031363636,51
3021.025462,61,71,0.32,10,0.032,51
3021.025462,58,75,0.54,17,0.031764706,51
3021.025462,56,77,0.67,21,0.031904762,51
3020.231977,62,72,0.31,10,0.031,51
3020.231977,56,79,0.71,23,0.030869565,51
3019.039639,61,74,0.4,13,0.030769231,51
3018.371334,50,78,0.95,28,0.033928571,51
3016.120129,63,70,0.22,7,0.031428571,51
3014.302111,58,78,0.61,20,0.0305,51
3013.804996,52,80,0.91,28,0.0325,51
3013.086961,59,72,0.42,13,0.032307692,51
3013.086961,57,74,0.55,17,0.032352941,51
3013.086961,53,79,0.84,26,0.032307692,51
3013.086961,51,81,0.97,30,0.032333333,51
3009.70122,69,87,0.32,18,0.017777778,51
3008.322172,59,75,0.5,16,0.03125,51
3007.892057,54,78,0.78,24,0.0325,51
3006.944732,40,49,0.34,9,0.037777778,51
3004.076831,53,78,0.81,25,0.0324,51
3002.534124,58,72,0.46,14,0.032857143,51
3002.534124,56,75,0.62,19,0.032631579,51
3002.534124,54,77,0.75,23,0.032608696,51
3002.534124,53,78,0.82,25,0.0328,51
3001.08394,59,77,0.55,18,0.030555556,51
2999.21586,57,78,0.65,21,0.030952381,51
2996.642587,58,73,0.49,15,0.032666667,51
2996.120315,55,75,0.66,20,0.033,51
2995.207828,68,81,0.25,13,0.019230769,51
2995.072674,50,59,0.23,9,0.025555556,51
2994.679416,61,75,0.43,14,0.030714286,51
2994.577097,49,59,0.26,10,0.026,51
2993.888771,67,87,0.38,20,0.019,51
2993.103291,56,74,0.59,18,0.032777778,51
2991.284918,68,88,0.36,20,0.018,51
2990.866279,43,67,0.62,24,0.025833333,51
2988.767896,53,80,0.87,27,0.032222222,51
2987.912656,60,70,0.33,10,0.033,51
2987.826259,66,83,0.33,17,0.019411765,51
2986.581832,45,65,0.51,20,0.0255,51
2983.850871,67,82,0.29,15,0.019333333,51
2983.728132,60,74,0.45,14,0.032142857,51
2983.728132,58,76,0.58,18,0.032222222,51
2983.72042,59,69,0.34,10,0.034,51
2982.736204,57,73,0.53,16,0.033125,51
2982.33502,53,82,0.91,29,0.03137931,51
2981.486372,59,74,0.49,15,0.032666667,51
2980.942913,62,69,0.23,7,0.032857143,51
2980.420869,64,83,0.38,19,0.02,51
2979.704736,69,79,0.2,10,0.02,51
2979.282689,62,73,0.34,11,0.030909091,51
2978.765211,68,86,0.34,18,0.018888889,51
2978.765211,65,90,0.47,25,0.0188,51
2977.607517,65,85,0.39,20,0.0195,51
2977.607517,64,86,0.43,22,0.019545455,51
2977.607517,63,87,0.47,24,0.019583333,51
2976.644279,48,60,0.31,12,0.025833333,51
2975.960019,68,79,0.22,11,0.02,51
2974.946866,70,84,0.26,14,0.018571429,51
2971.796737,44,67,0.58,23,0.025217391,51
2970.870636,46,64,0.46,18,0.025555556,51
2970.261454,45,63,0.47,18,0.026111111,51
2970.137666,53,73,0.68,20,0.034,51
2970.137666,52,74,0.75,22,0.034090909,51
2970.064501,57,66,0.33,9,0.036666667,51
2969.905541,69,85,0.3,16,0.01875,51
2969.905541,66,89,0.43,23,0.018695652,51
2969.905541,63,93,0.56,30,0.018666667,51
2968.393699,44,68,0.6,24,0.025,51
2967.804805,71,84,0.24,13,0.018461538,51
2967.804805,67,88,0.39,21,0.018571429,51
2967.804805,65,91,0.48,26,0.018461538,51
2967.804805,64,92,0.52,28,0.018571429,51
2967.304558,45,64,0.49,19,0.025789474,51
2966.977085,49,76,0.97,27,0.035925926,51
2965.471073,67,87,0.37,20,0.0185,51
2964.947869,66,90,0.44,24,0.018333333,51
2964.803233,71,79,0.15,8,0.01875,51
2964.550164,55,76,0.69,21,0.032857143,51
2964.532678,47,63,0.41,16,0.025625,51
2963.709423,72,85,0.23,13,0.017692308,51
2962.943638,58,77,0.59,19,0.031052632,51
2959.231752,71,86,0.27,15,0.018,51
2958.22806,41,47,0.23,6,0.038333333,51
2957.953209,47,61,0.36,14,0.025714286,51
2957.719249,36,49,0.53,13,0.040769231,51
2956.853,57,75,0.6,18,0.033333333,51
2955.926338,49,58,0.24,9,0.026666667,51
2955.709868,63,71,0.25,8,0.03125,51
2955.486548,56,80,0.74,24,0.030833333,51
2955.304867,8,39,0.64,31,0.020645161,51
2955.287033,56,76,0.65,20,0.0325,51
2954.582417,55,80,0.78,25,0.0312,51
2954.424322,39,51,0.43,12,0.035833333,51
2954.035768,50,77,0.92,27,0.034074074,51
2952.204398,55,79,0.76,24,0.031666667,51
2951.132327,54,76,0.73,22,0.033181818,51
2951.052597,51,54,0.08,3,0.026666667,51
2950.457632,51,81,0.98,30,0.032666667,51
2948.835538,73,75,0.04,2,0.02,51
2948.835538,72,76,0.08,4,0.02,51
2948.835538,71,77,0.12,6,0.02,51
2948.211261,57,74,0.56,17,0.032941176,51
2947.023819,62,87,0.5,25,0.02,51
2945.422418,51,75,0.83,24,0.034583333,51
2945.422418,50,76,0.9,26,0.034615385,51
2945.422418,49,77,0.97,28,0.034642857,51
2944.227975,60,71,0.36,11,0.032727273,51
2944.072897,59,70,0.37,11,0.033636364,51
2943.749527,65,84,0.37,19,0.019473684,51
2943.366288,56,74,0.6,18,0.033333333,51
2943.274962,63,72,0.28,9,0.031111111,51
2942.550534,55,81,0.8,26,0.030769231,51
2942.193983,68,80,0.24,12,0.02,51
2942.193983,67,81,0.28,14,0.02,51
2942.193983,66,82,0.32,16,0.02,51
2942.193983,65,83,0.36,18,0.02,51
2941.381558,65,90,0.46,25,0.0184,51
2939.416054,52,79,0.89,27,0.032962963,51
2939.396494,73,74,0.02,1,0.02,51
2939.396494,72,75,0.06,3,0.02,51
2939.396494,71,76,0.1,5,0.02,51
2939.396494,70,77,0.14,7,0.02,51
2939.396494,69,78,0.18,9,0.02,51
2939.340009,53,83,0.93,30,0.031,51
2938.470396,39,50,0.42,11,0.038181818,51
2938.285021,62,70,0.26,8,0.0325,51
2938.285021,60,72,0.39,12,0.0325,51
2936.759014,66,78,0.25,12,0.020833333,51
2936.707899,71,82,0.21,11,0.019090909,51
2935.266301,66,93,0.48,27,0.017777778,51
2933.803697,46,65,0.48,19,0.025263158,51
2933.593624,45,66,0.53,21,0.025238095,51
2933.448295,68,87,0.35,19,0.018421053,51
2930.986002,56,77,0.69,21,0.032857143,51
2929.901779,67,90,0.41,23,0.017826087,51
2929.080833,59,72,0.43,13,0.033076923,51
2929.080833,56,75,0.63,19,0.033157895,51
2929.030072,54,78,0.79,24,0.032916667,51
2928.35713,60,74,0.44,14,0.031428571,51
2928.350326,52,74,0.76,22,0.034545455,51
2927.953041,36,53,0.65,17,0.038235294,51
2926.598998,55,78,0.75,23,0.032608696,51
2926.593762,52,83,0.98,31,0.031612903,51
2926.548863,66,84,0.35,18,0.019444444,51
2925.995276,54,80,0.83,26,0.031923077,51
2925.373106,72,81,0.17,9,0.018888889,51
2925.279919,40,48,0.31,8,0.03875,51
2925.149142,53,79,0.85,26,0.032692308,51
2925.098446,52,81,0.94,29,0.032413793,51
2924.728563,60,72,0.4,12,0.033333333,51
2923.987783,57,76,0.61,19,0.032105263,51
2923.987783,55,78,0.74,23,0.032173913,51
2923.817019,52,58,0.15,6,0.025,51
2923.730347,67,83,0.31,16,0.019375,51
2921.548066,48,57,0.24,9,0.026666667,51
2920.908283,64,84,0.4,20,0.02,51
2920.484058,49,60,0.28,11,0.025454545,51
2920.361214,58,74,0.52,16,0.0325,51
2920.128813,57,77,0.63,20,0.0315,51
2918.934044,61,72,0.36,11,0.032727273,51
2918.664829,53,79,0.86,26,0.033076923,51
2918.432998,55,77,0.72,22,0.032727273,51
2918.284107,68,88,0.37,20,0.0185,51
2918.116632,62,68,0.2,6,0.033333333,51
2918.116632,59,71,0.4,12,0.033333333,51
2918.116076,66,88,0.41,22,0.018636364,51
2917.555941,64,91,0.5,27,0.018518519,51
2917.281521,44,65,0.55,21,0.026190476,51
2917.25662,52,55,0.08,3,0.026666667,51
2915.846095,74,81,0.13,7,0.018571429,51
2915.032895,66,92,0.47,26,0.018076923,51
2914.945221,61,72,0.35,11,0.031818182,51
2913.31373,75,81,0.11,6,0.018333333,51
2913.31373,67,90,0.42,23,0.01826087,51
2913.054631,46,62,0.41,16,0.025625,51
2911.102664,42,52,0.36,10,0.036,51
2910.879733,72,84,0.22,12,0.018333333,51
2910.407663,52,82,0.96,30,0.032,51
2909.839031,59,73,0.46,14,0.032857143,51
2909.778582,59,76,0.53,17,0.031176471,51
2909.708742,52,80,0.92,28,0.032857143,51
2909.708742,51,81,0.99,30,0.033,51
2909.129773,70,78,0.16,8,0.02,51
2909.054261,52,81,0.95,29,0.032758621,51
2908.749767,58,71,0.3,13,0.023076923,51
2908.112895,58,75,0.56,17,0.032941176,51
2907.943404,54,79,0.82,25,0.0328,51
2907.030444,37,53,0.59,16,0.036875,51
2906.620039,55,78,0.76,23,0.033043478,51
2906.602638,56,79,0.72,23,0.031304348,51
2906.355715,64,68,0.13,4,0.0325,51
2906.096289,72,74,0.04,2,0.02,51
2906.096289,71,75,0.08,4,0.02,51
2906.096289,70,76,0.12,6,0.02,51
2902.946593,54,81,0.85,27,0.031481481,51
2902.465675,54,77,0.76,23,0.033043478,51
2902.034218,47,62,0.38,15,0.025333333,51
2900.968955,58,76,0.57,18,0.031666667,51
2900.331695,65,79,0.29,14,0.020714286,51
2899.537783,46,59,0.35,13,0.026923077,51
2897.688595,53,78,0.83,25,0.0332,51
2896.460787,46,60,0.37,14,0.026428571,51
2895.590081,50,56,0.16,6,0.026666667,51
2895.344166,52,80,0.93,28,0.033214286,51
2895.055364,64,81,0.35,17,0.020588235,51
2894.195123,56,78,0.7,22,0.031818182,51
2894.04339,52,79,0.9,27,0.033333333,51
2893.759775,46,61,0.39,15,0.026,51
2893.412354,50,75,0.88,25,0.0352,51
2893.186195,34,56,0.83,22,0.037727273,51
2892.701681,49,61,0.3,12,0.025,51
2892.43406,37,53,0.6,16,0.0375,51
2892.218484,74,83,0.16,9,0.017777778,51
2892.208726,59,74,0.48,15,0.032,51
2891.7546,53,82,0.92,29,0.031724138,51
2891.460243,70,80,0.19,10,0.019,51
2890.699736,61,73,0.38,12,0.031666667,51
2890.588702,65,80,0.31,15,0.020666667,51
2890.528962,68,84,0.31,16,0.019375,51
2890.301268,64,90,0.49,26,0.018846154,51
2890.218333,64,70,0.19,6,0.031666667,51
2890.133619,44,48,0.15,4,0.0375,51
2890.065878,73,83,0.18,10,0.018,51
2890.039521,64,93,0.53,29,0.018275862,51
2890.039521,63,94,0.57,31,0.018387097,51
2888.898837,52,82,0.97,30,0.032333333,51
2888.731902,54,85,0.9,31,0.029032258,51
2888.586095,48,59,0.29,11,0.026363636,51
2888.498918,47,59,0.32,12,0.026666667,51
2887.947175,57,78,0.66,21,0.031428571,51
2887.891978,54,77,0.77,23,0.033478261,51
2887.399244,63,69,0.2,6,0.033333333,51
2887.255005,65,92,0.49,27,0.018148148,51
2886.838023,55,75,0.67,20,0.0335,51
2886.74344,38,52,0.51,14,0.036428571,51
2885.958533,53,80,0.88,27,0.032592593,51
2885.676472,60,75,0.47,15,0.031333333,51
2884.794268,55,80,0.79,25,0.0316,51
2884.415819,39,47,0.32,8,0.04,51
2884.206799,61,90,0.57,29,0.019655172,51
2883.814099,57,76,0.62,19,0.032631579,51
2883.068678,39,51,0.45,12,0.0375,51
2882.525961,59,75,0.51,16,0.031875,51
2881.824685,62,71,0.29,9,0.032222222,51
2881.824685,60,73,0.42,13,0.032307692,51
2880.948314,57,75,0.59,18,0.032777778,51
2880.904493,54,80,0.84,26,0.032307692,51
2878.377161,58,73,0.5,15,0.033333333,51
2878.196949,67,80,0.26,13,0.02,51
2878.067627,56,76,0.66,20,0.033,51
2878.033602,64,69,0.16,5,0.032,51
2877.594875,44,66,0.56,22,0.025454545,51
2877.233141,61,78,0.49,17,0.028823529,51
2877.233141,60,79,0.55,19,0.028947368,51
2876.453532,49,57,0.21,8,0.02625,51
2876.410071,55,76,0.7,21,0.033333333,51
2876.322688,66,73,0.2,7,0.028571429,51
2876.018465,37,51,0.54,14,0.038571429,51
2874.534448,61,69,0.27,8,0.03375,51
2874.534448,57,74,0.57,17,0.033529412,51
2874.480259,42,50,0.3,8,0.0375,51
2874.278741,53,86,0.97,33,0.029393939,51
2874.182238,69,81,0.23,12,0.019166667,51
2874.083915,51,58,0.18,7,0.025714286,51
2873.866269,43,50,0.26,7,0.037142857,51
2873.667727,56,77,0.68,21,0.032380952,51
2873.448674,63,70,0.23,7,0.032857143,51
2871.668219,62,77,0.43,15,0.028666667,51
2871.487636,56,70,0.42,14,0.03,51
2871.455371,50,58,0.21,8,0.02625,51
2871.266374,53,81,0.9,28,0.032142857,51
2871.194519,38,48,0.4,10,0.04,51
2869.592188,68,78,0.2,10,0.02,51
2869.592188,67,79,0.24,12,0.02,51
2869.506228,55,77,0.73,22,0.033181818,51
2869.385083,50,60,0.25,10,0.025,51
2869.316856,57,81,0.71,24,0.029583333,51
2869.316856,56,82,0.77,26,0.029615385,51
2869.316856,55,83,0.83,28,0.029642857,51
2869.316856,54,84,0.89,30,0.029666667,51
2869.316856,53,85,0.95,32,0.0296875,51
2869.252066,66,77,0.23,11,0.020909091,51
2868.718131,53,86,0.98,33,0.02969697,51
2867.298951,63,91,0.53,28,0.018928571,51
2867.24917,64,91,0.51,27,0.018888889,51
2867.24917,63,92,0.55,29,0.018965517,51
2867.24917,62,94,0.6,32,0.01875,51
2866.821418,69,86,0.32,17,0.018823529,51
2866.336225,58,77,0.6,19,0.031578947,51
2866.275616,54,79,0.81,25,0.0324,51
2865.381998,52,81,0.96,29,0.033103448,51
2864.829965,43,49,0.23,6,0.038333333,51
2864.589796,41,53,0.44,12,0.036666667,51
2864.546619,65,89,0.45,24,0.01875,51
2864.424975,72,82,0.19,10,0.019,51
2864.193202,42,47,0.19,5,0.038,51
2862.619894,36,52,0.62,16,0.03875,51
2862.582143,38,52,0.5,14,0.035714286,51
2862.095252,48,61,0.33,13,0.025384615,51
2862.048968,62,77,0.34,15,0.022666667,51
2861.394668,48,58,0.27,10,0.027,51
2860.880579,32,58,0.99,26,0.038076923,51
2860.044544,38,52,0.52,14,0.037142857,51
2859.885419,56,78,0.71,22,0.032272727,51
2859.335818,68,82,0.27,14,0.019285714,51
2859.282774,40,46,0.24,6,0.04,51
2858.477387,33,99,0.2,66,0.003030303,51
2858.45419,67,91,0.43,24,0.017916667,51
2858.064578,57,77,0.64,20,0.032,51
2856.839828,51,59,0.2,8,0.025,51
2856.671522,36,50,0.56,14,0.04,51
2856.500069,64,67,0.1,3,0.033333333,51
2856.500069,61,70,0.3,9,0.033333333,51
2856.217287,36,56,0.67,20,0.0335,51
2855.972962,58,72,0.47,14,0.033571429,51
2855.936829,39,57,0.64,18,0.035555556,51
2855.306886,34,55,0.81,21,0.038571429,51
2855.306886,33,56,0.89,23,0.038695652,51
2855.19286,37,49,0.48,12,0.04,51
2854.882247,45,61,0.43,16,0.026875,51
2853.510491,67,89,0.4,22,0.018181818,51
2853.510491,66,91,0.45,25,0.018,51
2850.93161,53,80,0.89,27,0.032962963,51
2849.693048,39,49,0.39,10,0.039,51
2848.954083,70,86,0.29,16,0.018125,51
2848.579684,35,54,0.73,19,0.038421053,51
2848.11997,67,83,0.3,16,0.01875,51
2847.912245,53,85,0.96,32,0.03,51
2847.21658,59,81,0.62,22,0.028181818,51
2847.21658,58,82,0.68,24,0.028333333,51
2845.570731,38,58,0.72,20,0.036,51
2845.563692,51,80,0.97,29,0.033448276,51
2845.171315,69,77,0.16,8,0.02,51
2843.784117,59,85,0.66,26,0.025384615,51
2843.784117,58,86,0.71,28,0.025357143,51
2843.600068,56,85,0.82,29,0.028275862,51
2843.333382,40,51,0.37,11,0.033636364,51
2842.915825,62,79,0.38,17,0.022352941,51
2842.915825,60,81,0.47,21,0.022380952,51
2842.417483,58,75,0.55,17,0.032352941,51
2841.903688,33,57,0.91,24,0.037916667,51
2841.843169,58,82,0.69,24,0.02875,51
2839.443425,51,71,0.72,20,0.036,51
2839.325772,52,75,0.69,23,0.03,51
2839.240161,38,51,0.49,13,0.037692308,51
2838.687138,56,75,0.55,19,0.028947368,51
2838.474994,54,76,0.74,22,0.033636364,51
2838.370121,35,51,0.64,16,0.04,51
2837.874156,43,50,0.25,7,0.035714286,51
2837.513926,69,87,0.33,18,0.018333333,51
2836.885813,61,71,0.33,10,0.033,51
2836.622767,37,52,0.57,15,0.038,51
2836.344397,60,80,0.57,20,0.0285,51
2836.344397,59,81,0.63,22,0.028636364,51
2835.654454,47,60,0.34,13,0.026153846,51
2835.472166,38,49,0.43,11,0.039090909,51
2835.472166,37,50,0.51,13,0.039230769,51
2835.119125,55,67,0.43,12,0.035833333,51
2834.849337,54,78,0.8,24,0.033333333,51
2834.664833,45,64,0.5,19,0.026315789,51
2833.833346,33,53,0.81,20,0.0405,51
2833.697856,44,47,0.11,3,0.036666667,51
2832.778372,59,79,0.59,20,0.0295,51
2831.951796,68,89,0.38,21,0.018095238,51
2830.504458,67,75,0.17,8,0.02125,51
2830.413947,33,98,0.21,65,0.003230769,51
2830.268286,47,61,0.37,14,0.026428571,51
2829.320365,70,79,0.17,9,0.018888889,51
2828.94171,68,90,0.39,22,0.017727273,51
2828.915377,56,80,0.64,24,0.026666667,51
2828.349262,66,84,0.34,18,0.018888889,51
2828.012984,59,71,0.35,12,0.029166667,51
2827.933948,38,56,0.64,18,0.035555556,51
2827.933948,37,57,0.72,20,0.036,51
2827.36754,65,85,0.38,20,0.019,51
2826.773502,61,77,0.47,16,0.029375,51
2826.773502,60,78,0.53,18,0.029444444,51
2826.302487,52,70,0.65,18,0.036111111,51
2826.113376,55,79,0.77,24,0.032083333,51
2825.655722,54,84,0.9,30,0.03,51
2825.247235,64,77,0.29,13,0.022307692,51
2823.327081,60,80,0.56,20,0.028,51
2822.806469,47,62,0.39,15,0.026,51
2822.768906,58,74,0.53,16,0.033125,51
2822.260045,49,85,0.98,36,0.027222222,51
2821.446252,65,76,0.24,11,0.021818182,51
2821.409333,54,82,0.75,28,0.026785714,51
2821.387188,63,85,0.44,22,0.02,51
2820.936635,53,86,0.96,33,0.029090909,51
2820.506991,50,76,0.86,26,0.033076923,51
2820.299944,61,79,0.51,18,0.028333333,51
2820.299944,57,84,0.76,27,0.028148148,51
2820.1712,44,64,0.53,20,0.0265,51
2820.10058,56,85,0.81,29,0.027931034,51
2819.309868,61,77,0.48,16,0.03,51
2819.29089,58,71,0.44,13,0.033846154,51
2818.232727,56,65,0.33,9,0.036666667,51
2816.073012,65,94,0.52,29,0.017931034,51
2815.947963,37,53,0.58,16,0.03625,51
2815.811803,62,76,0.41,14,0.029285714,51
2815.811803,56,83,0.78,27,0.028888889,51
2814.786663,42,44,0.08,2,0.04,51
2814.786663,41,45,0.16,4,0.04,51
2814.459364,43,68,0.64,25,0.0256,51
2813.550776,65,84,0.36,19,0.018947368,51
2813.500166,68,80,0.23,12,0.019166667,51
2813.303034,40,49,0.35,9,0.038888889,51
2812.886493,35,58,0.76,23,0.033043478,51
2810.953169,60,73,0.36,13,0.027692308,51
2810.894858,62,71,0.25,9,0.027777778,51
2810.894858,59,75,0.44,16,0.0275,51
2810.894858,57,77,0.55,20,0.0275,51
2810.49586,42,47,0.18,5,0.036,51
2810.495441,49,86,0.99,37,0.026756757,51
2809.734958,46,61,0.4,15,0.026666667,51
2809.497647,64,86,0.42,22,0.019090909,51
2809.114712,44,49,0.18,5,0.036,51
2808.693829,61,73,0.33,12,0.0275,51
2808.454284,38,50,0.46,12,0.038333333,51
2808.271683,55,86,0.88,31,0.028387097,51
2808.189424,55,79,0.66,24,0.0275,51
2807.291153,57,83,0.74,26,0.028461538,51
2806.617188,53,74,0.62,21,0.02952381,51
2806.486902,55,80,0.68,25,0.0272,51
2805.861797,61,71,0.28,10,0.028,51
2805.84428,65,83,0.35,18,0.019444444,51
2804.959327,67,84,0.32,17,0.018823529,51
2804.632594,44,65,0.54,21,0.025714286,51
2804.464063,37,48,0.45,11,0.040909091,51
2803.067444,35,55,0.75,20,0.0375,51
2800.859621,60,74,0.38,14,0.027142857,51
2800.468841,64,85,0.42,21,0.02,51
2800.314424,39,50,0.4,11,0.036363636,51
2799.57939,58,77,0.51,19,0.026842105,51
2799.205684,65,75,0.22,10,0.022,51
2798.881423,58,72,0.41,14,0.029285714,51
2798.831996,69,88,0.34,19,0.017894737,51
2797.192799,60,85,0.53,25,0.0212,51
2797.158881,57,84,0.75,27,0.027777778,51
2796.844671,53,76,0.72,23,0.031304348,51
2796.581923,40,53,0.49,13,0.037692308,51
2796.338303,36,51,0.59,15,0.039333333,51
2795.623872,51,80,0.89,29,0.030689655,51
2795.273468,39,48,0.35,9,0.038888889,51
2794.523217,57,78,0.57,21,0.027142857,51
2794.284179,42,49,0.26,7,0.037142857,51
2794.159735,62,78,0.36,16,0.0225,51
2794.094913,62,78,0.45,16,0.028125,51
2793.431072,56,77,0.59,21,0.028095238,51
2791.671755,63,83,0.41,20,0.0205,51
2791.610586,53,81,0.78,28,0.027857143,51
2791.433541,64,85,0.4,21,0.019047619,51
2791.347245,55,84,0.84,29,0.028965517,51
2791.195364,43,46,0.11,3,0.036666667,51
2790.762637,67,81,0.27,14,0.019285714,51
2790.192418,43,69,0.66,26,0.025384615,51
2789.939573,34,52,0.73,18,0.040555556,51
2789.923427,63,87,0.46,24,0.019166667,51
2789.876076,57,76,0.53,19,0.027894737,51
2789.50144,63,69,0.17,6,0.028333333,51
2789.50144,59,74,0.42,15,0.028,51
2789.010874,32,57,0.97,25,0.0388,51
2788.938202,66,82,0.31,16,0.019375,51
2788.92824,41,48,0.26,7,0.037142857,51
2788.370347,60,72,0.34,12,0.028333333,51
2788.235322,51,79,0.87,28,0.031071429,51
2787.683427,54,80,0.72,26,0.027692308,51
2786.557926,39,55,0.57,16,0.035625,51
2785.834573,60,70,0.3,10,0.03,51
2785.589408,57,72,0.46,15,0.030666667,51
2785.442051,56,86,0.8,30,0.026666667,51
2785.389735,54,88,0.95,34,0.027941176,51
2785.05423,55,86,0.87,31,0.028064516,51
2783.978952,63,77,0.31,14,0.022142857,51
2783.597554,37,66,0.21,29,0.007241379,51
2783.507196,35,52,0.67,17,0.039411765,51
2783.492383,65,84,0.38,19,0.02,51
2783.096144,68,72,0.09,4,0.0225,51
2783.096144,66,74,0.18,8,0.0225,51
2783.096144,64,76,0.27,12,0.0225,51
2782.838577,66,73,0.16,7,0.022857143,51
2782.579533,66,85,0.36,19,0.018947368,51
2782.505148,59,62,0.11,3,0.036666667,51
2782.315764,34,54,0.78,20,0.039,51
2781.929145,46,60,0.38,14,0.027142857,51
2781.900627,58,81,0.66,23,0.028695652,51
2781.307447,57,64,0.25,7,0.035714286,51
2780.675386,56,84,0.81,28,0.028928571,51
2780.675386,55,85,0.87,30,0.029,51
2780.459421,50,81,0.95,31,0.030645161,51
2780.050706,51,73,0.81,22,0.036818182,51
2779.462469,41,54,0.46,13,0.035384615,51
2778.181801,45,62,0.45,17,0.026470588,51
2778.088163,34,53,0.75,19,0.039473684,51
2777.609293,58,83,0.69,25,0.0276,51
2777.32597,56,89,0.83,33,0.025151515,51
2776.997885,63,86,0.44,23,0.019130435,51
2776.990385,64,75,0.25,11,0.022727273,51
2776.494045,54,87,0.94,33,0.028484848,51
2775.654052,53,77,0.74,24,0.030833333,51
2775.654052,52,78,0.8,26,0.030769231,51
2775.421384,51,79,0.86,28,0.030714286,51
2775.111508,57,83,0.75,26,0.028846154,51
2774.797038,57,82,0.72,25,0.0288,51
2773.938021,53,83,0.81,30,0.027,51
2773.113153,50,79,0.9,29,0.031034483,51
2772.930609,7,39,0.75,32,0.0234375,51
2772.658805,38,51,0.48,13,0.036923077,51
2772.52519,43,51,0.29,8,0.03625,51
2772.179409,53,73,0.63,20,0.0315,51
2771.848986,57,85,0.59,28,0.021071429,51
2771.313843,55,83,0.84,28,0.03,51
2770.624419,54,75,0.65,21,0.030952381,51
2770.373383,65,74,0.26,9,0.028888889,51
2770.239772,54,86,0.91,32,0.0284375,51
2769.671184,55,75,0.61,20,0.0305,51
2769.671184,52,79,0.82,27,0.03037037,51
2769.560066,40,55,0.54,15,0.036,51
2768.6658,66,90,0.43,24,0.017916667,51
2767.209936,52,84,0.85,32,0.0265625,51
2766.599908,65,90,0.45,25,0.018,51
2766.252333,56,83,0.79,27,0.029259259,51
2766.252333,55,84,0.85,29,0.029310345,51
2766.231823,63,86,0.46,23,0.02,51
2766.138144,35,53,0.7,18,0.038888889,51
2765.922952,44,63,0.51,19,0.026842105,51
2765.751199,53,87,0.97,34,0.028529412,51
2765.231288,56,84,0.8,28,0.028571429,51
2764.690159,54,89,0.93,35,0.026571429,51
2763.521163,59,80,0.61,21,0.029047619,51
2763.521163,58,81,0.67,23,0.029130435,51
2763.431789,55,88,0.68,33,0.020606061,51
2763.081014,50,72,0.8,22,0.036363636,51
2763.080705,64,91,0.49,27,0.018148148,51
2762.145854,51,81,0.86,30,0.028666667,51
2762.108314,55,81,0.7,26,0.026923077,51
2761.957577,54,81,0.73,27,0.027037037,51
2761.888188,56,78,0.61,22,0.027727273,51
2761.839598,56,88,0.82,32,0.025625,51
2761.82166,56,72,0.5,16,0.03125,51
2761.784713,39,50,0.43,11,0.039090909,51
2761.4883,56,82,0.78,26,0.03,51
2761.470665,58,80,0.65,22,0.029545455,51
2761.231794,63,77,0.39,14,0.027857143,51
2761.0284,55,78,0.65,23,0.02826087,51
2760.842364,8,39,0.63,31,0.020322581,51
2760.842311,8,39,0.45,31,0.014516129,51
2759.779198,63,78,0.33,15,0.022,51
2759.724214,58,76,0.5,18,0.027777778,51
2759.649596,33,60,0.99,27,0.036666667,51
2759.469869,53,76,0.71,23,0.030869565,51
2759.353487,55,79,0.67,24,0.027916667,51
2759.026915,41,48,0.27,7,0.038571429,51
2758.477769,40,54,0.5,14,0.035714286,51
2758.168787,55,85,0.86,30,0.028666667,51
2758.073828,58,83,0.7,25,0.028,51
2758.073828,55,87,0.89,32,0.0278125,51
2757.630891,64,69,0.14,5,0.028,51
2757.554442,54,81,0.74,27,0.027407407,51
2757.554442,53,82,0.8,29,0.027586207,51
2757.554442,52,84,0.87,32,0.0271875,51
2756.985848,54,83,0.77,29,0.026551724,51
2756.891387,57,84,0.74,27,0.027407407,51
2756.891387,55,87,0.87,32,0.0271875,51
2756.700511,68,69,0.03,1,0.03,51
2756.700511,67,70,0.09,3,0.03,51
2756.700511,66,71,0.15,5,0.03,51
2756.655099,61,70,0.26,9,0.028888889,51
2756.60025,58,76,0.49,18,0.027222222,51
2756.60025,56,79,0.62,23,0.026956522,51
2756.376302,62,89,0.53,27,0.01962963,51
2756.213451,55,80,0.69,25,0.0276,51
2755.84036,56,79,0.63,23,0.027391304,51
2755.68132,53,84,0.82,31,0.026451613,51
2755.597408,38,51,0.51,13,0.039230769,51
2755.535285,33,56,0.9,23,0.039130435,51
2755.517306,57,82,0.73,25,0.0292,51
2754.634144,37,52,0.56,15,0.037333333,51
2754.286516,34,60,0.84,26,0.032307692,51
2754.046343,52,83,0.86,31,0.027741935,51
2754.046343,51,85,0.93,34,0.027352941,51
2753.823371,32,57,0.99,25,0.0396,51
2753.645941,49,81,0.97,32,0.0303125,51
2753.53215,37,55,0.6,18,0.033333333,51
2753.445244,55,77,0.63,22,0.028636364,51
2752.704336,52,85,0.87,33,0.026363636,51
2752.675373,53,90,0.99,37,0.026756757,51
2752.540544,40,53,0.48,13,0.036923077,51
2751.813074,50,80,0.9,30,0.03,51
2751.599066,60,81,0.58,21,0.027619048,51
2751.599066,59,82,0.64,23,0.027826087,51
2751.593994,51,84,0.92,33,0.027878788,51
2750.914859,34,55,0.82,21,0.039047619,51
2750.83154,54,76,0.5,22,0.022727273,51
2750.605675,34,96,0.14,62,0.002258065,51
2750.571039,64,68,0.11,4,0.0275,51
2750.296731,50,85,0.94,35,0.026857143,51
2750.280385,50,80,0.93,30,0.031,51
2750.111555,52,85,0.88,33,0.026666667,51
2749.702953,52,77,0.78,25,0.0312,51
2749.670628,53,87,0.98,34,0.028823529,51
2749.663309,53,83,0.8,30,0.026666667,51
2749.50941,53,68,0.55,15,0.036666667,51
2749.478717,33,55,0.86,22,0.039090909,51
2749.467718,63,75,0.28,12,0.023333333,51
2749.456451,59,73,0.4,14,0.028571429,51
2749.456451,54,79,0.71,25,0.0284,51
2748.792842,56,78,0.6,22,0.027272727,51
2748.258166,37,54,0.59,17,0.034705882,51
2748.025096,63,85,0.45,22,0.020454545,51
2748.017267,40,65,0.16,25,0.0064,51
2747.657021,73,80,0.13,7,0.018571429,51
2747.4695,53,81,0.76,28,0.027142857,51
2747.357912,57,77,0.54,20,0.027,51
2747.084423,33,98,0.19,65,0.002923077,51
2746.561325,68,75,0.15,7,0.021428571,51
2746.4445,57,76,0.54,19,0.028421053,51
2746.433184,54,87,0.95,33,0.028787879,51
2746.346403,57,75,0.5,18,0.027777778,51
2746.256546,62,88,0.5,26,0.019230769,51
2746.190904,37,59,0.8,22,0.036363636,51
2745.770326,56,73,0.52,17,0.030588235,51
2745.499259,38,55,0.63,17,0.037058824,51
2745.333244,51,78,0.84,27,0.031111111,51
2744.833972,51,88,0.97,37,0.026216216,51
2744.660978,54,81,0.75,27,0.027777778,51
2744.292204,57,77,0.56,20,0.028,51
2744.292204,54,80,0.73,26,0.028076923,51
2744.255284,42,51,0.33,9,0.036666667,51
2744.148832,34,98,0.18,64,0.0028125,51
2743.643982,50,82,0.92,32,0.02875,51
2743.306865,8,39,0.46,31,0.01483871,51
2743.177468,58,73,0.43,15,0.028666667,51
2742.880932,39,54,0.56,15,0.037333333,51
2742.871637,37,57,0.73,20,0.0365,51
2742.763675,38,56,0.65,18,0.036111111,51
2742.634877,57,74,0.49,17,0.028823529,51
2742.439576,67,82,0.3,15,0.02,51
2742.439576,66,83,0.34,17,0.02,51
2742.298514,54,82,0.76,28,0.027142857,51
2742.203594,54,85,0.91,31,0.029354839,51
2742.087999,61,78,0.39,17,0.022941176,51
2741.817932,51,86,0.93,35,0.026571429,51
2741.754835,50,79,0.91,29,0.03137931,51
2741.65987,42,53,0.39,11,0.035454545,51
2741.582981,50,84,0.93,34,0.027352941,51
2741.352328,52,78,0.78,26,0.03,51
2741.293573,49,81,0.98,32,0.030625,51
2741.229116,48,74,0.95,26,0.036538462,51
2740.837964,53,84,0.83,31,0.026774194,51
2740.782977,54,67,0.48,13,0.036923077,51
2740.71113,51,80,0.88,29,0.030344828,51
2740.613673,40,50,0.36,10,0.036,51
2740.502011,51,80,0.87,29,0.03,51
2740.47775,57,73,0.49,16,0.030625,51
2740.451129,59,71,0.36,12,0.03,51
2740.451129,58,72,0.42,14,0.03,51
2740.083954,55,74,0.58,19,0.030526316,51
2740.029787,55,80,0.67,25,0.0268,51
2739.884342,53,80,0.76,27,0.028148148,51
2739.884342,52,81,0.82,29,0.028275862,51
2739.645363,49,75,0.95,26,0.036538462,51
2739.631712,38,57,0.7,19,0.036842105,51
2739.609709,49,81,0.99,32,0.0309375,51
2739.353429,51,82,0.88,31,0.028387097,51
2739.331358,58,85,0.55,27,0.02037037,51
2739.316087,62,69,0.2,7,0.028571429,51
2739.228578,67,77,0.27,10,0.027,51
2739.019204,53,77,0.72,24,0.03,51
2738.552079,56,74,0.53,18,0.029444444,51
2738.15568,69,98,0.49,29,0.016896552,51
2738.114967,34,54,0.79,20,0.0395,51
2738.088082,52,85,0.89,33,0.026969697,51
2737.626375,57,83,0.6,26,0.023076923,51
2737.410406,52,79,0.81,27,0.03,51
2737.375279,40,54,0.52,14,0.037142857,51
2737.286994,58,75,0.47,17,0.027647059,51
2737.14196,58,85,0.7,27,0.025925926,51
2737.137007,50,86,0.99,36,0.0275,51
2737.069856,57,75,0.51,18,0.028333333,51
2737.069856,56,76,0.57,20,0.0285,51
2736.813257,33,59,0.96,26,0.036923077,51
2736.62999,38,54,0.58,16,0.03625,51
2736.343407,64,92,0.5,28,0.017857143,51
2736.083762,52,86,0.9,34,0.026470588,51
2735.793411,50,81,0.94,31,0.030322581,51
2735.742614,54,76,0.67,22,0.030454545,51
2735.697602,55,78,0.63,23,0.027391304,51
2735.687449,53,78,0.75,25,0.03,51
2735.579948,61,80,0.42,19,0.022105263,51
2735.533861,50,81,0.93,31,0.03,51
2735.533861,49,82,0.99,33,0.03,51
2735.399134,57,87,0.76,30,0.025333333,51
2735.399134,55,90,0.88,35,0.025142857,51
2735.16986,59,82,0.63,23,0.027391304,51
2735.129439,53,83,0.82,30,0.027333333,51
2735.077454,53,82,0.79,29,0.027241379,51
2734.984265,52,86,0.89,34,0.026176471,51
2734.891902,57,69,0.36,12,0.03,51
2734.678711,54,68,0.52,14,0.037142857,51
2734.678711,52,70,0.67,18,0.037222222,51
2734.678711,50,73,0.85,23,0.036956522,51
2734.65105,54,87,0.93,33,0.028181818,51
2734.578536,39,52,0.44,13,0.033846154,51
2734.539419,56,71,0.52,15,0.034666667,51
2734.539419,55,72,0.59,17,0.034705882,51
2734.050167,52,76,0.75,24,0.03125,51
2733.587964,61,72,0.31,11,0.028181818,51
2733.587964,58,75,0.48,17,0.028235294,51
2733.262019,63,81,0.38,18,0.021111111,51
2733.190067,57,85,0.75,28,0.026785714,51
2733.100011,53,77,0.73,24,0.030416667,51
2733.100011,52,78,0.79,26,0.030384615,51
2732.644403,67,89,0.41,22,0.018636364,51
2732.643922,65,92,0.5,27,0.018518519,51
2732.447663,57,73,0.48,16,0.03,51
2732.447663,56,74,0.54,18,0.03,51
2732.447663,55,75,0.6,20,0.03,51
2732.447663,54,76,0.66,22,0.03,51
2732.224203,36,65,0.14,29,0.004827586,51
2731.505713,49,56,0.19,7,0.027142857,51
2731.286447,62,76,0.42,14,0.03,51
2730.881721,54,90,0.92,36,0.025555556,51
2730.637971,56,87,0.82,31,0.026451613,51
2730.38479,51,86,0.94,35,0.026857143,51
2730.218132,53,88,0.99,35,0.028285714,51
2729.98095,52,84,0.88,32,0.0275,51
2729.786461,61,72,0.3,11,0.027272727,51
2729.561788,55,71,0.49,16,0.030625,51
2729.469225,55,90,0.89,35,0.025428571,51
2729.213649,34,99,0.13,65,0.002,51
2728.474078,7,41,0.77,34,0.022647059,51
2728.447006,55,88,0.87,33,0.026363636,51
2728.425228,54,69,0.53,15,0.035333333,51
2728.288216,56,84,0.79,28,0.028214286,51
2728.200759,53,92,0.98,39,0.025128205,51
2728.192778,52,84,0.86,32,0.026875,51
2728.192778,51,85,0.92,34,0.027058824,51
2728.192778,50,87,0.99,37,0.026756757,51
2728.178999,56,86,0.81,30,0.027,51
2727.488904,40,51,0.41,11,0.037272727,51
2727.40698,59,74,0.41,15,0.027333333,51
2727.306032,33,97,0.21,64,0.00328125,51
2727.293201,70,87,0.31,17,0.018235294,51
2727.062303,50,74,0.87,24,0.03625,51
2726.795169,31,99,0.23,68,0.003382353,51
2726.774573,64,79,0.32,15,0.021333333,51
2725.997771,55,88,0.88,33,0.026666667,51
2725.997771,54,90,0.95,36,0.026388889,51
2725.825166,53,91,0.98,38,0.025789474,51
2725.790927,38,47,0.36,9,0.04,51
2725.725523,52,83,0.83,31,0.026774194,51
2723.835175,41,52,0.4,11,0.036363636,51
2723.835175,39,54,0.55,15,0.036666667,51
2723.50807,61,88,0.55,27,0.02037037,51
2722.691537,37,52,0.58,15,0.038666667,51
2722.637019,52,77,0.77,25,0.0308,51
2722.603658,54,88,0.93,34,0.027352941,51
2721.734541,53,78,0.73,25,0.0292,51
2721.700922,52,81,0.8,29,0.027586207,51
2721.700922,51,83,0.87,32,0.0271875,51
2720.991949,60,67,0.24,7,0.034285714,51
2720.882997,61,74,0.35,13,0.026923077,51
2720.711635,49,85,0.99,36,0.0275,51
2719.985486,50,87,0.98,37,0.026486486,51
2719.191791,36,90,0.49,54,0.009074074,51
2719.127309,54,91,0.93,37,0.025135135,51
2718.804055,64,80,0.34,16,0.02125,51
2718.766397,55,85,0.85,30,0.028333333,51
2718.484278,54,75,0.64,21,0.03047619,51
2718.332179,51,86,0.95,35,0.027142857,51
2718.226482,56,77,0.57,21,0.027142857,51
2718.091358,51,79,0.85,28,0.030357143,51
2718.091358,50,80,0.91,30,0.030333333,51
2717.989955,55,87,0.68,32,0.02125,51
2717.698654,56,86,0.64,30,0.021333333,51
2717.004499,51,85,0.94,34,0.027647059,51
2716.805675,60,78,0.54,18,0.03,51
2716.783928,52,83,0.85,31,0.027419355,51
2716.663702,38,53,0.51,15,0.034,51
2716.651198,38,55,0.64,17,0.037647059,51
2716.588723,51,84,0.88,33,0.026666667,51
2716.441362,50,80,0.92,30,0.030666667,51
2716.362236,39,52,0.52,13,0.04,51
2716.281327,51,79,0.84,28,0.03,51
2716.151316,33,97,0.22,64,0.0034375,51
2715.672252,56,88,0.81,32,0.0253125,51
2715.659849,59,68,0.31,9,0.034444444,51
2715.399816,55,87,0.86,32,0.026875,51
2715.255675,51,72,0.77,21,0.036666667,51
2714.937439,52,92,0.82,40,0.0205,51
2714.477166,35,59,0.89,24,0.037083333,51
2714.426745,39,54,0.57,15,0.038,51
2714.32532,61,89,0.56,28,0.02,51
2714.155987,66,91,0.46,25,0.0184,51
2713.898441,52,82,0.84,30,0.028,51
2713.876615,53,75,0.75,22,0.034090909,51
2713.876615,53,76,0.78,23,0.033913043,51
2713.876615,52,76,0.82,24,0.034166667,51
2713.853232,56,74,0.56,18,0.031111111,51
2713.724728,51,82,0.86,31,0.027741935,51
2713.724728,50,83,0.92,33,0.027878788,51
2713.724091,55,68,0.46,13,0.035384615,51
2713.471726,51,78,0.83,27,0.030740741,51
2713.413024,36,52,0.63,16,0.039375,51
2713.381153,60,83,0.5,23,0.02173913,51
2713.089029,67,85,0.35,18,0.019444444,51
2713.089029,66,86,0.39,20,0.0195,51
2713.075811,52,57,0.13,5,0.026,51
2713.041725,60,69,0.28,9,0.031111111,51
2713.041725,55,75,0.62,20,0.031,51
2712.942727,37,51,0.55,14,0.039285714,51
2712.489929,60,90,0.6,30,0.02,51
2712.220298,65,78,0.28,13,0.021538462,51
2712.173111,52,69,0.63,17,0.037058824,51
2712.135312,51,84,0.91,33,0.027575758,51
2711.84759,52,82,0.82,30,0.027333333,51
2711.84759,51,84,0.89,33,0.026969697,51
2711.845109,51,83,0.9,32,0.028125,51
2711.34065,42,46,0.15,4,0.0375,51
2711.195615,56,86,0.82,30,0.027333333,51
2711.195615,55,88,0.89,33,0.026969697,51
2711.193511,42,51,0.34,9,0.037777778,51
2711.072374,54,76,0.65,22,0.029545455,51
2710.99881,59,71,0.37,12,0.030833333,51
2710.979314,41,54,0.47,13,0.036153846,51
2710.97374,58,69,0.38,11,0.034545455,51
2710.97374,57,70,0.45,13,0.034615385,51
2710.857292,67,77,0.21,10,0.021,51
2710.83363,55,76,0.63,21,0.03,51
2710.55556,60,79,0.44,19,0.023157895,51
2710.370274,56,67,0.39,11,0.035454545,51
2710.050624,63,87,0.48,24,0.02,51
2710.050624,62,88,0.52,26,0.02,51
2709.972055,67,88,0.4,21,0.019047619,51
2709.972055,64,92,0.53,28,0.018928571,51
2709.833925,51,73,0.8,22,0.036363636,51
2709.808347,66,89,0.44,23,0.019130435,51
2709.724486,35,56,0.76,21,0.036190476,51
2709.629364,54,69,0.55,15,0.036666667,51
2709.528532,62,64,0.07,2,0.035,51
2709.332369,36,59,0.81,23,0.035217391,51
2709.332369,35,60,0.89,25,0.0356,51
2708.969114,65,77,0.26,12,0.021666667,51
2708.720522,57,73,0.47,16,0.029375,51
2708.720522,55,76,0.61,21,0.029047619,51
2708.687709,53,75,0.69,22,0.031363636,51
2708.225715,52,77,0.85,25,0.034,51
2708.225715,51,78,0.92,27,0.034074074,51
2708.219468,51,80,0.85,29,0.029310345,51
2707.681594,59,69,0.31,10,0.031,51
2707.636827,61,84,0.62,23,0.026956522,51
2707.428805,32,54,0.89,22,0.040454545,51
2707.424173,51,87,0.96,36,0.026666667,51
2707.419459,58,62,0.15,4,0.0375,51
2707.419459,56,64,0.3,8,0.0375,51
2707.376325,55,88,0.69,33,0.020909091,51
2707.314632,52,78,0.81,26,0.031153846,51
2707.080695,71,83,0.23,12,0.019166667,51
2707.003029,55,87,0.88,32,0.0275,51
2706.725043,62,95,0.59,33,0.017878788,51
2706.647955,55,73,0.56,18,0.031111111,51
2706.49169,53,82,0.78,29,0.026896552,51
2706.49169,50,86,0.96,36,0.026666667,51
2706.032236,50,84,0.96,34,0.028235294,51
2705.887814,55,77,0.65,22,0.029545455,51
2705.755209,61,83,0.47,22,0.021363636,51
2705.623873,55,89,0.69,34,0.020294118,51
2705.558342,50,74,0.88,24,0.036666667,51
2705.355161,32,99,0.23,67,0.003432836,51
2705.289435,50,79,0.99,29,0.034137931,51
2705.199197,41,50,0.34,9,0.037777778,51
2705.050943,56,87,0.81,31,0.026129032,51
2705.050943,55,89,0.88,34,0.025882353,51
2705.008889,34,99,0.16,65,0.002461538,51
2704.848704,51,85,0.91,34,0.026764706,51
2704.818752,54,73,0.66,19,0.034736842,51
2704.818752,53,74,0.73,21,0.034761905,51
2704.557334,58,72,0.43,14,0.030714286,51
2704.455852,50,79,0.89,29,0.030689655,51
2704.334724,62,87,0.49,25,0.0196,51
2704.307956,54,86,0.93,32,0.0290625,51
2704.307956,53,87,0.99,34,0.029117647,51
2704.245182,54,79,0.73,25,0.0292,51
2704.022581,57,87,0.77,30,0.025666667,51
2703.991927,54,80,0.71,26,0.027307692,51
2703.911131,62,86,0.46,24,0.019166667,51
2703.880696,31,98,0.24,67,0.00358209,51
2703.866884,56,86,0.84,30,0.028,51
2703.841913,54,89,0.73,35,0.020857143,51
2703.479953,41,46,0.19,5,0.038,51
2702.783056,34,53,0.76,19,0.04,51
2702.120964,36,55,0.72,19,0.037894737,51
2702.077979,61,89,0.54,28,0.019285714,51
2701.871408,32,57,0.98,25,0.0392,51
2701.731341,54,89,0.95,35,0.027142857,51
2701.468575,61,80,0.52,19,0.027368421,51
2701.452773,51,87,0.97,36,0.026944444,51
2701.410719,58,81,0.68,23,0.029565217,51
2701.244758,55,89,0.89,34,0.026176471,51
2701.226513,54,89,0.92,35,0.026285714,51
2701.148156,71,80,0.17,9,0.018888889,51
2701.139696,50,81,0.96,31,0.030967742,51
2701.091521,55,85,0.71,30,0.023666667,51
2700.96754,35,57,0.81,22,0.036818182,51
2700.819217,51,82,0.92,31,0.029677419,51
2700.529375,34,58,0.92,24,0.038333333,51
2700.313957,36,55,0.68,19,0.035789474,51
2700.222959,55,79,0.65,24,0.027083333,51
2700.163691,59,76,0.46,17,0.027058824,51
2700.087256,54,78,0.71,24,0.029583333,51
2699.715512,39,53,0.51,14,0.036428571,51
2699.512316,60,82,0.59,22,0.026818182,51
2699.512316,59,83,0.64,24,0.026666667,51
2699.512316,57,86,0.77,29,0.026551724,51
2699.360447,52,71,0.7,19,0.036842105,51
2699.340321,54,90,0.73,36,0.020277778,51
2699.317916,62,81,0.52,19,0.027368421,51
2699.299387,52,83,0.84,31,0.027096774,51
2699.299387,50,85,0.95,35,0.027142857,51
2699.214711,62,83,0.44,21,0.020952381,51
2698.96523,59,89,0.74,30,0.024666667,51
2698.912423,52,81,0.85,29,0.029310345,51
2698.799687,50,81,0.92,31,0.029677419,51
2698.631862,54,79,0.69,25,0.0276,51
2698.277413,51,80,0.9,29,0.031034483,51
2698.135785,54,86,0.76,32,0.02375,51
2697.684409,49,84,0.98,35,0.028,51
2697.645231,41,50,0.33,9,0.036666667,51
2697.231409,55,89,0.87,34,0.025588235,51
2696.820177,37,55,0.67,18,0.037222222,51
2696.717642,67,79,0.25,12,0.020833333,51
2696.570293,54,80,0.7,26,0.026923077,51
2696.20728,57,85,0.76,28,0.027142857,51
2695.959524,49,80,0.97,31,0.031290323,51
2695.866083,53,80,0.79,27,0.029259259,51
2695.474285,50,85,0.97,35,0.027714286,51
2695.363719,54,77,0.68,23,0.029565217,51
2695.363719,53,78,0.74,25,0.0296,51
2695.363719,52,79,0.8,27,0.02962963,51
2695.363719,51,80,0.86,29,0.029655172,51
2695.148594,37,58,0.79,21,0.037619048,51
2695.147057,58,84,0.55,26,0.021153846,51
2695.140287,66,81,0.31,15,0.020666667,51
2695.03271,52,85,0.9,33,0.027272727,51
2694.92314,56,87,0.83,31,0.026774194,51
2694.92314,54,89,0.94,35,0.026857143,51
2694.832541,64,84,0.39,20,0.0195,51
2694.825635,59,84,0.65,25,0.026,51
2694.825635,57,86,0.76,29,0.026206897,51
2694.825635,56,88,0.83,32,0.0259375,51
2694.825635,54,90,0.94,36,0.026111111,51
2694.825635,54,91,0.95,37,0.025675676,51
2694.560814,58,84,0.7,26,0.026923077,51
2694.203338,43,66,0.6,23,0.026086957,51
2694.136726,34,52,0.72,18,0.04,51
2693.721082,33,54,0.84,21,0.04,51
2693.580019,53,87,0.96,34,0.028235294,51
2693.45068,41,49,0.29,8,0.03625,51
2693.391083,59,89,0.62,30,0.020666667,51
2693.335165,54,86,0.92,32,0.02875,51
2693.102734,59,73,0.39,14,0.027857143,51
2693.083666,50,74,0.85,24,0.035416667,51
2693.083666,49,75,0.92,26,0.035384615,51
2692.905695,53,80,0.74,27,0.027407407,51
2692.59131,36,51,0.6,15,0.04,51
2692.414519,57,86,0.6,29,0.020689655,51
2692.079727,54,77,0.67,23,0.029130435,51
2691.900194,65,72,0.21,7,0.03,51
2691.900194,64,73,0.27,9,0.03,51
2691.524968,50,75,0.9,25,0.036,51
2691.485753,54,70,0.58,16,0.03625,51
2691.391767,36,56,0.75,20,0.0375,51
2691.143453,54,76,0.68,22,0.030909091,51
2690.959783,36,56,0.73,20,0.0365,51
2690.903601,36,54,0.69,18,0.038333333,51
2690.821524,64,65,0.03,1,0.03,51
2690.821524,63,66,0.09,3,0.03,51
2690.788997,52,82,0.81,30,0.027,51
2690.787675,68,87,0.36,19,0.018947368,51
2690.726348,41,52,0.42,11,0.038181818,51
2690.714546,63,79,0.33,16,0.020625,51
2690.709758,50,71,0.78,21,0.037142857,51
2690.647649,54,88,0.94,34,0.027647059,51
2690.54813,53,81,0.77,28,0.0275,51
2690.537187,58,85,0.71,27,0.026296296,51
2690.471253,38,54,0.59,16,0.036875,51
2690.410924,66,75,0.2,9,0.022222222,51
2690.366631,63,85,0.43,22,0.019545455,51
2690.366631,62,86,0.47,24,0.019583333,51
2690.060838,38,50,0.47,12,0.039166667,51
2690.041061,61,86,0.52,25,0.0208,51
2690.013631,53,91,0.97,38,0.025526316,51
2689.779415,60,78,0.42,18,0.023333333,51
2689.762465,40,62,0.16,22,0.007272727,51
2689.49329,44,62,0.49,18,0.027222222,51
2689.41343,52,72,0.73,20,0.0365,51
2689.319154,58,70,0.37,12,0.030833333,51
2689.145794,62,84,0.57,22,0.025909091,51
2689.145794,59,88,0.74,29,0.025517241,51
2688.43264,67,86,0.36,19,0.018947368,51
2688.408303,7,41,0.76,34,0.022352941,51
2688.363421,48,61,0.34,13,0.026153846,51
2688.346187,46,73,0.06,27,0.002222222,51
2688.28657,56,73,0.53,17,0.031176471,51
2688.200286,34,99,0.15,65,0.002307692,51
2688.160933,41,52,0.41,11,0.037272727,51
2688.127487,38,58,0.73,20,0.0365,51
2688.063799,63,93,0.57,30,0.019,51
2688.063799,61,96,0.66,35,0.018857143,51
2688.037436,35,53,0.71,18,0.039444444,51
2687.982228,44,66,0.57,22,0.025909091,51
2687.964334,29,88,0.18,59,0.003050847,51
2687.901366,62,94,0.61,32,0.0190625,51
2687.901366,61,95,0.65,34,0.019117647,51
2687.428764,35,57,0.83,22,0.037727273,51
2687.425804,50,82,0.93,32,0.0290625,51
2687.421137,58,74,0.45,16,0.028125,51
2687.29089,36,55,0.7,19,0.036842105,51
2687.002175,33,55,0.87,22,0.039545455,51
2686.956311,55,88,0.86,33,0.026060606,51
2686.585048,59,64,0.18,5,0.036,51
2686.261633,59,70,0.34,11,0.030909091,51
2685.878088,51,84,0.9,33,0.027272727,51
2685.773282,66,88,0.42,22,0.019090909,51
2685.773282,62,93,0.59,31,0.019032258,51
2685.746049,38,52,0.53,14,0.037857143,51
2685.667351,56,77,0.58,21,0.027619048,51
2685.667351,55,78,0.64,23,0.027826087,51
2685.625707,67,78,0.22,11,0.02,51
2685.517943,35,56,0.78,21,0.037142857,51
2685.495559,61,81,0.44,20,0.022,51
2685.470243,45,63,0.48,18,0.026666667,51
2685.457136,65,86,0.4,21,0.019047619,51
2685.213764,56,76,0.56,20,0.028,51
2685.195803,54,85,0.92,31,0.029677419,51
2684.847419,63,79,0.35,16,0.021875,51
2684.713321,59,85,0.56,26,0.021538462,51
2684.435214,56,66,0.37,10,0.037,51
2684.324302,50,82,0.97,32,0.0303125,51
2684.276271,35,56,0.8,21,0.038095238,51
2684.270596,54,86,0.83,32,0.0259375,51
2684.234338,51,74,0.83,23,0.036086957,51
2684.144939,63,93,0.54,30,0.018,51
2683.769357,64,83,0.39,19,0.020526316,51
2683.708449,37,55,0.66,18,0.036666667,51
2683.708449,36,57,0.76,21,0.036190476,51
2683.708449,35,58,0.84,23,0.036521739,51
2683.577368,64,84,0.41,20,0.0205,51
2683.25863,42,48,0.21,6,0.035,51
2683.240334,50,86,0.97,36,0.026944444,51
2683.011107,38,53,0.61,15,0.040666667,51
2682.942385,57,76,0.52,19,0.027368421,51
2682.927261,52,65,0.03,13,0.002307692,51
2682.921952,55,75,0.59,20,0.0295,51
2682.921952,52,79,0.79,27,0.029259259,51
2682.54884,41,49,0.3,8,0.0375,51
2682.502956,49,80,0.96,31,0.030967742,51
2682.329599,53,69,0.59,16,0.036875,51
2682.321691,65,75,0.28,10,0.028,51
2682.11554,50,77,0.84,27,0.031111111,51
2682.01596,34,99,0.17,65,0.002615385,51
2681.75122,68,89,0.37,21,0.017619048,51
2681.471954,53,81,0.81,28,0.028928571,51
2681.011208,57,83,0.73,26,0.028076923,51
2680.178742,39,55,0.6,16,0.0375,51
2679.908595,53,80,0.75,27,0.027777778,51
2679.509292,38,56,0.68,18,0.037777778,51
2679.397612,62,80,0.39,18,0.021666667,51
2679.326615,36,53,0.66,17,0.038823529,51
2679.276846,69,83,0.27,14,0.019285714,51
2679.259371,61,65,0.14,4,0.035,51
2679.248038,49,76,0.98,27,0.036296296,51
2679.230293,51,87,0.95,36,0.026388889,51
2679.045972,64,66,0.06,2,0.03,51
2679.045972,63,67,0.12,4,0.03,51
2679.045972,62,68,0.18,6,0.03,51
2679.045972,61,69,0.24,8,0.03,51
2678.882376,39,66,0.17,27,0.006296296,51
2678.326158,53,89,0.98,36,0.027222222,51
2677.927351,67,80,0.25,13,0.019230769,51
2677.828576,58,80,0.66,22,0.03,51
2677.800515,54,91,0.94,37,0.025405405,51
2677.800515,53,92,0.99,39,0.025384615,51
2677.446518,69,75,0.16,6,0.026666667,51
2677.181364,60,98,0.67,38,0.017631579,51
2676.986439,60,81,0.45,21,0.021428571,51
2676.930021,63,94,0.55,31,0.017741935,51
2676.837071,34,59,0.92,25,0.0368,51
2676.82536,67,80,0.27,13,0.020769231,51
2676.69022,54,88,0.92,34,0.027058824,51
2676.526169,56,74,0.55,18,0.030555556,51
2676.486726,54,86,0.94,32,0.029375,51
2676.473041,39,51,0.44,12,0.036666667,51
2676.260241,34,58,0.89,24,0.037083333,51
2676.078256,57,75,0.52,18,0.028888889,51
2676.078256,56,77,0.6,21,0.028571429,51
2675.970092,61,88,0.52,27,0.019259259,51
2675.970092,60,89,0.56,29,0.019310345,51
2675.511779,68,73,0.11,5,0.022,51
2675.366005,50,83,0.99,33,0.03,51
2675.165237,32,99,0.24,67,0.00358209,51
2675.097303,57,82,0.74,25,0.0296,51
2674.998764,63,76,0.3,13,0.023076923,51
2674.972247,68,85,0.32,17,0.018823529,51
2674.649224,35,58,0.85,23,0.036956522,51
2674.649224,34,59,0.93,25,0.0372,51
2674.59664,53,97,0.97,44,0.022045455,51
2674.56506,65,90,0.48,25,0.0192,51
2674.56506,64,91,0.52,27,0.019259259,51
2674.56506,63,92,0.56,29,0.019310345,51
2674.56506,62,93,0.6,31,0.019354839,51
2674.418143,60,97,0.66,37,0.017837838,51
2674.415474,61,86,0.63,25,0.0252,51
2674.286774,62,67,0.15,5,0.03,51
2674.286006,34,58,0.88,24,0.036666667,51
2674.194855,46,58,0.33,12,0.0275,51
2674.110423,54,79,0.7,25,0.028,51
2674.110423,51,83,0.89,32,0.0278125,51
2674.042432,49,76,0.95,27,0.035185185,51
2673.768307,7,42,0.76,35,0.021714286,51
2673.766242,37,54,0.63,17,0.037058824,51
2673.634671,52,82,0.87,30,0.029,51
2673.634671,51,83,0.93,32,0.0290625,51
2673.586039,62,87,0.48,25,0.0192,51
2673.335158,68,74,0.17,6,0.028333333,51
2673.297074,68,78,0.21,10,0.021,51
2672.950551,38,49,0.42,11,0.038181818,51
2672.734015,34,59,0.91,25,0.0364,51
2672.32992,58,68,0.35,10,0.035,51
2671.696778,59,84,0.71,25,0.0284,51
2671.669915,58,71,0.4,13,0.030769231,51
2671.592668,54,92,0.95,38,0.025,51
2671.513763,48,65,0.42,17,0.024705882,51
2671.216191,49,59,0.25,10,0.025,51
2671.100586,41,49,0.28,8,0.035,51
2671.042309,53,76,0.7,23,0.030434783,51
2670.843022,53,70,0.62,17,0.036470588,51
2670.80909,33,59,0.97,26,0.037307692,51
2670.686548,53,89,0.97,36,0.026944444,51
2670.64263,51,73,0.78,22,0.035454545,51
2670.492496,60,63,0.11,3,0.036666667,51
2670.476367,55,86,0.89,31,0.028709677,51
2670.342843,52,82,0.83,30,0.027666667,51
2670.215499,48,62,0.36,14,0.025714286,51
2670.103235,65,92,0.48,27,0.017777778,51
2669.894204,59,66,0.22,7,0.031428571,51
2669.863616,56,67,0.4,11,0.036363636,51
2669.863616,52,72,0.72,20,0.036,51
2669.863606,67,76,0.19,9,0.021111111,51
2669.859598,47,58,0.3,11,0.027272727,51
2669.751057,59,77,0.48,18,0.026666667,51
2669.629818,30,86,0.17,56,0.003035714,51
2669.621813,53,85,0.84,32,0.02625,51
2669.180089,61,94,0.64,33,0.019393939,51
2669.163604,35,57,0.82,22,0.037272727,51
2669.123837,54,78,0.68,24,0.028333333,51
2669.123837,53,79,0.74,26,0.028461538,51
2669.123837,52,80,0.8,28,0.028571429,51
2669.123837,50,83,0.93,33,0.028181818,51
2669.057008,60,68,0.25,8,0.03125,51
2669.022677,35,67,0.15,32,0.0046875,51
2669.018295,44,76,0.08,32,0.0025,51
2668.805492,65,69,0.11,4,0.0275,51
2668.805492,64,71,0.19,7,0.027142857,51
2668.805492,63,71,0.22,8,0.0275,51
2668.375559,50,84,0.95,34,0.027941176,51
2668.344207,50,78,0.82,28,0.029285714,51
2668.343898,49,82,0.98,33,0.02969697,51
2668.238335,53,88,0.9,35,0.025714286,51
2668.238335,52,89,0.95,37,0.025675676,51
2668.063025,49,83,0.99,34,0.029117647,51
2668.051397,53,79,0.79,26,0.030384615,51
2667.803385,51,83,0.88,32,0.0275,51
2667.803385,50,84,0.94,34,0.027647059,51
2667.706344,53,71,0.65,18,0.036111111,51
2667.682498,57,69,0.42,12,0.035,51
2667.682498,56,70,0.49,14,0.035,51
2667.567737,57,72,0.35,15,0.023333333,51
2667.52042,31,55,0.97,24,0.040416667,51
2667.462799,59,72,0.37,13,0.028461538,51
2667.289788,36,56,0.74,20,0.037,51
2667.20095,62,81,0.49,19,0.025789474,51
2667.138654,62,94,0.58,32,0.018125,51
2667.046035,55,74,0.59,19,0.031052632,51
2666.761323,35,62,0.96,27,0.035555556,51
2666.715238,48,60,0.3,12,0.025,51
2666.704703,57,79,0.59,22,0.026818182,51
2666.638786,51,84,0.95,33,0.028787879,51
2666.629672,54,77,0.69,23,0.03,51
2665.996822,50,83,0.94,33,0.028484848,51
2665.960528,39,52,0.48,13,0.036923077,51
2665.879477,60,71,0.32,11,0.029090909,51
2665.363029,55,77,0.62,22,0.028181818,51
2665.272118,68,74,0.13,6,0.021666667,51
2665.255333,62,81,0.41,19,0.021578947,51
2665.163469,51,82,0.94,31,0.030322581,51
2664.704104,33,54,0.83,21,0.03952381,51
2664.688892,57,84,0.62,27,0.022962963,51
2664.663232,47,86,0.87,39,0.022307692,51
2664.483818,51,72,0.75,21,0.035714286,51
2664.483818,50,73,0.82,23,0.035652174,51
2664.43511,52,92,0.83,40,0.02075,51
2664.268292,66,81,0.29,15,0.019333333,51
2664.075546,33,99,0.19,66,0.002878788,51
2664.061053,51,82,0.87,31,0.028064516,51
2663.922866,35,58,0.83,23,0.036086957,51
2663.913928,42,68,0.67,26,0.025769231,51
2663.764262,37,53,0.61,16,0.038125,51
2663.473433,65,82,0.35,17,0.020588235,51
2663.356579,36,61,0.91,25,0.0364,51
2663.245074,40,50,0.37,10,0.037,51
2663.109308,65,91,0.47,26,0.018076923,51
2663.052456,33,98,0.2,65,0.003076923,51
2662.780746,40,51,0.42,11,0.038181818,51
2662.764032,32,98,0.22,66,0.003333333,51
2662.016137,56,87,0.64,31,0.020645161,51
2661.994386,56,87,0.65,31,0.020967742,51
2661.826824,51,57,0.16,6,0.026666667,51
2661.805753,26,87,0.58,61,0.009508197,51
2661.768565,61,95,0.62,34,0.018235294,51
2661.505193,41,63,0.15,22,0.006818182,51
2661.472085,55,68,0.48,13,0.036923077,51
2661.395159,34,58,0.9,24,0.0375,51
2661.395159,33,59,0.98,26,0.037692308,51
2661.372903,45,65,0.52,20,0.026,51
2661.337922,51,81,0.92,30,0.030666667,51
2661.307228,53,87,0.88,34,0.025882353,51
2661.109559,7,41,0.75,34,0.022058824,51
2660.850707,54,77,0.7,23,0.030434783,51
2660.797089,39,52,0.49,13,0.037692308,51
2660.747091,58,71,0.39,13,0.03,51
2660.689431,50,57,0.18,7,0.025714286,51
2660.307121,52,81,0.81,29,0.027931034,51
2659.85248,61,81,0.53,20,0.0265,51
2659.658421,35,63,0.97,28,0.034642857,51
2659.567883,61,87,0.51,26,0.019615385,51
2659.37209,44,49,0.19,5,0.038,51
2659.236648,36,56,0.76,20,0.038,51
2658.937301,50,82,0.96,32,0.03,51
2658.876774,52,77,0.86,25,0.0344,51
2658.83005,57,81,0.72,24,0.03,51
2658.406224,49,75,0.94,26,0.036153846,51
2658.3625,54,84,0.79,30,0.026333333,51
2658.333022,47,60,0.35,13,0.026923077,51
2658.256324,52,72,0.71,20,0.0355,51
2658.165961,53,55,0.05,2,0.025,51
2658.165961,52,56,0.1,4,0.025,51
2658.165961,51,57,0.15,6,0.025,51
2658.050867,72,73,0.02,1,0.02,51
2658.015304,55,79,0.68,24,0.028333333,51
2657.945522,50,78,0.88,28,0.031428571,51
2657.855752,57,92,0.77,35,0.022,51
2657.716826,49,61,0.31,12,0.025833333,51
2657.658146,62,87,0.51,25,0.0204,51
2657.506469,62,86,0.49,24,0.020416667,51
2657.390594,27,93,0.3,66,0.004545455,51
2657.390048,50,58,0.2,8,0.025,51
2657.280178,49,74,0.91,25,0.0364,51
2657.199561,50,85,0.96,35,0.027428571,51
2656.894557,71,74,0.06,3,0.02,51
2656.894557,70,75,0.1,5,0.02,51
2656.894557,69,76,0.14,7,0.02,51
2656.827723,38,53,0.56,15,0.037333333,51
2656.697584,49,83,0.98,34,0.028823529,51
2656.610609,57,64,0.26,7,0.037142857,51
2656.469438,38,52,0.54,14,0.038571429,51
2656.391089,57,71,0.48,14,0.034285714,51
2656.351594,68,77,0.18,9,0.02,51
2656.34396,65,66,0.03,1,0.03,51
2656.34396,64,67,0.09,3,0.03,51
2656.34396,63,68,0.15,5,0.03,51
2656.34396,62,69,0.21,7,0.03,51
2656.34396,61,70,0.27,9,0.03,51
2656.34396,60,71,0.33,11,0.03,51
2656.324074,62,85,0.57,23,0.024782609,51
2656.250571,43,69,0.65,26,0.025,51
2656.225549,52,80,0.84,28,0.03,51
2656.225549,51,81,0.9,30,0.03,51
2656.107369,35,51,0.65,16,0.040625,51
2656.022653,73,93,0.34,20,0.017,51
2655.999111,55,76,0.64,21,0.03047619,51
2655.981408,53,90,0.78,37,0.021081081,51
2655.854541,52,75,0.79,23,0.034347826,51
2655.854541,51,76,0.86,25,0.0344,51
2655.829135,56,78,0.62,22,0.028181818,51
2655.695755,37,54,0.64,17,0.037647059,51
2655.647341,36,54,0.65,18,0.036111111,51
2655.62548,54,72,0.56,18,0.031111111,51
2655.502935,59,91,0.63,32,0.0196875,51
2655.343252,55,95,0.87,40,0.02175,51
2655.269957,51,77,0.9,26,0.034615385,51
2655.199667,74,75,0.02,1,0.02,51
2655.199667,73,76,0.06,3,0.02,51
2655.199667,72,77,0.1,5,0.02,51
2655.199667,71,78,0.14,7,0.02,51
2655.199667,70,79,0.18,9,0.02,51
2655.199667,69,80,0.22,11,0.02,51
2655.199667,68,81,0.26,13,0.02,51
2655.147924,55,72,0.6,17,0.035294118,51
2655.147924,54,73,0.67,19,0.035263158,51
2655.050898,36,71,0.22,35,0.006285714,51
2654.895941,50,84,0.99,34,0.029117647,51
2654.485461,66,72,0.14,6,0.023333333,51
2654.451182,51,81,0.89,30,0.029666667,51
2654.451182,50,82,0.95,32,0.0296875,51
2654.447158,63,84,0.43,21,0.02047619,51
2654.342015,55,68,0.47,13,0.036153846,51
2654.328601,45,73,0.08,28,0.002857143,51
2654.131818,36,57,0.77,21,0.036666667,51
2653.930271,57,67,0.36,10,0.036,51
2653.828134,54,90,0.93,36,0.025833333,51
2653.799294,32,56,0.96,24,0.04,51
2653.731173,36,65,0.32,29,0.011034483,51
2653.56996,49,76,0.96,27,0.035555556,51
2653.554921,54,96,0.92,42,0.021904762,51
2653.50152,40,50,0.38,10,0.038,51
2653.399144,72,80,0.15,8,0.01875,51
2653.362305,52,80,0.85,28,0.030357143,51
2653.357208,35,52,0.68,17,0.04,51
2653.313402,55,84,0.76,29,0.026206897,51
2653.164372,43,47,0.15,4,0.0375,51
2652.583532,38,51,0.5,13,0.038461538,51
2652.539818,54,90,0.74,36,0.020555556,51
2652.125046,56,66,0.36,10,0.036,51
2651.834905,56,76,0.6,20,0.03,51
2651.281138,52,80,0.83,28,0.029642857,51
2651.249885,62,86,0.48,24,0.02,51
2651.212637,53,91,0.78,38,0.020526316,51
2651.196586,54,73,0.68,19,0.035789474,51
2651.118841,46,66,0.5,20,0.025,51
2650.861278,56,83,0.8,27,0.02962963,51
2650.861278,55,84,0.86,29,0.029655172,51
2650.846278,51,76,0.76,25,0.0304,51
2650.802671,27,94,0.29,67,0.004328358,51
2650.690549,36,55,0.71,19,0.037368421,51
2650.430418,36,54,0.66,18,0.036666667,51
2650.430418,35,55,0.74,20,0.037,51
2650.279665,58,74,0.46,16,0.02875,51
2650.0639,32,56,0.95,24,0.039583333,51
2650.008483,58,64,0.19,6,0.031666667,51
2649.886879,35,55,0.73,20,0.0365,51
2649.715882,55,66,0.41,11,0.037272727,51
2649.636804,37,59,0.81,22,0.036818182,51
2649.524026,35,56,0.79,21,0.037619048,51
2649.45063,54,85,0.81,31,0.026129032,51
2649.283908,58,85,0.78,27,0.028888889,51
2649.282308,62,73,0.3,11,0.027272727,51
2649.282308,60,75,0.41,15,0.027333333,51
2649.282308,58,77,0.52,19,0.027368421,51
2649.278092,52,87,0.91,35,0.026,51
2649.200798,51,82,0.91,31,0.029354839,51
2649.200798,50,83,0.97,33,0.029393939,51
2649.014774,61,96,0.62,35,0.017714286,51
2648.81472,54,89,0.74,35,0.021142857,51
2648.81404,52,76,0.84,24,0.035,51
2648.81404,51,77,0.91,26,0.035,51
2648.81404,50,78,0.98,28,0.035,51
2648.778469,62,70,0.23,8,0.02875,51
2648.753857,50,74,0.86,24,0.035833333,51
2648.746527,60,91,0.62,31,0.02,51
2648.732488,55,77,0.66,22,0.03,51
2648.732488,54,78,0.72,24,0.03,51
2648.566233,53,80,0.81,27,0.03,51
2648.419805,56,86,0.83,30,0.027666667,51
2648.419805,55,88,0.91,33,0.027575758,51
2648.298349,64,92,0.51,28,0.018214286,51
2648.286641,53,79,0.77,26,0.029615385,51
2648.253235,56,72,0.55,16,0.034375,51
2648.228542,60,76,0.43,16,0.026875,51
2648.197803,45,60,0.41,15,0.027333333,51
2648.060802,63,78,0.41,15,0.027333333,51
2647.775723,56,85,0.8,29,0.027586207,51
2647.775723,55,86,0.85,31,0.027419355,51
2647.775723,55,86,0.86,31,0.027741935,51
2647.775723,54,87,0.91,33,0.027575758,51
2647.775723,53,88,0.97,35,0.027714286,51
2647.775723,53,89,0.99,36,0.0275,51
2647.659636,59,79,0.6,20,0.03,51
2646.709527,29,88,0.19,59,0.003220339,51
2646.571695,40,47,0.28,7,0.04,51
2646.312862,35,57,0.84,22,0.038181818,51
2646.311184,50,83,0.98,33,0.02969697,51
2646.143365,57,80,0.61,23,0.026521739,51
2646.143365,55,82,0.72,27,0.026666667,51
2645.986565,51,77,0.89,26,0.034230769,51
2645.986565,50,78,0.96,28,0.034285714,51
2645.976986,38,54,0.6,16,0.0375,51
2645.392938,37,49,0.47,12,0.039166667,51
2645.335673,51,93,0.88,42,0.020952381,51
2645.122012,36,55,0.73,19,0.038421053,51
2645.059424,48,64,0.4,16,0.025,51
2645.055558,38,50,0.45,12,0.0375,51
2645.055558,36,53,0.63,17,0.037058824,51
2644.977456,55,73,0.62,18,0.034444444,51
2644.977456,54,74,0.69,20,0.0345,51
2644.977456,53,75,0.76,22,0.034545455,51
2644.977456,52,76,0.83,24,0.034583333,51
2644.677777,66,87,0.4,21,0.019047619,51
2644.677777,65,88,0.44,23,0.019130435,51
2644.675057,62,84,0.55,22,0.025,51
2644.602838,62,85,0.47,23,0.020434783,51
2644.571697,46,68,0.54,22,0.024545455,51
2644.418051,66,79,0.26,13,0.02,51
2644.248341,56,85,0.83,29,0.02862069,51
2644.246849,52,73,0.75,21,0.035714286,51
2644.203095,61,95,0.61,34,0.017941176,51
2643.940493,56,73,0.4,17,0.023529412,51
2643.796687,60,73,0.37,13,0.028461538,51
2643.754375,39,51,0.46,12,0.038333333,51
2643.621724,47,86,0.86,39,0.022051282,51
2643.514266,38,48,0.39,10,0.039,51
2643.483,55,85,0.88,30,0.029333333,51
2643.384443,48,75,0.97,27,0.035925926,51
2643.165819,51,75,0.73,24,0.030416667,51
2642.732076,53,80,0.78,27,0.028888889,51
2642.706111,55,81,0.71,26,0.027307692,51
2642.680483,62,82,0.43,20,0.0215,51
2642.461527,60,66,0.21,6,0.035,51
2642.461527,59,67,0.28,8,0.035,51
2642.340375,36,55,0.67,19,0.035263158,51
2642.267824,52,81,0.87,29,0.03,51
2642.267824,52,82,0.89,30,0.029666667,51
2642.267824,51,82,0.93,31,0.03,51
2642.02094,34,55,0.8,21,0.038095238,51
2642.011792,41,51,0.38,10,0.038,51
2641.782635,64,86,0.44,22,0.02,51
2641.724802,53,91,0.99,38,0.026052632,51
2641.126416,53,81,0.8,28,0.028571429,51
2641.12442,34,56,0.82,22,0.037272727,51
2641.076076,54,72,0.64,18,0.035555556,51
2640.879615,56,94,0.82,38,0.021578947,51
2640.865474,49,82,0.97,33,0.029393939,51
2640.535587,55,67,0.44,12,0.036666667,51
2640.500483,49,83,0.76,34,0.022352941,51
2640.265025,55,87,0.9,32,0.028125,51
2640.265025,54,88,0.96,34,0.028235294,51
2640.227384,37,61,0.74,24,0.030833333,51
2640.078588,35,59,0.77,24,0.032083333,51
2640.034077,63,78,0.42,15,0.028,51
2639.966155,45,67,0.55,22,0.025,51
2639.78766,56,89,0.84,33,0.025454545,51
2639.643946,61,96,0.63,35,0.018,51
2639.635982,58,66,0.29,8,0.03625,51
2639.60408,70,83,0.25,13,0.019230769,51
2639.60408,65,89,0.46,24,0.019166667,51
2639.558629,37,57,0.76,20,0.038,51
2639.501704,53,82,0.81,29,0.027931034,51
2639.496958,67,86,0.37,19,0.019473684,51
2639.456454,36,90,0.48,54,0.008888889,51
2639.407687,53,75,0.77,22,0.035,51
2639.402538,50,81,0.91,31,0.029354839,51
2639.38564,58,81,0.54,23,0.023478261,51
2639.334945,62,84,0.44,22,0.02,51
2639.313987,53,72,0.64,19,0.033684211,51
2639.302538,64,78,0.3,14,0.021428571,51
2639.067427,65,85,0.4,20,0.02,51
2639.033766,53,81,0.79,28,0.028214286,51
2639.015862,67,74,0.15,7,0.021428571,51
2638.951696,53,78,0.77,25,0.0308,51
2638.774001,54,87,0.92,33,0.027878788,51
2638.769759,52,88,0.94,36,0.026111111,51
2638.742531,65,91,0.49,26,0.018846154,51
2638.742531,62,95,0.62,33,0.018787879,51
2638.741314,35,94,0.19,59,0.003220339,51
2638.7257,63,83,0.4,20,0.02,51
2638.547922,53,87,0.89,34,0.026176471,51
2638.31365,34,95,0.2,61,0.003278689,51
2638.258817,56,95,0.83,39,0.021282051,51
2638.16504,56,79,0.64,23,0.027826087,51
2638.081639,54,78,0.73,24,0.030416667,51
2637.85439,60,65,0.18,5,0.036,51
2637.79913,61,87,0.53,26,0.020384615,51
2637.784646,42,48,0.22,6,0.036666667,51
2637.742913,55,71,0.57,16,0.035625,51
2637.48186,56,84,0.83,28,0.029642857,51
2637.423149,52,83,0.87,31,0.028064516,51
2637.41314,63,86,0.47,23,0.020434783,51
2636.955566,52,82,0.85,30,0.028333333,51
2636.912614,37,58,0.78,21,0.037142857,51
2636.903022,56,80,0.65,24,0.027083333,51
2636.837098,68,85,0.33,17,0.019411765,51
2636.740516,66,82,0.33,16,0.020625,51
2636.651997,65,79,0.38,14,0.027142857,51
2636.651997,63,81,0.49,18,0.027222222,51
2636.651997,59,86,0.73,27,0.027037037,51
2636.596749,60,97,0.67,37,0.018108108,51
2636.594729,61,89,0.55,28,0.019642857,51
2636.487398,65,94,0.53,29,0.018275862,51
2636.406466,51,89,0.99,38,0.026052632,51
2636.273168,37,56,0.62,19,0.032631579,51
2636.068322,58,68,0.36,10,0.036,51
2636.058938,48,60,0.32,12,0.026666667,51
2636.0557,56,88,0.65,32,0.0203125,51
2635.937187,49,84,0.99,35,0.028285714,51
2635.905913,48,75,0.99,27,0.036666667,51
2635.749124,60,81,0.59,21,0.028095238,51
2635.646416,57,74,0.5,17,0.029411765,51
2635.367342,35,54,0.72,19,0.037894737,51
2635.345785,63,83,0.5,20,0.025,51
2635.345785,61,86,0.62,25,0.0248,51
2635.331883,30,87,0.11,57,0.001929825,51
2634.622085,42,70,0.72,28,0.025714286,51
2634.48094,35,62,0.95,27,0.035185185,51
2634.07099,67,74,0.2,7,0.028571429,51
2634.048663,34,60,0.96,26,0.036923077,51
2633.889241,43,66,0.61,23,0.026521739,51
2633.830586,37,64,0.12,27,0.004444444,51
2633.830459,67,91,0.44,24,0.018333333,51
2633.791205,36,54,0.63,18,0.035,51
2633.703698,60,74,0.39,14,0.027857143,51
2633.663716,47,55,0.27,8,0.03375,51
2633.514911,57,70,0.46,13,0.035384615,51
2633.514911,56,71,0.53,15,0.035333333,51
2633.510553,57,84,0.77,27,0.028518519,51
2633.427247,67,76,0.25,9,0.027777778,51
2633.400157,33,99,0.17,66,0.002575758,51
2633.234893,36,57,0.69,21,0.032857143,51
2633.047764,58,82,0.55,24,0.022916667,51
2633.046878,57,74,0.52,17,0.030588235,51
2632.991556,36,60,0.89,24,0.037083333,51
2632.822918,34,60,0.93,26,0.035769231,51
2632.690093,52,88,0.93,36,0.025833333,51
2632.680251,52,74,0.67,22,0.030454545,51
2632.558589,38,68,0.19,30,0.006333333,51
2632.50083,35,63,0.96,28,0.034285714,51
2632.479211,63,82,0.39,19,0.020526316,51
2632.433845,52,89,0.96,37,0.025945946,51
2632.402165,53,76,0.81,23,0.035217391,51
2632.39661,49,74,0.92,25,0.0368,51
2632.379851,65,80,0.39,15,0.026,51
2632.379851,64,81,0.44,17,0.025882353,51
2632.372333,61,83,0.6,22,0.027272727,51
2632.347771,46,74,0.06,28,0.002142857,51
2632.315344,51,78,0.94,27,0.034814815,51
2632.299285,55,90,0.7,35,0.02,51
2632.132778,52,82,0.86,30,0.028666667,51
2631.969781,8,39,0.7,31,0.022580645,51
2631.954527,56,75,0.58,19,0.030526316,51
2631.948529,70,87,0.3,17,0.017647059,51
2631.849386,54,69,0.54,15,0.036,51
2631.848633,54,74,0.7,20,0.035,51
2631.666098,51,83,0.92,32,0.02875,51
